UF,Município,Agropecuária_2019,Agropecuária_2020,Agropecuária_VrAbs,Agropecuária_Vr,Indústria_2019,Indústria_2020,Indústria_VrAbs,Indústria_Vr,Construção_2019,Construção_2020,Construção_VrAbs,Construção_Vr,Comércio_2019,Comércio_2020,Comércio_VrAbs,Comércio_Vr,Serviços_2019,Serviços_2020,Serviços_VrAbs,Serviços_Vr,Total_2019,Total_2020,Total_VrAbs,Total_Vr,Municipio_mapa,Latitude,Longitude,Ufs_indice,index_original
RO,ARIQUEMES,993,1066,73,7.35,2734,2477,-257,-9.4,378,393,15,3.97,6368,6499,131,2.06,7459,7099,-360,-4.83,17932,17534,-398,-2.22,ARIQUEMES RO,-9.9076522,-63.033069,20,1
RO,CABIXI,158,152,-6,-3.8,73,82,9,12.33,0,0,0,0.0,69,75,6,8.7,406,366,-40,-9.85,706,675,-31,-4.39,CABIXI RO,-13.4940499,-60.545110240525375,20,2
RO,CACOAL,505,481,-24,-4.75,2487,2567,80,3.22,737,797,60,8.14,6294,6178,-116,-1.84,7887,7503,-384,-4.87,17910,17526,-384,-2.14,CACOAL RO,-11.4333,-61.4420502,20,3
RO,CEREJEIRAS,205,213,8,3.9,210,207,-3,-1.43,13,15,2,15.38,761,845,84,11.04,1041,1092,51,4.9,2230,2372,142,6.37,CEREJEIRAS RO,-13.1924248,-60.81924455857779,20,4
RO,COLORADO DO OESTE,178,160,-18,-10.11,397,391,-6,-1.51,58,52,-6,-10.34,755,785,30,3.97,949,999,50,5.27,2337,2387,50,2.14,COLORADO DO OESTE RO,-13.12109915,-60.54207007205348,20,5
RO,CORUMBIARA,685,745,60,8.76,47,48,1,2.13,10,7,-3,-30.0,145,141,-4,-2.76,590,450,-140,-23.73,1477,1391,-86,-5.82,CORUMBIARA RO,-13.0002162,-60.94320578255167,20,6
RO,COSTA MARQUES,92,100,8,8.7,22,19,-3,-13.64,0,0,0,0.0,171,171,0,0.0,669,605,-64,-9.57,954,895,-59,-6.18,COSTA MARQUES RO,-12.4367165,-64.2279765,20,7
RO,GUAJARA-MIRIM,64,66,2,3.12,168,204,36,21.43,8,31,23,287.5,1580,1549,-31,-1.96,1910,1854,-56,-2.93,3730,3704,-26,-0.7,GUAJARA-MIRIM RO,-10.7804239,-65.3327825,20,9
RO,JARU,353,359,6,1.7,3237,3177,-60,-1.85,189,190,1,0.53,3403,3383,-20,-0.59,3064,3121,57,1.86,10246,10230,-16,-0.16,JARU RO,-10.431826,-62.478769,20,10
RO,JI-PARANA,596,612,16,2.68,5287,5409,122,2.31,2076,937,-1139,-54.87,9471,9516,45,0.48,11929,11514,-415,-3.48,29359,27988,-1371,-4.67,JI-PARANA RO,-10.8778148,-61.9277854,20,11
RO,OURO PRETO DO OESTE,283,277,-6,-2.12,450,535,85,18.89,637,472,-165,-25.9,1900,1860,-40,-2.11,2827,2752,-75,-2.65,6097,5896,-201,-3.3,OURO PRETO DO OESTE RO,-10.717914,-62.2566611,20,14
RO,PIMENTA BUENO,603,557,-46,-7.63,2640,2527,-113,-4.28,197,265,68,34.52,3576,3528,-48,-1.34,2977,3004,27,0.91,9993,9881,-112,-1.12,PIMENTA BUENO RO,-11.6767868,-61.1863902,20,15
RO,PORTO VELHO,1133,1021,-112,-9.89,8626,8523,-103,-1.19,4031,4162,131,3.25,26731,25346,-1385,-5.18,116164,117296,1132,0.97,156685,156348,-337,-0.22,PORTO VELHO RO,-8.7494525,-63.8735438,20,16
RO,PRESIDENTE MEDICI,199,204,5,2.51,540,531,-9,-1.67,58,99,41,70.69,583,665,82,14.07,1125,1107,-18,-1.6,2505,2606,101,4.03,PRESIDENTE MEDICI RO,-11.1686638,-61.9057627,20,17
RO,RIO CRESPO,288,353,65,22.57,57,51,-6,-10.53,0,2,2,0.0,29,31,2,6.9,311,46,-265,-85.21,685,483,-202,-29.49,RIO CRESPO RO,-9.7052777,-62.9004474,20,18
RO,ROLIM DE MOURA,347,340,-7,-2.02,2954,3017,63,2.13,212,315,103,48.58,3277,3266,-11,-0.34,5182,4550,-632,-12.2,11972,11488,-484,-4.04,ROLIM DE MOURA RO,-11.727071,-61.771411,20,19
RO,VILHENA,1325,1279,-46,-3.47,3396,3489,93,2.74,395,418,23,5.82,6774,6896,122,1.8,9893,10222,329,3.33,21783,22304,521,2.39,VILHENA RO,-12.7368536,-60.1465555,20,21
RO,SAO MIGUEL DO GUAPORE,200,194,-6,-3.0,960,1008,48,5.0,19,57,38,200.0,741,676,-65,-8.77,1399,1353,-46,-3.29,3319,3288,-31,-0.93,SAO MIGUEL DO GUAPORE RO,-11.6951466,-62.7195739,20,22
RO,NOVA MAMORE,123,140,17,13.82,96,84,-12,-12.5,15,12,-3,-20.0,409,433,24,5.87,1324,1225,-99,-7.48,1967,1894,-73,-3.71,NOVA MAMORE RO,-10.4104864,-65.3313761,20,23
RO,ALTO ALEGRE DOS PARECIS,120,111,-9,-7.5,29,20,-9,-31.03,22,26,4,18.18,255,245,-10,-3.92,658,626,-32,-4.86,1084,1028,-56,-5.17,ALTO ALEGRE DOS PARECIS RO,-12.1314515,-61.856265,20,25
RO,ALTO PARAISO,142,154,12,8.45,126,82,-44,-34.92,3,7,4,133.33,365,407,42,11.51,778,656,-122,-15.68,1414,1306,-108,-7.64,ALTO PARAISO RO,-9.7240103,-63.3188123,20,26
RO,BURITIS,149,169,20,13.42,365,351,-14,-3.84,44,26,-18,-40.91,1220,1096,-124,-10.16,1858,1700,-158,-8.5,3636,3342,-294,-8.09,BURITIS RO,-10.2054937,-63.8281954,20,27
RO,NOVO HORIZONTE DO OESTE,47,51,4,8.51,92,70,-22,-23.91,35,36,1,2.86,125,121,-4,-3.2,542,474,-68,-12.55,841,752,-89,-10.58,NOVO HORIZONTE DO OESTE RO,-11.7105311,-61.9993277,20,28
RO,CACAULANDIA,107,125,18,16.82,0,22,22,0.0,0,0,0,0.0,67,73,6,8.96,397,331,-66,-16.62,571,551,-20,-3.5,CACAULANDIA RO,-10.3380043,-62.9007231,20,29
RO,CAMPO NOVO DE RONDONIA,156,157,1,0.64,0,1,1,0.0,3,1,-2,-66.67,137,122,-15,-10.95,652,622,-30,-4.6,948,903,-45,-4.75,CAMPO NOVO DE RONDONIA RO,-10.5704235,-63.6199511,20,30
RO,CASTANHEIRAS,144,128,-16,-11.11,0,0,0,0.0,0,0,0,0.0,42,43,1,2.38,297,13,-284,-95.62,483,184,-299,-61.9,CASTANHEIRAS RO,-11.4277212,-61.9486802,20,32
RO,CHUPINGUAIA,880,827,-53,-6.02,1114,1046,-68,-6.1,13,4,-9,-69.23,186,177,-9,-4.84,762,746,-16,-2.1,2955,2800,-155,-5.25,CHUPINGUAIA RO,-12.5528918,-60.9027819,20,33
RO,CUJUBIM,173,161,-12,-6.94,212,207,-5,-2.36,3,5,2,66.67,282,335,53,18.79,684,617,-67,-9.8,1354,1325,-29,-2.14,CUJUBIM RO,-9.3687919,-62.5832107,20,34
RO,GOVERNADOR JORGE TEIXEIRA,49,52,3,6.12,8,3,-5,-62.5,4,0,-4,-100.0,79,77,-2,-2.53,501,428,-73,-14.57,641,560,-81,-12.64,GOVERNADOR JORGE TEIXEIRA RO,-10.6140224,-62.7326412,20,35
RO,ITAPUA DO OESTE,114,119,5,4.39,339,400,61,17.99,4,2,-2,-50.0,156,132,-24,-15.38,558,523,-35,-6.27,1171,1176,5,0.43,ITAPUA DO OESTE RO,-9.189646,-63.1910097,20,36
RO,MINISTRO ANDREAZZA,40,32,-8,-20.0,122,121,-1,-0.82,0,1,1,0.0,186,188,2,1.08,489,544,55,11.25,837,886,49,5.85,MINISTRO ANDREAZZA RO,-11.1981045,-61.5167422,20,37
RO,MIRANTE DA SERRA,49,35,-14,-28.57,267,263,-4,-1.5,4,6,2,50.0,336,277,-59,-17.56,682,639,-43,-6.3,1338,1220,-118,-8.82,MIRANTE DA SERRA RO,-11.0321694,-62.6717012,20,38
RO,MONTE NEGRO,152,129,-23,-15.13,135,128,-7,-5.19,29,29,0,0.0,267,269,2,0.75,738,746,8,1.08,1321,1301,-20,-1.51,MONTE NEGRO RO,-10.2603398,-63.2977025,20,39
RO,NOVA UNIAO,20,12,-8,-40.0,0,1,1,0.0,5,3,-2,-40.0,106,104,-2,-1.89,302,339,37,12.25,433,459,26,6.0,NOVA UNIAO RO,-10.91591,-62.5570096,20,40
RO,PARECIS,322,257,-65,-20.19,31,30,-1,-3.23,0,0,0,0.0,57,85,28,49.12,295,258,-37,-12.54,705,630,-75,-10.64,PARECIS RO,-12.1810712,-61.6037558,20,41
RO,PIMENTEIRAS DO OESTE,294,341,47,15.99,4,5,1,25.0,0,0,0,0.0,10,12,2,20.0,334,318,-16,-4.79,642,676,34,5.3,PIMENTEIRAS DO OESTE RO,-13.482271,-61.047052,20,42
RO,PRIMAVERA DE RONDONIA,70,65,-5,-7.14,0,5,5,0.0,0,0,0,0.0,21,25,4,19.05,307,285,-22,-7.17,398,380,-18,-4.52,PRIMAVERA DE RONDONIA RO,-11.829456,-61.315336,20,43
RO,SAO FRANCISCO DO GUAPORE,246,253,7,2.85,41,44,3,7.32,10,8,-2,-20.0,491,527,36,7.33,798,642,-156,-19.55,1586,1474,-112,-7.06,SAO FRANCISCO DO GUAPORE RO,-12.0609982,-63.5668307,20,45
RO,SERINGUEIRAS,79,77,-2,-2.53,109,133,24,22.02,1,2,1,100.0,345,321,-24,-6.96,736,696,-40,-5.43,1270,1229,-41,-3.23,SERINGUEIRAS RO,-11.7715738,-63.0346835,20,46
RO,TEIXEIROPOLIS,12,22,10,83.33,58,39,-19,-32.76,1,4,3,300.0,89,97,8,8.99,293,293,0,0.0,453,455,2,0.44,TEIXEIROPOLIS RO,-10.9336967,-62.2560049,20,47
RO,THEOBROMA,203,188,-15,-7.39,47,42,-5,-10.64,0,0,0,0.0,92,89,-3,-3.26,573,491,-82,-14.31,915,810,-105,-11.48,THEOBROMA RO,-10.246489,-62.3493803,20,48
RO,URUPA,39,49,10,25.64,159,220,61,38.36,5,7,2,40.0,377,393,16,4.24,718,705,-13,-1.81,1298,1374,76,5.86,URUPA RO,-11.1256535,-62.3704203,20,49
RO,VALE DO ANARI,41,48,7,17.07,36,27,-9,-25.0,0,0,0,0.0,189,194,5,2.65,458,441,-17,-3.71,724,710,-14,-1.93,VALE DO ANARI RO,-9.8580807,-62.1741423,20,50
RO,VALE DO PARAISO,62,60,-2,-3.23,13,16,3,23.08,1,0,-1,-100.0,118,90,-28,-23.73,531,597,66,12.43,725,763,38,5.24,VALE DO PARAISO RO,-10.4266959,-62.1300904,20,51
AC,ACRELANDIA,94,108,14,14.89,140,134,-6,-4.29,0,0,0,0.0,192,227,35,18.23,407,432,25,6.14,833,901,68,8.16,ACRELANDIA AC,-10.0759167,-67.0526898,0,52
AC,ASSIS BRASIL,4,3,-1,-25.0,2,2,0,0.0,0,0,0,0.0,72,84,12,16.67,337,292,-45,-13.35,415,381,-34,-8.19,ASSIS BRASIL AC,-10.9409203,-69.5672108,0,53
AC,BUJARI,268,286,18,6.72,1,0,-1,-100.0,0,3,3,0.0,70,81,11,15.71,1398,863,-535,-38.27,1737,1233,-504,-29.02,BUJARI AC,-9.8309656,-67.9520886,0,55
AC,CAPIXABA,125,124,-1,-0.8,13,21,8,61.54,0,0,0,0.0,114,106,-8,-7.02,372,384,12,3.23,624,635,11,1.76,CAPIXABA AC,-10.5741345,-67.6759719,0,56
AC,CRUZEIRO DO SUL,90,87,-3,-3.33,526,518,-8,-1.52,723,239,-484,-66.94,2727,2814,87,3.19,4701,5519,818,17.4,8767,9177,410,4.68,CRUZEIRO DO SUL AC,-7.6307956,-72.6703869,0,57
AC,FEIJO,44,41,-3,-6.82,50,47,-3,-6.0,33,29,-4,-12.12,317,303,-14,-4.42,1388,1347,-41,-2.95,1832,1767,-65,-3.55,FEIJO AC,-8.1648652,-70.3539579,0,59
AC,JORDAO,0,0,0,0.0,0,4,4,0.0,0,2,2,0.0,15,18,3,20.0,47,482,435,925.53,62,506,444,716.13,JORDAO AC,-9.1911406,-71.9481397,0,60
AC,MANCIO LIMA,19,29,10,52.63,4,1,-3,-75.0,7,4,-3,-42.86,147,169,22,14.97,685,697,12,1.75,862,900,38,4.41,MANCIO LIMA AC,-7.6145911,-72.905264,0,61
AC,MANOEL URBANO,6,4,-2,-33.33,69,84,15,21.74,0,0,0,0.0,66,74,8,12.12,303,289,-14,-4.62,444,451,7,1.58,MANOEL URBANO AC,-8.838755,-69.2619465,0,62
AC,MARECHAL THAUMATURGO,1,1,0,0.0,0,4,4,0.0,0,0,0,0.0,63,65,2,3.17,1163,714,-449,-38.61,1227,784,-443,-36.1,MARECHAL THAUMATURGO AC,-8.9479792,-72.7872614,0,63
AC,PLACIDO DE CASTRO,129,113,-16,-12.4,113,102,-11,-9.73,0,0,0,0.0,180,185,5,2.78,1051,1367,316,30.07,1473,1767,294,19.96,PLACIDO DE CASTRO AC,-10.3239154,-67.1824196,0,64
AC,PORTO WALTER,0,0,0,0.0,9,4,-5,-55.56,2,0,-2,-100.0,26,28,2,7.69,606,643,37,6.11,643,675,32,4.98,PORTO WALTER AC,-8.2687722,-72.7444458,0,65
AC,RIO BRANCO,1147,1072,-75,-6.54,5113,4678,-435,-8.51,4355,4977,622,14.28,17503,17883,380,2.17,64864,71436,6572,10.13,92982,100046,7064,7.6,RIO BRANCO AC,-9.9765362,-67.8220778,0,66
AC,RODRIGUES ALVES,2,7,5,250.0,0,0,0,0.0,0,0,0,0.0,20,18,-2,-10.0,716,682,-34,-4.75,738,707,-31,-4.2,RODRIGUES ALVES AC,-7.7380283,-72.6509379,0,67
AC,SANTA ROSA DO PURUS,0,0,0,0.0,0,4,4,0.0,0,4,4,0.0,8,8,0,0.0,252,245,-7,-2.78,260,261,1,0.38,SANTA ROSA DO PURUS AC,-9.4354872,-70.4926109,0,68
AC,SENADOR GUIOMARD,525,481,-44,-8.38,285,305,20,7.02,13,1,-12,-92.31,337,290,-47,-13.95,1011,1022,11,1.09,2171,2099,-72,-3.32,SENADOR GUIOMARD AC,-9.9765,-67.31913961038961,0,69
AC,SENA MADUREIRA,245,284,39,15.92,161,192,31,19.25,46,32,-14,-30.43,544,560,16,2.94,1322,1584,262,19.82,2318,2652,334,14.41,SENA MADUREIRA AC,-9.0659556,-68.6571058,0,70
AC,TARAUACA,119,116,-3,-2.52,65,95,30,46.15,22,17,-5,-22.73,562,591,29,5.16,1130,1174,44,3.89,1898,1993,95,5.01,TARAUACA AC,-8.1602019,-70.7665368,0,71
AC,XAPURI,189,152,-37,-19.58,192,152,-40,-20.83,0,0,0,0.0,203,238,35,17.24,388,384,-4,-1.03,972,926,-46,-4.73,XAPURI AC,-10.6511174,-68.5017902,0,72
AC,PORTO ACRE,190,215,25,13.16,35,29,-6,-17.14,1,2,1,100.0,145,209,64,44.14,728,606,-122,-16.76,1099,1061,-38,-3.46,PORTO ACRE AC,-9.5879722,-67.53307,0,73
AM,ALVARAES,1,0,-1,-100.0,8,6,-2,-25.0,0,0,0,0.0,68,48,-20,-29.41,689,488,-201,-29.17,766,542,-224,-29.24,ALVARAES AM,-3.214786,-64.8143124,2,74
AM,AMATURA,0,0,0,0.0,4,5,1,25.0,0,0,0,0.0,2,7,5,250.0,554,421,-133,-24.01,560,433,-127,-22.68,AMATURA AM,-3.3640509,-68.1994689,2,75
AM,ANAMA,0,0,0,0.0,3,4,1,33.33,0,0,0,0.0,2,3,1,50.0,450,352,-98,-21.78,455,359,-96,-21.1,ANAMA AM,-3.5797356,-61.4049996,2,76
AM,ANORI,0,0,0,0.0,4,1,-3,-75.0,0,17,17,0.0,11,10,-1,-9.09,724,361,-363,-50.14,739,389,-350,-47.36,ANORI AM,-3.7435254,-61.6605203,2,77
AM,APUI,7,10,3,42.86,8,15,7,87.5,26,14,-12,-46.15,206,199,-7,-3.4,616,531,-85,-13.8,863,769,-94,-10.89,APUI AM,-7.1940195,-59.8830192,2,78
AM,ATALAIA DO NORTE,0,0,0,0.0,25,39,14,56.0,0,0,0,0.0,11,7,-4,-36.36,1116,170,-946,-84.77,1152,216,-936,-81.25,ATALAIA DO NORTE AM,-4.3658547,-70.1908742,2,79
AM,AUTAZES,10,12,2,20.0,59,88,29,49.15,0,0,0,0.0,226,256,30,13.27,1953,977,-976,-49.97,2248,1333,-915,-40.7,AUTAZES AM,-3.5833283,-59.1301518,2,80
AM,BARCELOS,0,0,0,0.0,17,25,8,47.06,0,0,0,0.0,82,91,9,10.98,790,972,182,23.04,889,1088,199,22.38,BARCELOS AM,-0.9729214,-62.925635,2,81
AM,BARREIRINHA,0,0,0,0.0,25,14,-11,-44.0,1,3,2,200.0,92,88,-4,-4.35,1915,555,-1360,-71.02,2033,660,-1373,-67.54,BARREIRINHA AM,-2.798863,-57.067897,2,82
AM,BENJAMIN CONSTANT,0,0,0,0.0,50,47,-3,-6.0,38,0,-38,-100.0,89,95,6,6.74,2443,2330,-113,-4.63,2620,2472,-148,-5.65,BENJAMIN CONSTANT AM,-4.3782748,-70.0290603,2,83
AM,BERURI,0,0,0,0.0,13,5,-8,-61.54,0,0,0,0.0,4,9,5,125.0,1193,33,-1160,-97.23,1210,47,-1163,-96.12,BERURI AM,-3.9007135,-61.3717319,2,84
AM,BOA VISTA DO RAMOS,0,0,0,0.0,14,9,-5,-35.71,0,0,0,0.0,25,32,7,28.0,817,1387,570,69.77,856,1428,572,66.82,BOA VISTA DO RAMOS AM,-2.9716927,-57.5869819,2,85
AM,BOCA DO ACRE,371,383,12,3.23,408,384,-24,-5.88,0,15,15,0.0,217,237,20,9.22,1627,1639,12,0.74,2623,2658,35,1.33,BOCA DO ACRE AM,-8.7553487,-67.3930873,2,86
AM,BORBA,0,0,0,0.0,45,42,-3,-6.67,0,0,0,0.0,121,108,-13,-10.74,2236,2507,271,12.12,2402,2657,255,10.62,BORBA AM,-4.3934778,-59.5947721,2,87
AM,CAAPIRANGA,0,0,0,0.0,3,2,-1,-33.33,0,0,0,0.0,3,3,0,0.0,872,954,82,9.4,878,959,81,9.23,CAAPIRANGA AM,-3.3188884,-61.2096404,2,88
AM,CANUTAMA,26,24,-2,-7.69,6,4,-2,-33.33,0,0,0,0.0,9,10,1,11.11,514,517,3,0.58,555,555,0,0.0,CANUTAMA AM,-6.5330019,-64.3834966,2,89
AM,CARAUARI,10,10,0,0.0,40,32,-8,-20.0,1,0,-1,-100.0,77,82,5,6.49,1369,1472,103,7.52,1497,1596,99,6.61,CARAUARI AM,-4.8766426,-66.8961433,2,90
AM,CAREIRO,4,4,0,0.0,23,10,-13,-56.52,0,4,4,0.0,118,104,-14,-11.86,1076,1136,60,5.58,1221,1258,37,3.03,CAREIRO AM,-3.8185277,-60.3616505,2,91
AM,CAREIRO DA VARZEA,0,0,0,0.0,8,4,-4,-50.0,0,0,0,0.0,17,13,-4,-23.53,1139,949,-190,-16.68,1164,966,-198,-17.01,CAREIRO DA VARZEA AM,-3.197024,-59.8259104,2,92
AM,COARI,4,4,0,0.0,441,520,79,17.91,13,0,-13,-100.0,631,588,-43,-6.81,585,5591,5006,855.73,1674,6703,5029,300.42,COARI AM,-4.0885957,-63.1431166,2,93
AM,CODAJAS,0,0,0,0.0,20,20,0,0.0,0,0,0,0.0,36,47,11,30.56,795,555,-240,-30.19,851,622,-229,-26.91,CODAJAS AM,-3.8413202,-62.0603444,2,94
AM,EIRUNEPE,0,0,0,0.0,38,34,-4,-10.53,22,6,-16,-72.73,130,126,-4,-3.08,1412,1396,-16,-1.13,1602,1562,-40,-2.5,EIRUNEPE AM,-6.6567654,-69.866161,2,95
AM,ENVIRA,2,2,0,0.0,16,11,-5,-31.25,0,0,0,0.0,43,29,-14,-32.56,901,557,-344,-38.18,962,599,-363,-37.73,ENVIRA AM,-7.437889,-70.028143,2,96
AM,FONTE BOA,0,0,0,0.0,5,4,-1,-20.0,0,0,0,0.0,30,30,0,0.0,1891,1443,-448,-23.69,1926,1477,-449,-23.31,FONTE BOA AM,-2.55,-66.91321428571428,2,97
AM,GUAJARA,7,27,20,285.71,5,5,0,0.0,0,0,0,0.0,19,11,-8,-42.11,606,624,18,2.97,637,667,30,4.71,GUAJARA AM,-7.5455927,-72.5832769,2,98
AM,HUMAITA,29,64,35,120.69,180,228,48,26.67,11,12,1,9.09,929,952,23,2.48,1892,1702,-190,-10.04,3041,2958,-83,-2.73,HUMAITA AM,-7.5099404,-63.0248674,2,99
AM,IPIXUNA,1,1,0,0.0,15,11,-4,-26.67,0,0,0,0.0,12,19,7,58.33,331,331,0,0.0,359,362,3,0.84,IPIXUNA AM,-7.047909,-71.693426,2,100
AM,IRANDUBA,156,146,-10,-6.41,951,1113,162,17.03,72,92,20,27.78,352,336,-16,-4.55,2645,2408,-237,-8.96,4176,4095,-81,-1.94,IRANDUBA AM,-3.2758203,-60.1867429,2,101
AM,ITACOATIARA,183,75,-108,-59.02,1054,1161,107,10.15,79,52,-27,-34.18,1465,1446,-19,-1.3,6028,5776,-252,-4.18,8809,8510,-299,-3.39,ITACOATIARA AM,-3.1477898,-58.4461041,2,102
AM,ITAMARATI,0,0,0,0.0,5,2,-3,-60.0,0,0,0,0.0,0,8,8,0.0,854,475,-379,-44.38,859,485,-374,-43.54,ITAMARATI AM,-6.4385189,-68.2437385,2,103
AM,ITAPIRANGA,0,0,0,0.0,5,6,1,20.0,0,0,0,0.0,23,30,7,30.43,311,212,-99,-31.83,339,248,-91,-26.84,ITAPIRANGA AM,-2.7461205,-58.025377,2,104
AM,JAPURA,0,2,2,0.0,13,4,-9,-69.23,0,0,0,0.0,16,19,3,18.75,13,8,-5,-38.46,42,33,-9,-21.43,JAPURA AM,-1.8808468,-66.9967657,2,105
AM,JURUA,0,1,1,0.0,18,15,-3,-16.67,0,0,0,0.0,39,45,6,15.38,925,956,31,3.35,982,1017,35,3.56,JURUA AM,-3.4746666,-66.0622335,2,106
AM,JUTAI,0,0,0,0.0,6,5,-1,-16.67,0,0,0,0.0,33,31,-2,-6.06,635,727,92,14.49,674,763,89,13.2,JUTAI AM,-2.7471478,-66.7721255,2,107
AM,LABREA,108,144,36,33.33,68,35,-33,-48.53,0,0,0,0.0,265,273,8,3.02,1673,1687,14,0.84,2114,2139,25,1.18,LABREA AM,-7.2613683,-64.7924505,2,108
AM,MANACAPURU,93,132,39,41.94,797,678,-119,-14.93,26,11,-15,-57.69,1274,1213,-61,-4.79,4499,1593,-2906,-64.59,6689,3627,-3062,-45.78,MANACAPURU AM,-3.2996768,-60.6213528,2,109
AM,MANAQUIRI,0,0,0,0.0,10,5,-5,-50.0,0,0,0,0.0,16,31,15,93.75,1125,870,-255,-22.67,1151,906,-245,-21.29,MANAQUIRI AM,-3.4305885,-60.4593078,2,110
AM,MANAUS,1155,1186,31,2.68,93908,99663,5755,6.13,17769,20291,2522,14.19,83973,85886,1913,2.28,291915,292885,970,0.33,488720,499911,11191,2.29,MANAUS AM,-3.1316333,-59.9825041,2,111
AM,MANICORE,41,24,-17,-41.46,114,84,-30,-26.32,0,1,1,0.0,258,236,-22,-8.53,1346,1171,-175,-13.0,1759,1516,-243,-13.81,MANICORE AM,-5.804618,-61.289483,2,112
AM,MARAA,0,0,0,0.0,6,3,-3,-50.0,0,8,8,0.0,8,10,2,25.0,11,440,429,3900.0,25,461,436,1744.0,MARAA AM,-1.8535579,-65.5897749,2,113
AM,MAUES,16,14,-2,-12.5,92,88,-4,-4.35,9,2,-7,-77.78,334,377,43,12.87,2752,2596,-156,-5.67,3203,3077,-126,-3.93,MAUES AM,-3.3795798,-57.7196072,2,114
AM,NHAMUNDA,0,0,0,0.0,7,4,-3,-42.86,0,0,0,0.0,53,57,4,7.55,938,813,-125,-13.33,998,874,-124,-12.42,NHAMUNDA AM,-2.1921521,-56.7111308,2,115
AM,NOVA OLINDA DO NORTE,0,0,0,0.0,42,50,8,19.05,0,0,0,0.0,181,189,8,4.42,1315,1093,-222,-16.88,1538,1332,-206,-13.39,NOVA OLINDA DO NORTE AM,-3.8926889,-59.0953046,2,116
AM,NOVO AIRAO,0,1,1,0.0,14,10,-4,-28.57,4,0,-4,-100.0,72,45,-27,-37.5,1016,1030,14,1.38,1106,1086,-20,-1.81,NOVO AIRAO AM,-2.6260236,-60.9434406,2,117
AM,NOVO ARIPUANA,3,3,0,0.0,21,23,2,9.52,3,0,-3,-100.0,34,28,-6,-17.65,801,655,-146,-18.23,862,709,-153,-17.75,NOVO ARIPUANA AM,-5.125929,-60.373179,2,118
AM,PARINTINS,0,6,6,0.0,326,341,15,4.6,15,13,-2,-13.33,1549,1545,-4,-0.26,3570,2236,-1334,-37.37,5460,4141,-1319,-24.16,PARINTINS AM,-2.6344567,-56.7319324,2,119
AM,PAUINI,0,0,0,0.0,8,4,-4,-50.0,0,0,0,0.0,0,1,1,0.0,1003,739,-264,-26.32,1011,744,-267,-26.41,PAUINI AM,-7.7122214,-66.9998441,2,120
AM,PRESIDENTE FIGUEIREDO,888,812,-76,-8.56,1381,1386,5,0.36,10,9,-1,-10.0,339,291,-48,-14.16,2737,2559,-178,-6.5,5355,5057,-298,-5.56,PRESIDENTE FIGUEIREDO AM,-2.0486359,-60.0236658,2,121
AM,RIO PRETO DA EVA,170,152,-18,-10.59,249,225,-24,-9.64,13,5,-8,-61.54,174,176,2,1.15,1334,1102,-232,-17.39,1940,1660,-280,-14.43,RIO PRETO DA EVA AM,-2.6990647,-59.7012494,2,122
AM,SANTA ISABEL DO RIO NEGRO,0,0,0,0.0,7,2,-5,-71.43,0,0,0,0.0,13,11,-2,-15.38,560,223,-337,-60.18,580,236,-344,-59.31,SANTA ISABEL DO RIO NEGRO AM,-0.4160389,-65.0153096,2,123
AM,SANTO ANTONIO DO ICA,0,1,1,0.0,8,9,1,12.5,0,0,0,0.0,106,110,4,3.77,1022,259,-763,-74.66,1136,379,-757,-66.64,SANTO ANTONIO DO ICA AM,-3.095443,-67.946279,2,124
AM,SAO GABRIEL DA CACHOEIRA,1,0,-1,-100.0,15,28,13,86.67,5,5,0,0.0,275,198,-77,-28.0,1839,1497,-342,-18.6,2135,1728,-407,-19.06,SAO GABRIEL DA CACHOEIRA AM,-0.1249715,-67.0813855,2,125
AM,SAO PAULO DE OLIVENCA,0,0,0,0.0,25,21,-4,-16.0,0,0,0,0.0,36,34,-2,-5.56,999,989,-10,-1.0,1060,1044,-16,-1.51,SAO PAULO DE OLIVENCA AM,-3.4650627,-68.9468462,2,126
AM,SAO SEBASTIAO DO UATUMA,0,0,0,0.0,4,3,-1,-25.0,4,1,-3,-75.0,33,43,10,30.3,538,543,5,0.93,579,590,11,1.9,SAO SEBASTIAO DO UATUMA AM,-2.5719341,-57.8703616,2,127
AM,SILVES,0,0,0,0.0,7,17,10,142.86,0,0,0,0.0,5,7,2,40.0,499,275,-224,-44.89,511,299,-212,-41.49,SILVES AM,-2.8372614,-58.2105199,2,128
AM,TABATINGA,0,3,3,0.0,118,82,-36,-30.51,5,6,1,20.0,712,626,-86,-12.08,3208,3215,7,0.22,4043,3932,-111,-2.75,TABATINGA AM,-4.2327349,-69.9263372,2,129
AM,TAPAUA,0,1,1,0.0,4,5,1,25.0,0,0,0,0.0,5,6,1,20.0,1595,1349,-246,-15.42,1604,1361,-243,-15.15,TAPAUA AM,-5.6232283,-63.1879157,2,130
AM,TEFE,1,1,0,0.0,166,139,-27,-16.27,19,24,5,26.32,972,954,-18,-1.85,1893,1770,-123,-6.5,3051,2888,-163,-5.34,TEFE AM,-3.3485276,-64.7102278,2,131
AM,TONANTINS,0,0,0,0.0,6,1,-5,-83.33,0,0,0,0.0,1,6,5,500.0,1011,19,-992,-98.12,1018,26,-992,-97.45,TONANTINS AM,-2.86261,-67.7735482,2,132
AM,UARINI,0,0,0,0.0,14,7,-7,-50.0,0,0,0,0.0,27,28,1,3.7,349,291,-58,-16.62,390,326,-64,-16.41,UARINI AM,-2.9827061,-65.1578615,2,133
AM,URUCARA,4,6,2,50.0,28,20,-8,-28.57,0,0,0,0.0,31,41,10,32.26,729,1156,427,58.57,792,1223,431,54.42,URUCARA AM,-2.537073,-57.7590254,2,134
AM,URUCURITUBA,0,0,0,0.0,12,7,-5,-41.67,0,0,0,0.0,16,46,30,187.5,873,377,-496,-56.82,901,430,-471,-52.28,URUCURITUBA AM,-3.1304332,-58.1549157,2,135
RR,AMAJARI,95,59,-36,-37.89,1,1,0,0.0,0,0,0,0.0,16,9,-7,-43.75,448,451,3,0.67,560,520,-40,-7.14,AMAJARI RR,3.6523869,-61.4194315,21,136
RR,ALTO ALEGRE,101,104,3,2.97,0,0,0,0.0,0,1,1,0.0,38,46,8,21.05,709,640,-69,-9.73,848,791,-57,-6.72,ALTO ALEGRE RR,2.98858,-61.307167,21,137
RR,BOA VISTA,481,530,49,10.19,3069,3344,275,8.96,3448,4850,1402,40.66,17771,18253,482,2.71,64336,64017,-319,-0.5,89105,90994,1889,2.12,BOA VISTA RR,2.8208478,-60.6719582,21,138
RR,BONFIM,372,341,-31,-8.33,0,0,0,0.0,0,0,0,0.0,54,42,-12,-22.22,757,649,-108,-14.27,1183,1032,-151,-12.76,BONFIM RR,3.3613818,-59.8427241,21,139
RR,CANTA,72,59,-13,-18.06,83,110,27,32.53,5,206,201,4020.0,47,37,-10,-21.28,861,1129,268,31.13,1068,1541,473,44.29,CANTA RR,2.60994,-60.605827,21,140
RR,CARACARAI,72,69,-3,-4.17,53,55,2,3.77,6,103,97,1616.67,142,146,4,2.82,1131,1035,-96,-8.49,1404,1408,4,0.28,CARACARAI RR,1.827598,-61.125389,21,141
RR,CAROEBE,28,25,-3,-10.71,0,0,0,0.0,15,1,-14,-93.33,90,80,-10,-11.11,422,418,-4,-0.95,555,524,-31,-5.59,CAROEBE RR,0.8808696,-59.6963796,21,142
RR,IRACEMA,24,20,-4,-16.67,0,0,0,0.0,0,0,0,0.0,22,29,7,31.82,395,205,-190,-48.1,441,254,-187,-42.4,IRACEMA RR,2.1664742,-61.0513048,21,143
RR,MUCAJAI,127,114,-13,-10.24,115,93,-22,-19.13,14,1,-13,-92.86,162,140,-22,-13.58,614,441,-173,-28.18,1032,789,-243,-23.55,MUCAJAI RR,2.4486084,-60.9199986,21,144
RR,NORMANDIA,42,40,-2,-4.76,0,0,0,0.0,3,0,-3,-100.0,25,17,-8,-32.0,461,284,-177,-38.39,531,341,-190,-35.78,NORMANDIA RR,3.8792356,-59.6293367,21,145
RR,PACARAIMA,16,0,-16,-100.0,32,29,-3,-9.38,8,42,34,425.0,267,219,-48,-17.98,445,293,-152,-34.16,768,583,-185,-24.09,PACARAIMA RR,4.4787884,-61.1389799,21,146
RR,RORAINOPOLIS,197,206,9,4.57,165,145,-20,-12.12,12,12,0,0.0,425,403,-22,-5.18,1495,1075,-420,-28.09,2294,1841,-453,-19.75,RORAINOPOLIS RR,0.9387308,-60.4236464,21,147
RR,SAO JOAO DA BALIZA,10,7,-3,-30.0,237,339,102,43.04,0,0,0,0.0,83,74,-9,-10.84,404,506,102,25.25,734,926,192,26.16,SAO JOAO DA BALIZA RR,0.951659,-59.913293,21,148
RR,SAO LUIZ,13,14,1,7.69,34,26,-8,-23.53,0,0,0,0.0,55,60,5,9.09,595,26,-569,-95.63,697,126,-571,-81.92,SAO LUIZ RR,1.0170607,-60.0371719,21,149
RR,UIRAMUTA,0,0,0,0.0,0,0,0,0.0,0,0,0,0.0,5,13,8,160.0,272,87,-185,-68.01,277,100,-177,-63.9,UIRAMUTA RR,4.5938559,-60.1641831,21,150
PA,ABAETETUBA,235,212,-23,-9.79,286,268,-18,-6.29,85,53,-32,-37.65,2793,3425,632,22.63,6373,5786,-587,-9.21,9772,9744,-28,-0.29,ABAETETUBA PA,-1.721828,-48.878843,13,151
PA,ABEL FIGUEIREDO,95,80,-15,-15.79,170,158,-12,-7.06,0,16,16,0.0,84,57,-27,-32.14,387,280,-107,-27.65,736,591,-145,-19.7,ABEL FIGUEIREDO PA,-4.953001,-48.3958485,13,152
PA,ACARA,1159,1240,81,6.99,225,342,117,52.0,2,2,0,0.0,231,222,-9,-3.9,2542,3450,908,35.72,4159,5256,1097,26.38,ACARA PA,-1.961388,-48.1987043,13,153
PA,AFUA,0,0,0,0.0,273,262,-11,-4.03,2,2,0,0.0,53,50,-3,-5.66,2141,1411,-730,-34.1,2469,1725,-744,-30.13,AFUA PA,-0.1535664,-50.3879223,13,154
PA,AGUA AZUL DO NORTE,690,650,-40,-5.8,661,705,44,6.66,0,0,0,0.0,85,113,28,32.94,683,438,-245,-35.87,2119,1906,-213,-10.05,AGUA AZUL DO NORTE PA,-6.8064885,-50.4849667,13,155
PA,ALENQUER,15,17,2,13.33,56,51,-5,-8.93,5,5,0,0.0,244,235,-9,-3.69,2524,2098,-426,-16.88,2844,2406,-438,-15.4,ALENQUER PA,-1.946229,-54.738355,13,156
PA,ALTAMIRA,450,435,-15,-3.33,881,851,-30,-3.41,2696,503,-2193,-81.34,4888,4754,-134,-2.74,6430,7302,872,13.56,15345,13845,-1500,-9.78,ALTAMIRA PA,-3.204065,-52.209961,13,158
PA,ANAJAS,0,0,0,0.0,37,41,4,10.81,0,0,0,0.0,68,52,-16,-23.53,1137,1032,-105,-9.23,1242,1125,-117,-9.42,ANAJAS PA,-0.9878802,-49.9390114,13,159
PA,ANAPU,50,52,2,4.0,65,42,-23,-35.38,0,0,0,0.0,424,449,25,5.9,976,887,-89,-9.12,1515,1430,-85,-5.61,ANAPU PA,-3.4668292,-51.2057035,13,161
PA,AUGUSTO CORREA,16,4,-12,-75.0,9,22,13,144.44,14,2,-12,-85.71,90,88,-2,-2.22,2415,1346,-1069,-44.27,2544,1462,-1082,-42.53,AUGUSTO CORREA PA,-1.0229335,-46.6404029,13,162
PA,AURORA DO PARA,210,190,-20,-9.52,39,35,-4,-10.26,0,0,0,0.0,72,68,-4,-5.56,990,936,-54,-5.45,1311,1229,-82,-6.25,AURORA DO PARA PA,-2.1323199,-47.558436,13,163
PA,AVEIRO,40,45,5,12.5,24,12,-12,-50.0,0,0,0,0.0,6,7,1,16.67,664,589,-75,-11.3,734,653,-81,-11.04,AVEIRO PA,-3.6029015,-55.328079,13,164
PA,BAGRE,0,0,0,0.0,0,2,2,0.0,0,0,0,0.0,69,61,-8,-11.59,628,694,66,10.51,697,757,60,8.61,BAGRE PA,-1.8994498,-50.2103844,13,165
PA,BAIAO,63,48,-15,-23.81,0,0,0,0.0,0,0,0,0.0,121,112,-9,-7.44,1461,1363,-98,-6.71,1645,1523,-122,-7.42,BAIAO PA,-2.7903479,-49.6702845,13,166
PA,BANNACH,355,311,-44,-12.39,2,2,0,0.0,0,0,0,0.0,33,31,-2,-6.06,172,133,-39,-22.67,562,477,-85,-15.12,BANNACH PA,-7.3508505,-50.4064531,13,167
PA,BARCARENA,18,13,-5,-27.78,5832,6341,509,8.73,5445,5056,-389,-7.14,2701,3284,583,21.58,12543,12457,-86,-0.69,26539,27151,612,2.31,BARCARENA PA,-1.5107945,-48.6190679,13,168
PA,BELEM,1025,1154,129,12.59,13666,14500,834,6.1,20521,21597,1076,5.24,63094,64490,1396,2.21,298393,296973,-1420,-0.48,396699,398714,2015,0.51,BELEM PA,-1.45056,-48.4682453,13,169
PA,BELTERRA,543,518,-25,-4.6,7,5,-2,-28.57,0,0,0,0.0,50,51,1,2.0,860,892,32,3.72,1460,1466,6,0.41,BELTERRA PA,-2.636091,-54.937392,13,170
PA,BOM JESUS DO TOCANTINS,286,175,-111,-38.81,48,64,16,33.33,13,12,-1,-7.69,94,112,18,19.15,750,580,-170,-22.67,1191,943,-248,-20.82,BOM JESUS DO TOCANTINS PA,-5.0471796,-48.5978362,13,172
PA,BONITO,45,72,27,60.0,1119,1311,192,17.16,0,0,0,0.0,27,25,-2,-7.41,732,611,-121,-16.53,1923,2019,96,4.99,BONITO PA,-1.3605722,-47.3049907,13,173
PA,BRAGANCA,80,119,39,48.75,659,654,-5,-0.76,159,190,31,19.5,1883,1942,59,3.13,4352,3798,-554,-12.73,7133,6703,-430,-6.03,BRAGANCA PA,-0.9892329,-46.78317899815352,13,174
PA,BRASIL NOVO,36,21,-15,-41.67,61,96,35,57.38,24,10,-14,-58.33,250,247,-3,-1.2,854,720,-134,-15.69,1225,1094,-131,-10.69,BRASIL NOVO PA,-3.3055853,-52.539198,13,175
PA,BREJO GRANDE DO ARAGUAIA,160,143,-17,-10.62,0,0,0,0.0,4,4,0,0.0,71,84,13,18.31,415,386,-29,-6.99,650,617,-33,-5.08,BREJO GRANDE DO ARAGUAIA PA,-5.7011449,-48.4037308,13,176
PA,BREU BRANCO,386,416,30,7.77,357,362,5,1.4,259,313,54,20.85,699,783,84,12.02,1726,1874,148,8.57,3427,3748,321,9.37,BREU BRANCO PA,-3.7785073,-49.5684795,13,177
PA,BREVES,0,7,7,0.0,122,118,-4,-3.28,7,8,1,14.29,957,977,20,2.09,5884,3953,-1931,-32.82,6970,5063,-1907,-27.36,BREVES PA,-1.68036,-50.479085,13,178
PA,BUJARU,54,79,25,46.3,1,9,8,800.0,6,2,-4,-66.67,93,112,19,20.43,1158,739,-419,-36.18,1312,941,-371,-28.28,BUJARU PA,-1.5169239,-48.0410699,13,179
PA,CACHOEIRA DO PIRIA,14,8,-6,-42.86,18,17,-1,-5.56,0,0,0,0.0,34,27,-7,-20.59,662,640,-22,-3.32,728,692,-36,-4.95,CACHOEIRA DO PIRIA PA,-1.7599443,-46.5446954,13,180
PA,CACHOEIRA DO ARARI,38,38,0,0.0,38,46,8,21.05,0,0,0,0.0,68,86,18,26.47,946,824,-122,-12.9,1090,994,-96,-8.81,CACHOEIRA DO ARARI PA,-1.0143572,-48.9621089,13,181
PA,CAMETA,0,1,1,0.0,83,49,-34,-40.96,7,6,-1,-14.29,924,879,-45,-4.87,4932,4928,-4,-0.08,5946,5863,-83,-1.4,CAMETA PA,-2.242949,-49.497885,13,182
PA,CANAA DOS CARAJAS,266,228,-38,-14.29,4527,4935,408,9.01,1492,4037,2545,170.58,1198,1346,148,12.35,6167,8039,1872,30.36,13650,18585,4935,36.15,CANAA DOS CARAJAS PA,-6.5296837,-49.8516592,13,183
PA,CAPITAO POCO,572,513,-59,-10.31,149,175,26,17.45,7,9,2,28.57,633,785,152,24.01,1977,1232,-745,-37.68,3338,2714,-624,-18.69,CAPITAO POCO PA,-1.7447162,-47.0638495,13,185
PA,CASTANHAL,643,694,51,7.93,7008,8150,1142,16.3,892,845,-47,-5.27,10091,10055,-36,-0.36,12297,11808,-489,-3.98,30931,31552,621,2.01,CASTANHAL PA,-1.2927031,-47.9223903,13,186
PA,CHAVES,153,203,50,32.68,9,9,0,0.0,0,2,2,0.0,11,6,-5,-45.45,743,748,5,0.67,916,968,52,5.68,CHAVES PA,-0.164154,-49.987006,13,187
PA,COLARES,1,2,1,100.0,0,1,1,0.0,0,0,0,0.0,52,44,-8,-15.38,479,577,98,20.46,532,624,92,17.29,COLARES PA,-0.936423,-48.280254,13,188
PA,CONCEICAO DO ARAGUAIA,273,267,-6,-2.2,274,226,-48,-17.52,48,70,22,45.83,1051,1088,37,3.52,2076,1723,-353,-17.0,3722,3374,-348,-9.35,CONCEICAO DO ARAGUAIA PA,-8.2696905,-49.2676864,13,189
PA,CONCORDIA DO PARA,1084,1222,138,12.73,149,123,-26,-17.45,5,26,21,420.0,304,281,-23,-7.57,1188,65,-1123,-94.53,2730,1717,-1013,-37.11,CONCORDIA DO PARA PA,-1.9924056,-47.9450474,13,190
PA,CUMARU DO NORTE,1273,1035,-238,-18.7,20,18,-2,-10.0,0,0,0,0.0,33,27,-6,-18.18,494,447,-47,-9.51,1820,1527,-293,-16.1,CUMARU DO NORTE PA,-7.8122669,-50.7677675,13,191
PA,CURIONOPOLIS,446,459,13,2.91,761,926,165,21.68,11,15,4,36.36,232,237,5,2.16,588,359,-229,-38.95,2038,1996,-42,-2.06,CURIONOPOLIS PA,-6.0990443,-49.6059039,13,192
PA,CURRALINHO,0,0,0,0.0,1,0,-1,-100.0,0,0,0,0.0,30,31,1,3.33,1806,1215,-591,-32.72,1837,1246,-591,-32.17,CURRALINHO PA,-1.8115866,-49.7975682,13,193
PA,CURUA,0,0,0,0.0,0,0,0,0.0,0,0,0,0.0,18,27,9,50.0,918,762,-156,-16.99,936,789,-147,-15.71,CURUA PA,-1.887754,-55.116842,13,194
PA,CURUCA,68,65,-3,-4.41,129,194,65,50.39,4,4,0,0.0,202,190,-12,-5.94,1657,1046,-611,-36.87,2060,1499,-561,-27.23,CURUCA PA,-0.7276792,-47.856568,13,195
PA,DOM ELISEU,865,709,-156,-18.03,495,432,-63,-12.73,38,37,-1,-2.63,1150,1301,151,13.13,1707,1447,-260,-15.23,4255,3926,-329,-7.73,DOM ELISEU PA,-4.2928111,-47.5559083,13,196
PA,FLORESTA DO ARAGUAIA,215,201,-14,-6.51,24,50,26,108.33,1,1,0,0.0,205,193,-12,-5.85,961,691,-270,-28.1,1406,1136,-270,-19.2,FLORESTA DO ARAGUAIA PA,-7.5597065,-49.7032829,13,199
PA,GARRAFAO DO NORTE,41,39,-2,-4.88,125,106,-19,-15.2,1,1,0,0.0,88,94,6,6.82,1441,953,-488,-33.87,1696,1193,-503,-29.66,GARRAFAO DO NORTE PA,-1.9282256,-47.0513157,13,200
PA,GOIANESIA DO PARA,347,289,-58,-16.71,159,291,132,83.02,5,4,-1,-20.0,406,444,38,9.36,1796,1980,184,10.24,2713,3008,295,10.87,GOIANESIA DO PARA PA,-3.8380998,-49.0977992,13,201
PA,GURUPA,0,0,0,0.0,0,0,0,0.0,1,0,-1,-100.0,46,41,-5,-10.87,1789,1512,-277,-15.48,1836,1553,-283,-15.41,GURUPA PA,-1.406325,-51.6427456,13,202
PA,IGARAPE-ACU,532,575,43,8.08,198,204,6,3.03,1,1,0,0.0,471,493,22,4.67,1167,914,-253,-21.68,2369,2187,-182,-7.68,IGARAPE-ACU PA,-4.2865751,-55.6346369,13,203
PA,IGARAPE-MIRI,10,9,-1,-10.0,266,243,-23,-8.65,18,9,-9,-50.0,402,487,85,21.14,2495,2368,-127,-5.09,3191,3116,-75,-2.35,IGARAPE-MIRI PA,-1.9785213,-48.9634826,13,204
PA,INHANGAPI,127,108,-19,-14.96,295,326,31,10.51,4,0,-4,-100.0,34,38,4,11.76,549,530,-19,-3.46,1009,1002,-7,-0.69,INHANGAPI PA,-1.4283738,-47.9108608,13,205
PA,IPIXUNA DO PARA,371,381,10,2.7,357,308,-49,-13.73,7,2,-5,-71.43,181,194,13,7.18,3112,1845,-1267,-40.71,4028,2730,-1298,-32.22,IPIXUNA DO PARA PA,-2.5592139,-47.4965462,13,206
PA,IRITUIA,89,111,22,24.72,121,97,-24,-19.83,4,7,3,75.0,105,115,10,9.52,1399,992,-407,-29.09,1718,1322,-396,-23.05,IRITUIA PA,-1.7709543,-47.4399687,13,207
PA,ITAITUBA,143,170,27,18.88,1520,1639,119,7.83,332,529,197,59.34,3305,3616,311,9.41,6169,6962,793,12.85,11469,12916,1447,12.62,ITAITUBA PA,-4.2625218,-55.9878139,13,208
PA,ITUPIRANGA,375,315,-60,-16.0,113,86,-27,-23.89,276,189,-87,-31.52,403,509,106,26.3,1758,1607,-151,-8.59,2925,2706,-219,-7.49,ITUPIRANGA PA,-5.1337224,-49.3321988,13,209
PA,JACAREACANGA,60,53,-7,-11.67,76,56,-20,-26.32,16,3,-13,-81.25,90,117,27,30.0,515,423,-92,-17.86,757,652,-105,-13.87,JACAREACANGA PA,-6.2196518,-57.758625,13,210
PA,JACUNDA,155,136,-19,-12.26,333,446,113,33.93,23,11,-12,-52.17,877,879,2,0.23,2242,2217,-25,-1.12,3630,3689,59,1.63,JACUNDA PA,-4.446173,-49.115272,13,211
PA,JURUTI,94,52,-42,-44.68,553,600,47,8.5,563,602,39,6.93,434,497,63,14.52,2818,2630,-188,-6.67,4462,4381,-81,-1.82,JURUTI PA,-2.1571381,-56.0900977,13,212
PA,LIMOEIRO DO AJURU,0,0,0,0.0,2,2,0,0.0,0,0,0,0.0,29,31,2,6.9,1101,994,-107,-9.72,1132,1027,-105,-9.28,LIMOEIRO DO AJURU PA,-1.88664405,-49.495701348909165,13,213
PA,MAE DO RIO,192,199,7,3.65,144,125,-19,-13.19,3,8,5,166.67,607,577,-30,-4.94,1575,1132,-443,-28.13,2521,2041,-480,-19.04,MAE DO RIO PA,-2.0458692,-47.5522076,13,214
PA,MAGALHAES BARATA,4,5,1,25.0,7,7,0,0.0,0,0,0,0.0,6,7,1,16.67,552,165,-387,-70.11,569,184,-385,-67.66,MAGALHAES BARATA PA,-0.8346168,-47.62963129677816,13,215
PA,MARABA,1130,970,-160,-14.16,7781,7973,192,2.47,4205,5814,1609,38.26,13163,13648,485,3.68,23383,22190,-1193,-5.1,49662,50595,933,1.88,MARABA PA,-5.3462821,-49.1007401,13,216
PA,MARACANA,63,77,14,22.22,2,4,2,100.0,26,17,-9,-34.62,37,42,5,13.51,1250,1401,151,12.08,1378,1541,163,11.83,MARACANA PA,-0.7666582,-47.4537818,13,217
PA,MARAPANIM,33,31,-2,-6.06,16,17,1,6.25,0,0,0,0.0,171,173,2,1.17,1261,751,-510,-40.44,1481,972,-509,-34.37,MARAPANIM PA,-0.7134493,-47.6985381,13,218
PA,MEDICILANDIA,81,75,-6,-7.41,17,28,11,64.71,15,4,-11,-73.33,279,345,66,23.66,859,816,-43,-5.01,1251,1268,17,1.36,MEDICILANDIA PA,-3.4438388,-52.8889236,13,220
PA,MELGACO,0,0,0,0.0,9,8,-1,-11.11,0,0,0,0.0,40,75,35,87.5,893,858,-35,-3.92,942,941,-1,-0.11,MELGACO PA,-1.803202,-50.714927,13,221
PA,MOCAJUBA,3,0,-3,-100.0,31,41,10,32.26,4,3,-1,-25.0,151,134,-17,-11.26,1812,1439,-373,-20.58,2001,1617,-384,-19.19,MOCAJUBA PA,-2.583098,-49.504224,13,222
PA,MOJU,3214,3903,689,21.44,992,1126,134,13.51,22,20,-2,-9.09,638,592,-46,-7.21,2675,2928,253,9.46,7541,8569,1028,13.63,MOJU PA,-1.889926,-48.766765,13,223
PA,MONTE ALEGRE,55,66,11,20.0,72,84,12,16.67,11,21,10,90.91,442,412,-30,-6.79,2655,2466,-189,-7.12,3235,3049,-186,-5.75,MONTE ALEGRE PA,-1.9989108,-54.0727694,13,225
PA,MUANA,26,27,1,3.85,4,9,5,125.0,0,0,0,0.0,39,37,-2,-5.13,940,971,31,3.3,1009,1044,35,3.47,MUANA PA,-1.5317443,-49.2223565,13,226
PA,NOVA ESPERANCA DO PIRIA,69,62,-7,-10.14,1,1,0,0.0,0,0,0,0.0,101,95,-6,-5.94,716,654,-62,-8.66,887,812,-75,-8.46,NOVA ESPERANCA DO PIRIA PA,-2.2663093,-46.9661622,13,227
PA,NOVA IPIXUNA,76,59,-17,-22.37,107,126,19,17.76,0,0,0,0.0,89,129,40,44.94,559,469,-90,-16.1,831,783,-48,-5.78,NOVA IPIXUNA PA,-4.916221,-49.082194,13,228
PA,NOVA TIMBOTEUA,89,86,-3,-3.37,7,6,-1,-14.29,0,0,0,0.0,81,91,10,12.35,768,768,0,0.0,945,951,6,0.63,NOVA TIMBOTEUA PA,-1.2052428,-47.3935775,13,229
PA,NOVO PROGRESSO,355,329,-26,-7.32,664,593,-71,-10.69,30,22,-8,-26.67,1245,1240,-5,-0.4,1646,1694,48,2.92,3940,3878,-62,-1.57,NOVO PROGRESSO PA,-7.0374884,-55.4185904,13,230
PA,NOVO REPARTIMENTO,436,386,-50,-11.47,54,117,63,116.67,24,39,15,62.5,1061,1035,-26,-2.45,2743,2580,-163,-5.94,4318,4157,-161,-3.73,NOVO REPARTIMENTO PA,-4.2519172,-49.9524257,13,231
PA,OBIDOS,53,53,0,0.0,236,236,0,0.0,6,197,191,3183.33,461,485,24,5.21,2138,2005,-133,-6.22,2894,2976,82,2.83,OBIDOS PA,-1.901072,-55.520812,13,232
PA,OEIRAS DO PARA,0,0,0,0.0,4,3,-1,-25.0,2,0,-2,-100.0,32,27,-5,-15.62,1062,1035,-27,-2.54,1100,1065,-35,-3.18,OEIRAS DO PARA PA,-2.0040813,-49.8596065,13,233
PA,ORIXIMINA,41,80,39,95.12,1702,1811,109,6.4,866,828,-38,-4.39,678,709,31,4.57,2933,2765,-168,-5.73,6220,6193,-27,-0.43,ORIXIMINA PA,-1.7669992,-55.868285,13,234
PA,OUREM,25,25,0,0.0,59,64,5,8.47,0,0,0,0.0,90,119,29,32.22,22,575,553,2513.64,196,783,587,299.49,OUREM PA,-1.5489964,-47.1174572,13,235
PA,OURILANDIA DO NORTE,138,162,24,17.39,922,1034,112,12.15,2,6,4,200.0,484,517,33,6.82,1676,1717,41,2.45,3222,3436,214,6.64,OURILANDIA DO NORTE PA,-6.748975,-51.0788476,13,236
PA,PACAJA,200,171,-29,-14.5,3,2,-1,-33.33,72,65,-7,-9.72,476,440,-36,-7.56,1789,3290,1501,83.9,2540,3968,1428,56.22,PACAJA PA,-3.8354195,-50.6399248,13,237
PA,PALESTINA DO PARA,132,121,-11,-8.33,10,10,0,0.0,3,3,0,0.0,48,44,-4,-8.33,300,304,4,1.33,493,482,-11,-2.23,PALESTINA DO PARA PA,-5.7423938,-48.3185533,13,238
PA,PARAGOMINAS,2911,2791,-120,-4.12,3900,4033,133,3.41,1417,1458,41,2.89,4115,3952,-163,-3.96,6194,6087,-107,-1.73,18537,18321,-216,-1.17,PARAGOMINAS PA,-2.99564,-47.3548942,13,239
PA,PARAUAPEBAS,289,323,34,11.76,9952,11776,1824,18.33,9231,12649,3418,37.03,8855,9633,778,8.79,23354,25491,2137,9.15,51681,59872,8191,15.85,PARAUAPEBAS PA,-6.0696846,-49.8903283,13,240
PA,PEIXE-BOI,54,46,-8,-14.81,3,2,-1,-33.33,0,0,0,0.0,5,6,1,20.0,238,242,4,1.68,300,296,-4,-1.33,PEIXE-BOI PA,-1.193824,-47.324031,13,242
PA,PICARRA,521,415,-106,-20.35,125,159,34,27.2,8,1,-7,-87.5,102,106,4,3.92,574,492,-82,-14.29,1330,1173,-157,-11.8,PICARRA PA,-6.4475822,-48.8633795,13,243
PA,PLACAS,14,16,2,14.29,19,11,-8,-42.11,0,0,0,0.0,110,126,16,14.55,803,1016,213,26.53,946,1169,223,23.57,PLACAS PA,-3.8689529,-54.2154346,13,244
PA,PONTA DE PEDRAS,40,40,0,0.0,3,4,1,33.33,0,0,0,0.0,128,114,-14,-10.94,1035,822,-213,-20.58,1206,980,-226,-18.74,PONTA DE PEDRAS PA,-1.3914098,-48.8714528,13,245
PA,PORTEL,139,122,-17,-12.23,190,201,11,5.79,3,4,1,33.33,182,212,30,16.48,3673,2312,-1361,-37.05,4187,2851,-1336,-31.91,PORTEL PA,-1.9387118,-50.8240402,13,246
PA,PORTO DE MOZ,25,29,4,16.0,1,14,13,1300.0,1,3,2,200.0,68,80,12,17.65,1598,1656,58,3.63,1693,1782,89,5.26,PORTO DE MOZ PA,-1.7502089,-52.235556,13,247
PA,PRAINHA,134,121,-13,-9.7,11,21,10,90.91,0,0,0,0.0,48,41,-7,-14.58,1193,1027,-166,-13.91,1386,1210,-176,-12.7,PRAINHA PA,-1.8072874,-53.4797942,13,248
PA,PRIMAVERA,3,3,0,0.0,172,175,3,1.74,32,14,-18,-56.25,56,61,5,8.93,442,336,-106,-23.98,705,589,-116,-16.45,PRIMAVERA PA,-0.9406522,-47.116728,13,249
PA,QUATIPURU,0,0,0,0.0,4,4,0,0.0,0,0,0,0.0,36,29,-7,-19.44,426,543,117,27.46,466,576,110,23.61,QUATIPURU PA,-0.8948725,-47.0049317,13,250
PA,REDENCAO,734,689,-45,-6.13,1444,1418,-26,-1.8,479,598,119,24.84,4427,4323,-104,-2.35,5500,6116,616,11.2,12584,13144,560,4.45,REDENCAO PA,-8.025294,-50.031687,13,251
PA,RIO MARIA,511,514,3,0.59,817,824,7,0.86,32,82,50,156.25,436,440,4,0.92,1026,852,-174,-16.96,2822,2712,-110,-3.9,RIO MARIA PA,-7.3137312,-50.0465372,13,252
PA,RONDON DO PARA,772,682,-90,-11.66,588,538,-50,-8.5,8,9,1,12.5,869,970,101,11.62,1699,505,-1194,-70.28,3936,2704,-1232,-31.3,RONDON DO PARA PA,-4.7804416,-48.06983,13,253
PA,RUROPOLIS,8,8,0,0.0,163,170,7,4.29,5,3,-2,-40.0,292,320,28,9.59,1336,1659,323,24.18,1804,2160,356,19.73,RUROPOLIS PA,-4.1014311,-54.9086853,13,254
PA,SALINOPOLIS,3,0,-3,-100.0,52,49,-3,-5.77,494,548,54,10.93,1037,1034,-3,-0.29,2126,2228,102,4.8,3712,3859,147,3.96,SALINOPOLIS PA,-0.6259282,-47.3442819,13,255
PA,SANTA BARBARA DO PARA,448,362,-86,-19.2,373,437,64,17.16,57,78,21,36.84,623,618,-5,-0.8,1137,681,-456,-40.11,2638,2176,-462,-17.51,SANTA BARBARA DO PARA PA,-1.226144,-48.295101,13,257
PA,SANTA CRUZ DO ARARI,18,17,-1,-5.56,9,9,0,0.0,0,0,0,0.0,5,6,1,20.0,283,270,-13,-4.59,315,302,-13,-4.13,SANTA CRUZ DO ARARI PA,-0.6637491,-49.1729321,13,258
PA,SANTA LUZIA DO PARA,59,50,-9,-15.25,14,0,-14,-100.0,0,0,0,0.0,69,68,-1,-1.45,881,505,-376,-42.68,1023,623,-400,-39.1,SANTA LUZIA DO PARA PA,-1.5220049,-46.9020697,13,260
PA,SANTA MARIA DAS BARREIRAS,970,944,-26,-2.68,3,3,0,0.0,0,4,4,0.0,139,166,27,19.42,542,493,-49,-9.04,1654,1610,-44,-2.66,SANTA MARIA DAS BARREIRAS PA,-8.8710157,-49.7171263,13,261
PA,SANTA MARIA DO PARA,50,65,15,30.0,329,319,-10,-3.04,18,30,12,66.67,349,366,17,4.87,1325,800,-525,-39.62,2071,1580,-491,-23.71,SANTA MARIA DO PARA PA,-1.3455478,-47.5782981,13,262
PA,SANTANA DO ARAGUAIA,1334,1299,-35,-2.62,888,634,-254,-28.6,641,567,-74,-11.54,817,694,-123,-15.06,1321,1320,-1,-0.08,5001,4514,-487,-9.74,SANTANA DO ARAGUAIA PA,-9.3348334,-50.3427734,13,263
PA,SANTAREM,851,800,-51,-5.99,2415,2690,275,11.39,1556,1999,443,28.47,10787,11758,971,9.0,24304,25454,1150,4.73,39913,42701,2788,6.99,SANTAREM PA,-2.438489,-54.699611,13,264
PA,SANTAREM NOVO,7,9,2,28.57,0,0,0,0.0,0,0,0,0.0,11,12,1,9.09,526,226,-300,-57.03,544,247,-297,-54.6,SANTAREM NOVO PA,-0.9283904,-47.3999958,13,265
PA,SANTO ANTONIO DO TAUA,695,723,28,4.03,264,321,57,21.59,0,6,6,0.0,205,211,6,2.93,1194,1192,-2,-0.17,2358,2453,95,4.03,SANTO ANTONIO DO TAUA PA,-1.1522,-48.131446,13,266
PA,SAO CAETANO DE ODIVELAS,67,63,-4,-5.97,11,10,-1,-9.09,1,1,0,0.0,104,95,-9,-8.65,684,506,-178,-26.02,867,675,-192,-22.15,SAO CAETANO DE ODIVELAS PA,-0.747293,-48.024622,13,267
PA,SAO DOMINGOS DO ARAGUAIA,146,116,-30,-20.55,130,85,-45,-34.62,0,0,0,0.0,352,356,4,1.14,1075,1207,132,12.28,1703,1764,61,3.58,SAO DOMINGOS DO ARAGUAIA PA,-5.5416409,-48.7291003,13,268
PA,SAO DOMINGOS DO CAPIM,119,130,11,9.24,11,14,3,27.27,0,4,4,0.0,571,75,-496,-86.87,1337,1062,-275,-20.57,2038,1285,-753,-36.95,SAO DOMINGOS DO CAPIM PA,-1.6789331,-47.7717815,13,269
PA,SAO FELIX DO XINGU,1814,1731,-83,-4.58,503,531,28,5.57,12,11,-1,-8.33,669,701,32,4.78,2573,2697,124,4.82,5571,5671,100,1.8,SAO FELIX DO XINGU PA,-6.6386974,-51.9787582,13,270
PA,SAO FRANCISCO DO PARA,202,217,15,7.43,80,60,-20,-25.0,0,0,0,0.0,65,85,20,30.77,497,409,-88,-17.71,844,771,-73,-8.65,SAO FRANCISCO DO PARA PA,-1.1693995,-47.7972589,13,271
PA,SAO GERALDO DO ARAGUAIA,394,411,17,4.31,881,991,110,12.49,15,19,4,26.67,439,466,27,6.15,1165,1018,-147,-12.62,2894,2905,11,0.38,SAO GERALDO DO ARAGUAIA PA,-6.394715,-48.559169,13,272
PA,SAO JOAO DA PONTA,7,10,3,42.86,0,0,0,0.0,0,0,0,0.0,27,25,-2,-7.41,302,307,5,1.66,336,342,6,1.79,SAO JOAO DA PONTA PA,-0.8526516,-47.9224095,13,273
PA,SAO JOAO DE PIRABAS,15,18,3,20.0,53,57,4,7.55,4,4,0,0.0,63,64,1,1.59,1176,943,-233,-19.81,1311,1086,-225,-17.16,SAO JOAO DE PIRABAS PA,-0.7733201,-47.1770631,13,274
PA,SAO JOAO DO ARAGUAIA,93,82,-11,-11.83,65,90,25,38.46,1,0,-1,-100.0,21,20,-1,-4.76,561,495,-66,-11.76,741,687,-54,-7.29,SAO JOAO DO ARAGUAIA PA,-5.3617017,-48.7911109,13,275
PA,SAO MIGUEL DO GUAMA,128,142,14,10.94,1805,2223,418,23.16,24,11,-13,-54.17,856,875,19,2.22,1855,1850,-5,-0.27,4668,5101,433,9.28,SAO MIGUEL DO GUAMA PA,-1.6116804,-47.4757551,13,276
PA,SAO SEBASTIAO DA BOA VISTA,0,0,0,0.0,2,3,1,50.0,0,0,0,0.0,40,30,-10,-25.0,927,849,-78,-8.41,969,882,-87,-8.98,SAO SEBASTIAO DA BOA VISTA PA,-1.7182884,-49.5319955,13,277
PA,SAPUCAIA,625,515,-110,-17.6,48,54,6,12.5,0,0,0,0.0,114,87,-27,-23.68,575,554,-21,-3.65,1362,1210,-152,-11.16,SAPUCAIA PA,-6.9411006,-49.6991328,13,278
PA,SENADOR JOSE PORFIRIO,17,15,-2,-11.76,35,37,2,5.71,0,0,0,0.0,20,29,9,45.0,564,471,-93,-16.49,636,552,-84,-13.21,SENADOR JOSE PORFIRIO PA,-2.5935424,-51.948209,13,279
PA,TAILANDIA,3308,3611,303,9.16,2417,2812,395,16.34,282,254,-28,-9.93,1455,1726,271,18.63,2828,2642,-186,-6.58,10290,11045,755,7.34,TAILANDIA PA,-2.936096,-48.9523366,13,281
PA,TERRA ALTA,51,56,5,9.8,2,2,0,0.0,0,0,0,0.0,45,43,-2,-4.44,509,265,-244,-47.94,607,366,-241,-39.7,TERRA ALTA PA,-1.0397924,-47.9091595,13,282
PA,TERRA SANTA,104,158,54,51.92,43,37,-6,-13.95,61,109,48,78.69,119,131,12,10.08,1116,870,-246,-22.04,1443,1305,-138,-9.56,TERRA SANTA PA,-2.104435,-56.487653,13,283
PA,TOME-ACU,1803,1893,90,4.99,1800,2028,228,12.67,29,57,28,96.55,960,1139,179,18.65,2134,2589,455,21.32,6726,7706,980,14.57,TOME-ACU PA,-2.4166306,-48.1522907,13,284
PA,TRACUATEUA,12,23,11,91.67,13,39,26,200.0,3,6,3,100.0,80,69,-11,-13.75,1331,422,-909,-68.29,1439,559,-880,-61.15,TRACUATEUA PA,-1.0765338,-46.9030822,13,285
PA,TRAIRAO,21,22,1,4.76,30,42,12,40.0,1,4,3,300.0,230,216,-14,-6.09,691,668,-23,-3.33,973,952,-21,-2.16,TRAIRAO PA,-4.700551,-55.9972165,13,286
PA,TUCUMA,143,141,-2,-1.4,1207,619,-588,-48.72,91,119,28,30.77,1247,1279,32,2.57,1470,1946,476,32.38,4158,4104,-54,-1.3,TUCUMA PA,-6.7517239,-51.1507941,13,287
PA,TUCURUI,165,141,-24,-14.55,693,582,-111,-16.02,89,148,59,66.29,2625,2677,52,1.98,9713,7821,-1892,-19.48,13285,11369,-1916,-14.42,TUCURUI PA,-3.7738509,-49.6708204,13,288
PA,ULIANOPOLIS,621,557,-64,-10.31,1746,1599,-147,-8.42,72,31,-41,-56.94,433,438,5,1.15,1198,1184,-14,-1.17,4070,3809,-261,-6.41,ULIANOPOLIS PA,-3.7575266,-47.5009377,13,289
PA,URUARA,176,164,-12,-6.82,133,89,-44,-33.08,18,24,6,33.33,765,749,-16,-2.09,1740,1235,-505,-29.02,2832,2261,-571,-20.16,URUARA PA,-3.7185381,-53.738549,13,290
PA,VIGIA,663,686,23,3.47,100,92,-8,-8.0,0,2,2,0.0,485,532,47,9.69,1240,1123,-117,-9.44,2488,2435,-53,-2.13,VIGIA PA,-0.8546027,-48.1432873,13,291
PA,VISEU,59,65,6,10.17,14,10,-4,-28.57,1,1,0,0.0,85,89,4,4.71,2148,1616,-532,-24.77,2307,1781,-526,-22.8,VISEU PA,-1.204892,-46.1392244,13,292
PA,VITORIA DO XINGU,133,130,-3,-2.26,0,0,0,0.0,85,26,-59,-69.41,146,99,-47,-32.19,809,791,-18,-2.22,1173,1046,-127,-10.83,VITORIA DO XINGU PA,-2.8833063,-52.0114889,13,293
PA,XINGUARA,1147,1194,47,4.1,2690,2638,-52,-1.93,52,52,0,0.0,2094,2057,-37,-1.77,2623,2634,11,0.42,8606,8575,-31,-0.36,XINGUARA PA,-7.0998514,-49.9416632,13,294
AP,SERRA DO NAVIO,0,0,0,0.0,4,0,-4,-100.0,2,0,-2,-100.0,20,26,6,30.0,46,32,-14,-30.43,72,58,-14,-19.44,SERRA DO NAVIO AP,1.637,-52.272340909090914,3,295
AP,AMAPA,43,48,5,11.63,8,19,11,137.5,0,2,2,0.0,128,64,-64,-50.0,439,182,-257,-58.54,618,315,-303,-49.03,AMAPA AP,2.0529997,-50.7930003,3,296
AP,PEDRA BRANCA DO AMAPARI,1,2,1,100.0,474,478,4,0.84,693,656,-37,-5.34,49,43,-6,-12.24,772,803,31,4.02,1989,1982,-7,-0.35,PEDRA BRANCA DO AMAPARI AP,0.7771833,-51.9523218,3,297
AP,CALCOENE,2,5,3,150.0,123,55,-68,-55.28,0,1,1,0.0,86,77,-9,-10.47,399,387,-12,-3.01,610,525,-85,-13.93,CALCOENE AP,2.4981757,-50.9539503,3,298
AP,CUTIAS,26,23,-3,-11.54,0,0,0,0.0,0,0,0,0.0,34,26,-8,-23.53,269,389,120,44.61,329,438,109,33.13,CUTIAS AP,0.9708625,-50.8000608,3,299
AP,FERREIRA GOMES,2,2,0,0.0,119,98,-21,-17.65,0,0,0,0.0,31,37,6,19.35,72,574,502,697.22,224,711,487,217.41,FERREIRA GOMES AP,0.8580838,-51.1814,3,300
AP,ITAUBAL,11,20,9,81.82,0,0,0,0.0,0,0,0,0.0,6,8,2,33.33,34,364,330,970.59,51,392,341,668.63,ITAUBAL AP,0.6027524,-50.6998737,3,301
AP,MACAPA,397,375,-22,-5.54,2624,2259,-365,-13.91,3566,3213,-353,-9.9,19967,21390,1423,7.13,80650,78386,-2264,-2.81,107204,105623,-1581,-1.47,MACAPA AP,0.0401529,-51.0569588,3,303
AP,MAZAGAO,5,1,-4,-80.0,184,196,12,6.52,9,47,38,422.22,53,56,3,5.66,1031,94,-937,-90.88,1282,394,-888,-69.27,MAZAGAO AP,-0.1160565,-51.2861759,3,304
AP,OIAPOQUE,0,1,1,0.0,64,73,9,14.06,0,0,0,0.0,426,367,-59,-13.85,1127,180,-947,-84.03,1617,621,-996,-61.6,OIAPOQUE AP,3.8432128,-51.8350798,3,305
AP,PORTO GRANDE,344,404,60,17.44,111,51,-60,-54.05,89,74,-15,-16.85,110,128,18,16.36,948,1149,201,21.2,1602,1806,204,12.73,PORTO GRANDE AP,0.7028371,-51.4041605,3,306
AP,PRACUUBA,0,0,0,0.0,0,0,0,0.0,0,0,0,0.0,1,4,3,300.0,12,295,283,2358.33,13,299,286,2200.0,PRACUUBA AP,1.7429041,-50.7848832,3,307
AP,TARTARUGALZINHO,100,104,4,4.0,2,2,0,0.0,9,0,-9,-100.0,63,30,-33,-52.38,533,616,83,15.57,707,752,45,6.36,TARTARUGALZINHO AP,1.5052391,-50.9123126,3,309
TO,ABREULANDIA,83,86,3,3.61,0,3,3,0.0,0,1,1,0.0,15,10,-5,-33.33,138,94,-44,-31.88,236,194,-42,-17.8,ABREULANDIA TO,-9.6221526,-49.1558343,26,311
TO,ALIANCA DO TOCANTINS,138,152,14,10.14,42,53,11,26.19,14,6,-8,-57.14,68,99,31,45.59,330,218,-112,-33.94,592,528,-64,-10.81,ALIANCA DO TOCANTINS TO,-11.3055927,-48.9409096,26,313
TO,ALMAS,148,129,-19,-12.84,63,37,-26,-41.27,0,0,0,0.0,60,55,-5,-8.33,376,25,-351,-93.35,647,246,-401,-61.98,ALMAS TO,-11.5681309,-47.1702803,26,314
TO,ANANAS,222,213,-9,-4.05,19,20,1,5.26,0,2,2,0.0,144,137,-7,-4.86,516,459,-57,-11.05,901,831,-70,-7.77,ANANAS TO,-6.3663053,-48.080238,26,316
TO,ANGICO,75,75,0,0.0,0,4,4,0.0,0,0,0,0.0,5,6,1,20.0,160,112,-48,-30.0,240,197,-43,-17.92,ANGICO TO,-6.3893733,-47.8656722,26,317
TO,APARECIDA DO RIO NEGRO,155,168,13,8.39,46,47,1,2.17,0,0,0,0.0,37,32,-5,-13.51,277,362,85,30.69,515,609,94,18.25,APARECIDA DO RIO NEGRO TO,-9.9513491,-47.9773786,26,318
TO,ARAGOMINAS,180,166,-14,-7.78,5,5,0,0.0,1,0,-1,-100.0,5,3,-2,-40.0,211,165,-46,-21.8,402,339,-63,-15.67,ARAGOMINAS TO,-7.1654101,-48.525488,26,319
TO,ARAGUACEMA,175,145,-30,-17.14,9,17,8,88.89,0,4,4,0.0,43,44,1,2.33,292,407,115,39.38,519,617,98,18.88,ARAGUACEMA TO,-8.8067391,-49.5560969,26,320
TO,ARAGUACU,572,591,19,3.32,13,15,2,15.38,5,2,-3,-60.0,175,154,-21,-12.0,532,443,-89,-16.73,1297,1205,-92,-7.09,ARAGUACU TO,-12.928934,-49.823134,26,321
TO,ARAGUAINA,1241,1247,6,0.48,3757,3848,91,2.42,1354,1259,-95,-7.02,9616,9693,77,0.8,16464,14673,-1791,-10.88,32432,30720,-1712,-5.28,ARAGUAINA TO,-7.193241,-48.2018597,26,322
TO,ARAGUANA,219,233,14,6.39,9,0,-9,-100.0,1,1,0,0.0,44,32,-12,-27.27,230,201,-29,-12.61,503,467,-36,-7.16,ARAGUANA TO,-6.5799107,-48.6428482,26,323
TO,ARAGUATINS,215,196,-19,-8.84,150,154,4,2.67,44,9,-35,-79.55,537,545,8,1.49,1119,1048,-71,-6.34,2065,1952,-113,-5.47,ARAGUATINS TO,-5.6529384,-48.1161923,26,324
TO,ARAPOEMA,338,311,-27,-7.99,15,15,0,0.0,211,2760,2549,1208.06,83,79,-4,-4.82,272,263,-9,-3.31,919,3428,2509,273.01,ARAPOEMA TO,-7.6575001,-49.0641484,26,325
TO,ARRAIAS,160,174,14,8.75,245,67,-178,-72.65,0,0,0,0.0,136,151,15,11.03,447,370,-77,-17.23,988,762,-226,-22.87,ARRAIAS TO,-12.9287788,-46.9437231,26,326
TO,AUGUSTINOPOLIS,65,57,-8,-12.31,200,212,12,6.0,12,13,1,8.33,497,471,-26,-5.23,874,677,-197,-22.54,1648,1430,-218,-13.23,AUGUSTINOPOLIS TO,-5.4662267,-47.8897519,26,327
TO,AURORA DO TOCANTINS,16,20,4,25.0,16,12,-4,-25.0,6,8,2,33.33,6,8,2,33.33,142,174,32,22.54,186,222,36,19.35,AURORA DO TOCANTINS TO,-12.71045,-46.407604,26,328
TO,AXIXA DO TOCANTINS,33,32,-1,-3.03,18,18,0,0.0,2,0,-2,-100.0,115,98,-17,-14.78,567,470,-97,-17.11,735,618,-117,-15.92,AXIXA DO TOCANTINS TO,-5.612747,-47.77007,26,329
TO,BABACULANDIA,469,399,-70,-14.93,10,3,-7,-70.0,0,0,0,0.0,19,20,1,5.26,347,287,-60,-17.29,845,709,-136,-16.09,BABACULANDIA TO,-7.2034355,-47.761613,26,330
TO,BANDEIRANTES DO TOCANTINS,276,271,-5,-1.81,79,109,30,37.97,1,0,-1,-100.0,15,14,-1,-6.67,228,183,-45,-19.74,599,577,-22,-3.67,BANDEIRANTES DO TOCANTINS TO,-7.7635698,-48.579148,26,331
TO,BARRA DO OURO,66,83,17,25.76,8,7,-1,-12.5,0,0,0,0.0,17,18,1,5.88,223,170,-53,-23.77,314,278,-36,-11.46,BARRA DO OURO TO,-7.7113784,-47.6743925,26,332
TO,BARROLANDIA,77,75,-2,-2.6,7,7,0,0.0,11,11,0,0.0,74,76,2,2.7,381,351,-30,-7.87,550,520,-30,-5.45,BARROLANDIA TO,-9.837246,-48.7264346,26,333
TO,BERNARDO SAYAO,153,184,31,20.26,77,61,-16,-20.78,0,0,0,0.0,16,25,9,56.25,181,159,-22,-12.15,427,429,2,0.47,BERNARDO SAYAO TO,-7.8794244,-48.8968905,26,334
TO,BRASILANDIA DO TOCANTINS,85,92,7,8.24,0,0,0,0.0,0,0,0,0.0,11,16,5,45.45,219,183,-36,-16.44,315,291,-24,-7.62,BRASILANDIA DO TOCANTINS TO,-8.3886619,-48.4842729,26,336
TO,BREJINHO DE NAZARE,333,345,12,3.6,5,7,2,40.0,0,1,1,0.0,42,45,3,7.14,276,280,4,1.45,656,678,22,3.35,BREJINHO DE NAZARE TO,-11.0138265,-48.564626,26,337
TO,BURITI DO TOCANTINS,15,14,-1,-6.67,50,44,-6,-12.0,0,0,0,0.0,101,86,-15,-14.85,411,351,-60,-14.6,577,495,-82,-14.21,BURITI DO TOCANTINS TO,-5.3187439,-48.2256609,26,338
TO,CAMPOS LINDOS,447,530,83,18.57,9,17,8,88.89,7,5,-2,-28.57,117,146,29,24.79,391,158,-233,-59.59,971,856,-115,-11.84,CAMPOS LINDOS TO,-7.9740597,-46.8023881,26,340
TO,CARIRI DO TOCANTINS,220,235,15,6.82,186,220,34,18.28,32,34,2,6.25,180,176,-4,-2.22,466,503,37,7.94,1084,1168,84,7.75,CARIRI DO TOCANTINS TO,-11.8882727,-49.1604216,26,341
TO,CARMOLANDIA,82,96,14,17.07,0,0,0,0.0,2,2,0,0.0,14,11,-3,-21.43,192,157,-35,-18.23,290,266,-24,-8.28,CARMOLANDIA TO,-7.033804,-48.3951295,26,342
TO,CARRASCO BONITO,15,16,1,6.67,0,0,0,0.0,0,0,0,0.0,1,2,1,100.0,285,164,-121,-42.46,301,182,-119,-39.53,CARRASCO BONITO TO,-5.3205734,-48.0376667,26,343
TO,CASEARA,357,378,21,5.88,6,34,28,466.67,51,0,-51,-100.0,37,34,-3,-8.11,250,235,-15,-6.0,701,681,-20,-2.85,CASEARA TO,-9.273159,-49.9576837,26,344
TO,CHAPADA DE AREIA,30,28,-2,-6.67,8,2,-6,-75.0,0,0,0,0.0,5,3,-2,-40.0,75,58,-17,-22.67,118,91,-27,-22.88,CHAPADA DE AREIA TO,-10.1417377,-49.1781853,26,346
TO,CHAPADA DA NATIVIDADE,78,84,6,7.69,72,115,43,59.72,0,0,0,0.0,12,10,-2,-16.67,251,135,-116,-46.22,413,344,-69,-16.71,CHAPADA DA NATIVIDADE TO,-11.6119239,-47.7538517,26,347
TO,COLINAS DO TOCANTINS,234,205,-29,-12.39,400,393,-7,-1.75,118,97,-21,-17.8,1428,1461,33,2.31,2420,2044,-376,-15.54,4600,4200,-400,-8.7,COLINAS DO TOCANTINS TO,-8.0612688,-48.4716768,26,348
TO,COMBINADO,11,9,-2,-18.18,25,25,0,0.0,1,0,-1,-100.0,103,103,0,0.0,270,149,-121,-44.81,410,286,-124,-30.24,COMBINADO TO,-12.8136581,-46.5461041,26,349
TO,CONCEICAO DO TOCANTINS,37,42,5,13.51,4,4,0,0.0,1,1,0,0.0,44,50,6,13.64,178,156,-22,-12.36,264,253,-11,-4.17,CONCEICAO DO TOCANTINS TO,-12.220874,-47.295103,26,350
TO,COUTO MAGALHAES,116,122,6,5.17,5,5,0,0.0,53,35,-18,-33.96,71,85,14,19.72,222,160,-62,-27.93,467,407,-60,-12.85,COUTO MAGALHAES TO,-8.360583,-49.1773955,26,351
TO,CRISTALANDIA,205,197,-8,-3.9,62,46,-16,-25.81,0,0,0,0.0,91,88,-3,-3.3,310,245,-65,-20.97,668,576,-92,-13.77,CRISTALANDIA TO,-10.59848,-49.194202,26,352
TO,CRIXAS DO TOCANTINS,47,44,-3,-6.38,0,0,0,0.0,0,0,0,0.0,1,4,3,300.0,167,143,-24,-14.37,215,191,-24,-11.16,CRIXAS DO TOCANTINS TO,-11.1039404,-48.918827,26,353
TO,DARCINOPOLIS,379,398,19,5.01,1,1,0,0.0,4,2,-2,-50.0,33,45,12,36.36,337,284,-53,-15.73,754,730,-24,-3.18,DARCINOPOLIS TO,-6.7085964,-47.7524283,26,354
TO,DIANOPOLIS,434,445,11,2.53,109,123,14,12.84,27,36,9,33.33,641,655,14,2.18,1061,859,-202,-19.04,2272,2118,-154,-6.78,DIANOPOLIS TO,-11.624008,-46.819787,26,355
TO,DIVINOPOLIS DO TOCANTINS,205,255,50,24.39,37,55,18,48.65,1,1,0,0.0,146,124,-22,-15.07,373,184,-189,-50.67,762,619,-143,-18.77,DIVINOPOLIS DO TOCANTINS TO,-9.8015722,-49.2143531,26,356
TO,DOIS IRMAOS DO TOCANTINS,203,189,-14,-6.9,16,11,-5,-31.25,0,0,0,0.0,67,66,-1,-1.49,180,141,-39,-21.67,466,407,-59,-12.66,DOIS IRMAOS DO TOCANTINS TO,-9.2539897,-49.0665558,26,357
TO,DUERE,306,254,-52,-16.99,75,87,12,16.0,0,0,0,0.0,42,27,-15,-35.71,294,230,-64,-21.77,717,598,-119,-16.6,DUERE TO,-11.341631,-49.271566,26,358
TO,ESPERANTINA,15,14,-1,-6.67,4,5,1,25.0,0,0,0,0.0,36,23,-13,-36.11,440,431,-9,-2.05,495,473,-22,-4.44,ESPERANTINA TO,-5.3658232,-48.5368181,26,359
TO,FATIMA,48,57,9,18.75,8,6,-2,-25.0,32,10,-22,-68.75,71,69,-2,-2.82,211,202,-9,-4.27,370,344,-26,-7.03,FATIMA TO,-10.7575656,-48.9031328,26,360
TO,FIGUEIROPOLIS,212,209,-3,-1.42,13,13,0,0.0,0,0,0,0.0,132,110,-22,-16.67,269,201,-68,-25.28,626,533,-93,-14.86,FIGUEIROPOLIS TO,-12.1347916,-49.1737141,26,361
TO,FORMOSO DO ARAGUAIA,864,874,10,1.16,114,116,2,1.75,8,18,10,125.0,351,357,6,1.71,1215,979,-236,-19.42,2552,2344,-208,-8.15,FORMOSO DO ARAGUAIA TO,-11.8059989,-49.5257153,26,363
TO,FORTALEZA DO TABOCAO,83,83,0,0.0,13,33,20,153.85,0,21,21,0.0,227,220,-7,-3.08,346,298,-48,-13.87,669,655,-14,-2.09,FORTALEZA DO TABOCAO TO,-9.0565211,-48.5216745,26,364
TO,GOIANORTE,78,84,6,7.69,18,24,6,33.33,0,0,0,0.0,27,28,1,3.7,208,168,-40,-19.23,331,304,-27,-8.16,GOIANORTE TO,-8.7720092,-48.9340879,26,365
TO,GOIATINS,195,208,13,6.67,8,8,0,0.0,2,0,-2,-100.0,38,36,-2,-5.26,28,396,368,1314.29,271,648,377,139.11,GOIATINS TO,-7.7132054,-47.3154841,26,366
TO,GUARAI,207,194,-13,-6.28,288,286,-2,-0.69,26,10,-16,-61.54,1040,1013,-27,-2.6,1639,1391,-248,-15.13,3200,2894,-306,-9.56,GUARAI TO,-8.835429,-48.511432,26,367
TO,GURUPI,381,363,-18,-4.72,1545,1490,-55,-3.56,163,159,-4,-2.45,5143,5103,-40,-0.78,7783,7479,-304,-3.91,15015,14594,-421,-2.8,GURUPI TO,-11.72794,-49.068046,26,368
TO,IPUEIRAS,54,53,-1,-1.85,2,2,0,0.0,0,0,0,0.0,4,2,-2,-50.0,186,154,-32,-17.2,246,211,-35,-14.23,IPUEIRAS TO,-11.2408008,-48.4438878,26,369
TO,ITACAJA,62,62,0,0.0,31,26,-5,-16.13,2,2,0,0.0,67,78,11,16.42,244,200,-44,-18.03,406,368,-38,-9.36,ITACAJA TO,-8.392935,-47.772615,26,370
TO,ITAGUATINS,69,70,1,1.45,9,8,-1,-11.11,0,0,0,0.0,15,16,1,6.67,303,265,-38,-12.54,396,359,-37,-9.34,ITAGUATINS TO,-5.7696766,-47.4815382,26,371
TO,ITAPIRATINS,75,78,3,4.0,9,3,-6,-66.67,0,0,0,0.0,17,14,-3,-17.65,186,152,-34,-18.28,287,247,-40,-13.94,ITAPIRATINS TO,-8.3832116,-48.1054968,26,372
TO,ITAPORA DO TOCANTINS,189,188,-1,-0.53,15,13,-2,-13.33,0,0,0,0.0,15,12,-3,-20.0,156,112,-44,-28.21,375,325,-50,-13.33,ITAPORA DO TOCANTINS TO,-8.571722,-48.689481,26,373
TO,JAU DO TOCANTINS,63,56,-7,-11.11,26,21,-5,-19.23,0,0,0,0.0,26,19,-7,-26.92,272,238,-34,-12.5,387,334,-53,-13.7,JAU DO TOCANTINS TO,-12.6526649,-48.5922532,26,374
TO,JUARINA,18,18,0,0.0,0,6,6,0.0,0,0,0,0.0,12,12,0,0.0,197,156,-41,-20.81,227,192,-35,-15.42,JUARINA TO,-8.1194209,-49.0967459,26,375
TO,LAGOA DA CONFUSAO,798,822,24,3.01,154,190,36,23.38,4,16,12,300.0,285,307,22,7.72,640,634,-6,-0.94,1881,1969,88,4.68,LAGOA DA CONFUSAO TO,-10.7883045,-49.6224431,26,376
TO,LAGOA DO TOCANTINS,22,27,5,22.73,3,10,7,233.33,0,0,0,0.0,10,12,2,20.0,194,180,-14,-7.22,229,229,0,0.0,LAGOA DO TOCANTINS TO,-10.2967881,-47.566253,26,377
TO,LAJEADO,18,22,4,22.22,26,27,1,3.85,42,38,-4,-9.52,41,44,3,7.32,310,257,-53,-17.1,437,388,-49,-11.21,LAJEADO TO,-9.7548945,-48.3563706,26,378
TO,LAVANDEIRA,7,12,5,71.43,0,0,0,0.0,0,0,0,0.0,1,1,0,0.0,137,79,-58,-42.34,145,92,-53,-36.55,LAVANDEIRA TO,-12.7887924,-46.5073198,26,379
TO,LIZARDA,16,31,15,93.75,5,6,1,20.0,0,0,0,0.0,11,12,1,9.09,129,95,-34,-26.36,161,144,-17,-10.56,LIZARDA TO,-9.5955336,-46.675218,26,380
TO,LUZINOPOLIS,50,43,-7,-14.0,3,4,1,33.33,0,0,0,0.0,25,35,10,40.0,195,168,-27,-13.85,273,250,-23,-8.42,LUZINOPOLIS TO,-6.1918183,-47.8562036,26,381
TO,MARIANOPOLIS DO TOCANTINS,363,474,111,30.58,23,19,-4,-17.39,23,10,-13,-56.52,85,78,-7,-8.24,326,278,-48,-14.72,820,859,39,4.76,MARIANOPOLIS DO TOCANTINS TO,-9.7962503,-49.6547174,26,382
TO,MATEIROS,199,186,-13,-6.53,15,8,-7,-46.67,0,9,9,0.0,21,34,13,61.9,216,148,-68,-31.48,451,385,-66,-14.63,MATEIROS TO,-10.5462254,-46.417423,26,383
TO,MAURILANDIA DO TOCANTINS,35,32,-3,-8.57,0,0,0,0.0,0,0,0,0.0,22,21,-1,-4.55,219,197,-22,-10.05,276,250,-26,-9.42,MAURILANDIA DO TOCANTINS TO,-5.951688,-47.512492,26,384
TO,MIRACEMA DO TOCANTINS,205,247,42,20.49,163,176,13,7.98,67,76,9,13.43,433,418,-15,-3.46,1231,674,-557,-45.25,2099,1591,-508,-24.2,MIRACEMA DO TOCANTINS TO,-9.5617939,-48.3966536,26,385
TO,MIRANORTE,215,293,78,36.28,77,76,-1,-1.3,4,6,2,50.0,362,331,-31,-8.56,682,579,-103,-15.1,1340,1285,-55,-4.1,MIRANORTE TO,-9.529068,-48.592222,26,386
TO,MONTE DO CARMO,185,228,43,23.24,9,18,9,100.0,211,25,-186,-88.15,18,17,-1,-5.56,339,280,-59,-17.4,762,568,-194,-25.46,MONTE DO CARMO TO,-10.7647456,-48.1121813,26,387
TO,MONTE SANTO DO TOCANTINS,75,77,2,2.67,5,0,-5,-100.0,0,0,0,0.0,6,11,5,83.33,175,116,-59,-33.71,261,204,-57,-21.84,MONTE SANTO DO TOCANTINS TO,-10.0051944,-48.9927531,26,388
TO,PALMEIRAS DO TOCANTINS,51,49,-2,-3.92,1,0,-1,-100.0,7,0,-7,-100.0,27,29,2,7.41,242,220,-22,-9.09,328,298,-30,-9.15,PALMEIRAS DO TOCANTINS TO,-6.6096035,-47.546399,26,389
TO,MURICILANDIA,151,138,-13,-8.61,0,0,0,0.0,0,0,0,0.0,24,19,-5,-20.83,207,200,-7,-3.38,382,357,-25,-6.54,MURICILANDIA TO,-7.14669,-48.609135,26,390
TO,NATIVIDADE,134,123,-11,-8.21,170,214,44,25.88,8,9,1,12.5,152,151,-1,-0.66,407,338,-69,-16.95,871,835,-36,-4.13,NATIVIDADE TO,-11.7089881,-47.7284165,26,391
TO,NAZARE,36,29,-7,-19.44,1,1,0,0.0,0,0,0,0.0,15,22,7,46.67,218,193,-25,-11.47,270,245,-25,-9.26,NAZARE TO,-6.3733313,-47.6632702,26,392
TO,NOVA OLINDA,90,81,-9,-10.0,626,639,13,2.08,3,1,-2,-66.67,255,235,-20,-7.84,358,319,-39,-10.89,1332,1275,-57,-4.28,NOVA OLINDA TO,-7.631712,-48.425232,26,393
TO,NOVA ROSALANDIA,33,105,72,218.18,3,3,0,0.0,3,0,-3,-100.0,35,32,-3,-8.57,206,160,-46,-22.33,280,300,20,7.14,NOVA ROSALANDIA TO,-10.565102,-48.912477,26,394
TO,NOVO ACORDO,87,94,7,8.05,0,0,0,0.0,0,0,0,0.0,51,54,3,5.88,246,216,-30,-12.2,384,364,-20,-5.21,NOVO ACORDO TO,-9.964658,-47.6762804,26,395
TO,NOVO ALEGRE,12,11,-1,-8.33,0,6,6,0.0,1,0,-1,-100.0,11,12,1,9.09,95,81,-14,-14.74,119,110,-9,-7.56,NOVO ALEGRE TO,-12.915134,-46.5740939,26,396
TO,NOVO JARDIM,25,24,-1,-4.0,50,8,-42,-84.0,1,12,11,1100.0,7,7,0,0.0,198,100,-98,-49.49,281,151,-130,-46.26,NOVO JARDIM TO,-11.8199253,-46.6254107,26,397
TO,OLIVEIRA DE FATIMA,9,25,16,177.78,0,0,0,0.0,0,0,0,0.0,2,4,2,100.0,170,127,-43,-25.29,181,156,-25,-13.81,OLIVEIRA DE FATIMA TO,-10.7091365,-48.9077446,26,398
TO,PALMEIRANTE,116,113,-3,-2.59,14,11,-3,-21.43,0,0,0,0.0,17,20,3,17.65,251,186,-65,-25.9,398,330,-68,-17.09,PALMEIRANTE TO,-7.8582335,-47.9264382,26,399
TO,PALMEIROPOLIS,128,242,114,89.06,50,52,2,4.0,1,1,0,0.0,156,145,-11,-7.05,428,268,-160,-37.38,763,708,-55,-7.21,PALMEIROPOLIS TO,-13.0428105,-48.4065223,26,400
TO,PARAISO DO TOCANTINS,276,299,23,8.33,1899,1816,-83,-4.37,630,604,-26,-4.13,2970,3019,49,1.65,3583,2520,-1063,-29.67,9358,8258,-1100,-11.75,PARAISO DO TOCANTINS TO,-10.1752474,-48.886759,26,401
TO,PARANA,116,106,-10,-8.62,34,34,0,0.0,18,11,-7,-38.89,94,102,8,8.51,459,42,-417,-90.85,721,295,-426,-59.08,PARANA TO,-12.616747,-47.873378,26,402
TO,PEDRO AFONSO,199,180,-19,-9.55,882,840,-42,-4.76,43,28,-15,-34.88,394,398,4,1.02,761,680,-81,-10.64,2279,2126,-153,-6.71,PEDRO AFONSO TO,-8.9757351,-48.1733282,26,404
TO,PEIXE,418,459,41,9.81,98,88,-10,-10.2,1,1,0,0.0,84,77,-7,-8.33,589,501,-88,-14.94,1190,1126,-64,-5.38,PEIXE TO,-12.0390993,-48.5392455,26,405
TO,PEQUIZEIRO,76,102,26,34.21,3,7,4,133.33,0,0,0,0.0,42,46,4,9.52,267,190,-77,-28.84,388,345,-43,-11.08,PEQUIZEIRO TO,-8.594846,-48.9332775,26,406
TO,COLMEIA,78,71,-7,-8.97,79,69,-10,-12.66,1,1,0,0.0,155,165,10,6.45,384,363,-21,-5.47,697,669,-28,-4.02,COLMEIA TO,-8.734098,-48.7510897,26,407
TO,PINDORAMA DO TOCANTINS,39,37,-2,-5.13,10,13,3,30.0,0,0,0,0.0,16,19,3,18.75,256,211,-45,-17.58,321,280,-41,-12.77,PINDORAMA DO TOCANTINS TO,-11.131074,-47.57263,26,408
TO,PIRAQUE,294,297,3,1.02,2,4,2,100.0,0,0,0,0.0,8,2,-6,-75.0,183,150,-33,-18.03,487,453,-34,-6.98,PIRAQUE TO,-6.769831,-48.2945507,26,409
TO,PIUM,404,449,45,11.14,23,18,-5,-21.74,10,0,-10,-100.0,49,38,-11,-22.45,276,219,-57,-20.65,762,724,-38,-4.99,PIUM TO,-10.4421368,-49.1747741,26,410
TO,PONTE ALTA DO BOM JESUS,23,31,8,34.78,12,8,-4,-33.33,0,6,6,0.0,15,10,-5,-33.33,105,289,184,175.24,155,344,189,121.94,PONTE ALTA DO BOM JESUS TO,-12.0873615,-46.4785732,26,411
TO,PONTE ALTA DO TOCANTINS,74,102,28,37.84,15,14,-1,-6.67,2,0,-2,-100.0,59,58,-1,-1.69,340,293,-47,-13.82,490,467,-23,-4.69,PONTE ALTA DO TOCANTINS TO,-10.7454591,-47.5374479,26,412
TO,PORTO ALEGRE DO TOCANTINS,40,46,6,15.0,0,3,3,0.0,0,0,0,0.0,15,14,-1,-6.67,173,139,-34,-19.65,228,202,-26,-11.4,PORTO ALEGRE DO TOCANTINS TO,-11.6070802,-47.052627,26,413
TO,PORTO NACIONAL,971,1050,79,8.14,1013,1039,26,2.57,355,408,53,14.93,2287,2380,93,4.07,5302,3781,-1521,-28.69,9928,8658,-1270,-12.79,PORTO NACIONAL TO,-10.7019786,-48.4110952,26,414
TO,PRAIA NORTE,12,9,-3,-25.0,9,4,-5,-55.56,0,0,0,0.0,12,11,-1,-8.33,192,314,122,63.54,225,338,113,50.22,PRAIA NORTE TO,-5.392812,-47.811144,26,415
TO,PRESIDENTE KENNEDY,44,42,-2,-4.55,13,13,0,0.0,0,0,0,0.0,51,52,1,1.96,184,182,-2,-1.09,292,289,-3,-1.03,PRESIDENTE KENNEDY TO,-8.5340643,-48.5060747,26,416
TO,PUGMIL,40,38,-2,-5.0,33,30,-3,-9.09,1,0,-1,-100.0,77,78,1,1.3,270,148,-122,-45.19,421,294,-127,-30.17,PUGMIL TO,-10.4255161,-48.8969824,26,417
TO,RECURSOLANDIA,54,57,3,5.56,4,4,0,0.0,0,0,0,0.0,24,19,-5,-20.83,201,142,-59,-29.35,283,222,-61,-21.55,RECURSOLANDIA TO,-8.7368677,-47.2416349,26,418
TO,RIACHINHO,30,33,3,10.0,0,0,0,0.0,0,14,14,0.0,11,11,0,0.0,263,205,-58,-22.05,304,263,-41,-13.49,RIACHINHO TO,-6.4426372,-48.137969,26,419
TO,RIO DA CONCEICAO,64,41,-23,-35.94,0,3,3,0.0,0,0,0,0.0,2,4,2,100.0,189,7,-182,-96.3,255,55,-200,-78.43,RIO DA CONCEICAO TO,-11.394863,-46.884664,26,420
TO,RIO DOS BOIS,39,35,-4,-10.26,0,0,0,0.0,0,0,0,0.0,2,1,-1,-50.0,166,161,-5,-3.01,207,197,-10,-4.83,RIO DOS BOIS TO,-9.3412231,-48.5349207,26,421
TO,RIO SONO,61,67,6,9.84,12,11,-1,-8.33,0,0,0,0.0,24,24,0,0.0,274,180,-94,-34.31,371,282,-89,-23.99,RIO SONO TO,-9.3442508,-47.8998831,26,422
TO,SAMPAIO,5,5,0,0.0,4,3,-1,-25.0,0,0,0,0.0,9,8,-1,-11.11,157,114,-43,-27.39,175,130,-45,-25.71,SAMPAIO TO,-5.354233,-47.878184,26,423
TO,SANDOLANDIA,179,185,6,3.35,4,5,1,25.0,0,0,0,0.0,27,18,-9,-33.33,216,154,-62,-28.7,426,362,-64,-15.02,SANDOLANDIA TO,-12.5389465,-49.9285958,26,424
TO,SANTA FE DO ARAGUAIA,315,268,-47,-14.92,40,38,-2,-5.0,10,2,-8,-80.0,101,87,-14,-13.86,327,285,-42,-12.84,793,680,-113,-14.25,SANTA FE DO ARAGUAIA TO,-7.150072,-48.6925943,26,425
TO,SANTA MARIA DO TOCANTINS,36,44,8,22.22,3,7,4,133.33,0,0,0,0.0,22,29,7,31.82,208,125,-83,-39.9,269,205,-64,-23.79,SANTA MARIA DO TOCANTINS TO,-8.7752144,-47.7482956,26,426
TO,SANTA RITA DO TOCANTINS,177,173,-4,-2.26,11,3,-8,-72.73,0,0,0,0.0,31,42,11,35.48,217,149,-68,-31.34,436,367,-69,-15.83,SANTA RITA DO TOCANTINS TO,-10.8643623,-48.9082979,26,427
TO,SANTA ROSA DO TOCANTINS,162,173,11,6.79,42,9,-33,-78.57,8,0,-8,-100.0,74,65,-9,-12.16,278,204,-74,-26.62,564,451,-113,-20.04,SANTA ROSA DO TOCANTINS TO,-11.447392,-48.121627,26,428
TO,SANTA TEREZA DO TOCANTINS,24,26,2,8.33,13,12,-1,-7.69,0,0,0,0.0,12,6,-6,-50.0,180,3,-177,-98.33,229,47,-182,-79.48,SANTA TEREZA DO TOCANTINS TO,-10.2816205,-47.8091871,26,429
TO,SANTA TEREZINHA DO TOCANTINS,24,20,-4,-16.67,0,0,0,0.0,0,0,0,0.0,3,1,-2,-66.67,173,84,-89,-51.45,200,105,-95,-47.5,SANTA TEREZINHA DO TOCANTINS TO,-6.4356048,-47.673061,26,430
TO,SAO BENTO DO TOCANTINS,187,160,-27,-14.44,0,0,0,0.0,0,0,0,0.0,25,25,0,0.0,220,139,-81,-36.82,432,324,-108,-25.0,SAO BENTO DO TOCANTINS TO,-6.021853,-47.900057,26,431
TO,SAO FELIX DO TOCANTINS,3,6,3,100.0,6,8,2,33.33,0,0,0,0.0,6,10,4,66.67,173,165,-8,-4.62,188,189,1,0.53,SAO FELIX DO TOCANTINS TO,-10.161465,-46.661786,26,432
TO,SAO MIGUEL DO TOCANTINS,122,100,-22,-18.03,15,17,2,13.33,0,0,0,0.0,35,30,-5,-14.29,419,341,-78,-18.62,591,488,-103,-17.43,SAO MIGUEL DO TOCANTINS TO,-5.5549817,-47.5747649,26,433
TO,SAO SALVADOR DO TOCANTINS,31,28,-3,-9.68,2,3,1,50.0,0,0,0,0.0,8,9,1,12.5,211,223,12,5.69,252,263,11,4.37,SAO SALVADOR DO TOCANTINS TO,-12.7503331,-48.2352148,26,434
TO,SAO SEBASTIAO DO TOCANTINS,11,14,3,27.27,72,68,-4,-5.56,0,1,1,0.0,9,6,-3,-33.33,217,181,-36,-16.59,309,270,-39,-12.62,SAO SEBASTIAO DO TOCANTINS TO,-5.2587094,-48.2055574,26,435
TO,SAO VALERIO,100,98,-2,-2.0,6,5,-1,-16.67,0,0,0,0.0,82,80,-2,-2.44,285,175,-110,-38.6,473,358,-115,-24.31,SAO VALERIO TO,-11.974315,-48.235315,26,436
TO,SILVANOPOLIS,122,106,-16,-13.11,36,40,4,11.11,37,27,-10,-27.03,75,80,5,6.67,300,318,18,6.0,570,571,1,0.18,SILVANOPOLIS TO,-11.1513516,-48.1711295,26,437
TO,SITIO NOVO DO TOCANTINS,50,44,-6,-12.0,26,22,-4,-15.38,0,4,4,0.0,52,48,-4,-7.69,680,658,-22,-3.24,808,776,-32,-3.96,SITIO NOVO DO TOCANTINS TO,-5.6028662,-47.6349901,26,438
TO,SUCUPIRA,102,99,-3,-2.94,0,0,0,0.0,0,0,0,0.0,2,2,0,0.0,121,122,1,0.83,225,223,-2,-0.89,SUCUPIRA TO,-11.9850885,-48.9113689,26,439
TO,TAGUATINGA,102,76,-26,-25.49,81,111,30,37.04,0,0,0,0.0,227,199,-28,-12.33,713,788,75,10.52,1123,1174,51,4.54,TAGUATINGA TO,-12.402404,-46.4365769,26,440
TO,TAIPAS DO TOCANTINS,23,28,5,21.74,3,1,-2,-66.67,0,0,0,0.0,1,2,1,100.0,3,151,148,4933.33,30,182,152,506.67,TAIPAS DO TOCANTINS TO,-12.193349,-46.9918003,26,441
TO,TALISMA,212,208,-4,-1.89,10,4,-6,-60.0,0,0,0,0.0,28,23,-5,-17.86,262,197,-65,-24.81,512,432,-80,-15.62,TALISMA TO,-12.797836,-49.0929839,26,442
TO,PALMAS,267,239,-28,-10.49,4234,4400,166,3.92,3775,3795,20,0.53,17673,17422,-251,-1.42,95078,97893,2815,2.96,121027,123749,2722,2.25,PALMAS TO,-10.1837852,-48.3336423,26,443
TO,TUPIRATINS,17,13,-4,-23.53,2,0,-2,-100.0,1,1,0,0.0,17,23,6,35.29,137,114,-23,-16.79,174,151,-23,-13.22,TUPIRATINS TO,-8.3996247,-48.1299635,26,447
TO,WANDERLANDIA,157,160,3,1.91,140,134,-6,-4.29,4,0,-4,-100.0,80,86,6,7.5,431,309,-122,-28.31,812,689,-123,-15.15,WANDERLANDIA TO,-6.8522727,-47.9653917,26,448
MA,ACAILANDIA,2716,2473,-243,-8.95,2240,2457,217,9.69,1827,1476,-351,-19.21,3241,3431,190,5.86,5779,6488,709,12.27,15803,16325,522,3.3,ACAILANDIA MA,-4.9514278,-47.4844564,9,450
MA,AFONSO CUNHA,22,29,7,31.82,0,0,0,0.0,0,0,0,0.0,7,4,-3,-42.86,256,258,2,0.78,285,291,6,2.11,AFONSO CUNHA MA,-4.1326105,-43.3230026,9,451
MA,AGUA DOCE DO MARANHAO,13,14,1,7.69,0,0,0,0.0,0,26,26,0.0,52,38,-14,-26.92,495,480,-15,-3.03,560,558,-2,-0.36,AGUA DOCE DO MARANHAO MA,-2.8402004,-42.1181949,9,452
MA,ALCANTARA,0,3,3,0.0,0,0,0,0.0,7,7,0,0.0,41,39,-2,-4.88,2057,23,-2034,-98.88,2105,72,-2033,-96.58,ALCANTARA MA,-2.4084996,-44.4174143,9,453
MA,ALDEIAS ALTAS,3,0,-3,-100.0,359,374,15,4.18,0,0,0,0.0,119,112,-7,-5.88,842,810,-32,-3.8,1323,1296,-27,-2.04,ALDEIAS ALTAS MA,-4.6291957,-43.4708622,9,454
MA,ALTAMIRA DO MARANHAO,64,66,2,3.12,0,0,0,0.0,0,0,0,0.0,26,28,2,7.69,201,259,58,28.86,291,353,62,21.31,ALTAMIRA DO MARANHAO MA,-4.1643006,-45.4674574,9,455
MA,ALTO ALEGRE DO MARANHAO,7,6,-1,-14.29,8,8,0,0.0,39,29,-10,-25.64,235,291,56,23.83,983,513,-470,-47.81,1272,847,-425,-33.41,ALTO ALEGRE DO MARANHAO MA,-4.2055693,-44.4525287,9,456
MA,ALTO ALEGRE DO PINDARE,8,8,0,0.0,0,0,0,0.0,3,135,132,4400.0,57,54,-3,-5.26,1444,1116,-328,-22.71,1512,1313,-199,-13.16,ALTO ALEGRE DO PINDARE MA,-3.6698186,-45.8462153,9,457
MA,AMAPA DO MARANHAO,2,0,-2,-100.0,0,0,0,0.0,0,0,0,0.0,22,37,15,68.18,266,266,0,0.0,290,303,13,4.48,AMAPA DO MARANHAO MA,-1.6762114,-46.0109669,9,459
MA,AMARANTE DO MARANHAO,103,89,-14,-13.59,0,0,0,0.0,0,0,0,0.0,221,218,-3,-1.36,1615,1291,-324,-20.06,1939,1598,-341,-17.59,AMARANTE DO MARANHAO MA,-5.56913,-46.747284,9,460
MA,ANAJATUBA,3,0,-3,-100.0,7,18,11,157.14,0,0,0,0.0,87,67,-20,-22.99,689,674,-15,-2.18,786,759,-27,-3.44,ANAJATUBA MA,-3.26441,-44.6179916,9,461
MA,ANAPURUS,112,42,-70,-62.5,10,4,-6,-60.0,0,0,0,0.0,55,55,0,0.0,727,673,-54,-7.43,904,774,-130,-14.38,ANAPURUS MA,-3.6751298,-43.1046001,9,462
MA,APICUM-ACU,0,0,0,0.0,0,0,0,0.0,0,0,0,0.0,36,44,8,22.22,531,608,77,14.5,567,652,85,14.99,APICUM-ACU MA,-1.5279295,-45.082278,9,463
MA,ARAGUANA,219,233,14,6.39,9,0,-9,-100.0,1,1,0,0.0,44,32,-12,-27.27,230,201,-29,-12.61,503,467,-36,-7.16,ARAGUANA MA,-2.9508403,-45.6651986,9,464
MA,ARAIOSES,36,8,-28,-77.78,36,28,-8,-22.22,0,0,0,0.0,219,190,-29,-13.24,1880,93,-1787,-95.05,2171,319,-1852,-85.31,ARAIOSES MA,-2.890914,-41.904993,9,465
MA,ARAME,46,52,6,13.04,2,0,-2,-100.0,1,0,-1,-100.0,120,89,-31,-25.83,572,692,120,20.98,741,833,92,12.42,ARAME MA,-4.8858769,-46.0102484,9,466
MA,ARARI,11,14,3,27.27,27,20,-7,-25.93,7,7,0,0.0,303,318,15,4.95,1305,1343,38,2.91,1653,1702,49,2.96,ARARI MA,-3.4547602,-44.7772723,9,467
MA,BACABAL,315,302,-13,-4.13,812,711,-101,-12.44,60,80,20,33.33,3758,3798,40,1.06,3625,3888,263,7.26,8570,8779,209,2.44,BACABAL MA,-4.2318132,-44.781167,9,469
MA,BACABEIRA,12,37,25,208.33,490,503,13,2.65,92,151,59,64.13,104,126,22,21.15,646,577,-69,-10.68,1344,1394,50,3.72,BACABEIRA MA,-2.9786744,-44.3163504,9,470
MA,BACURI,0,0,0,0.0,0,0,0,0.0,0,0,0,0.0,10,12,2,20.0,957,1004,47,4.91,967,1016,49,5.07,BACURI MA,-1.728894,-45.1417148,9,471
MA,BACURITUBA,0,0,0,0.0,0,0,0,0.0,0,0,0,0.0,10,8,-2,-20.0,260,196,-64,-24.62,270,204,-66,-24.44,BACURITUBA MA,-2.7082587,-44.7381309,9,472
MA,BALSAS,2787,2947,160,5.74,898,957,59,6.57,749,759,10,1.34,6269,6326,57,0.91,8996,8720,-276,-3.07,19699,19709,10,0.05,BALSAS MA,-7.53214,-46.037163,9,473
MA,BARRA DO CORDA,219,230,11,5.02,170,150,-20,-11.76,16,12,-4,-25.0,1191,1281,90,7.56,3857,3209,-648,-16.8,5453,4882,-571,-10.47,BARRA DO CORDA MA,-5.496823,-45.248496,9,475
MA,BARREIRINHAS,0,1,1,0.0,14,12,-2,-14.29,14,15,1,7.14,545,808,263,48.26,937,3259,2322,247.81,1510,4095,2585,171.19,BARREIRINHAS MA,-2.7541271,-42.8259693,9,476
MA,BELAGUA,0,0,0,0.0,0,0,0,0.0,0,0,0,0.0,10,8,-2,-20.0,702,669,-33,-4.7,712,677,-35,-4.92,BELAGUA MA,-3.1604031,-43.5085052,9,477
MA,BELA VISTA DO MARANHAO,105,129,24,22.86,69,70,1,1.45,14,17,3,21.43,30,37,7,23.33,327,340,13,3.98,545,593,48,8.81,BELA VISTA DO MARANHAO MA,-3.7416367,-45.2514192,9,478
MA,BEQUIMAO,3,1,-2,-66.67,0,0,0,0.0,0,0,0,0.0,44,58,14,31.82,855,965,110,12.87,902,1024,122,13.53,BEQUIMAO MA,-2.4495376,-44.7884889,9,480
MA,BERNARDO DO MEARIM,2,12,10,500.0,0,0,0,0.0,12,11,-1,-8.33,19,21,2,10.53,183,180,-3,-1.64,216,224,8,3.7,BERNARDO DO MEARIM MA,-4.6315929,-44.7617508,9,481
MA,BOA VISTA DO GURUPI,0,0,0,0.0,0,0,0,0.0,2,0,-2,-100.0,43,35,-8,-18.6,385,343,-42,-10.91,430,378,-52,-12.09,BOA VISTA DO GURUPI MA,-1.7981168,-46.3071882,9,482
MA,BOM JARDIM,189,157,-32,-16.93,0,1,1,0.0,13,14,1,7.69,162,155,-7,-4.32,1402,1511,109,7.77,1766,1838,72,4.08,BOM JARDIM MA,-3.54129,-45.606004,9,483
MA,BOM JESUS DAS SELVAS,303,308,5,1.65,10,9,-1,-10.0,2,2,0,0.0,143,143,0,0.0,1011,1339,328,32.44,1469,1801,332,22.6,BOM JESUS DAS SELVAS MA,-4.4878075,-46.8526639,9,484
MA,BOM LUGAR,31,30,-1,-3.23,0,0,0,0.0,0,0,0,0.0,23,19,-4,-17.39,376,2,-374,-99.47,430,51,-379,-88.14,BOM LUGAR MA,-4.3728019,-45.0366054,9,485
MA,BREJO,83,91,8,9.64,9,8,-1,-11.11,9,6,-3,-33.33,234,249,15,6.41,1203,1033,-170,-14.13,1538,1387,-151,-9.82,BREJO MA,-3.6804397,-42.7529313,9,486
MA,BREJO DE AREIA,0,0,0,0.0,0,0,0,0.0,0,0,0,0.0,11,11,0,0.0,238,238,0,0.0,249,249,0,0.0,BREJO DE AREIA MA,-4.3316785,-45.5833334,9,487
MA,BURITI,66,48,-18,-27.27,0,0,0,0.0,9,1,-8,-88.89,96,104,8,8.33,858,16,-842,-98.14,1029,169,-860,-83.58,BURITI MA,-3.9430944,-42.9244281,9,488
MA,BURITI BRAVO,32,19,-13,-40.62,0,0,0,0.0,121,88,-33,-27.27,87,92,5,5.75,384,403,19,4.95,624,602,-22,-3.53,BURITI BRAVO MA,-5.8391884,-43.8367876,9,489
MA,BURITICUPU,243,225,-18,-7.41,33,24,-9,-27.27,6,9,3,50.0,657,600,-57,-8.68,3209,3388,179,5.58,4148,4246,98,2.36,BURITICUPU MA,-4.3227472,-46.4516989,9,490
MA,BURITIRANA,49,42,-7,-14.29,0,0,0,0.0,0,0,0,0.0,36,37,1,2.78,7,412,405,5785.71,92,491,399,433.7,BURITIRANA MA,-5.5897455,-47.0148915,9,491
MA,CAJAPIO,3,3,0,0.0,0,0,0,0.0,0,0,0,0.0,15,15,0,0.0,273,253,-20,-7.33,291,271,-20,-6.87,CAJAPIO MA,-2.8778715,-44.6746871,9,493
MA,CAJARI,0,0,0,0.0,0,0,0,0.0,0,0,0,0.0,24,20,-4,-16.67,699,609,-90,-12.88,723,629,-94,-13.0,CAJARI MA,-3.3213076,-45.0118757,9,494
MA,CAMPESTRE DO MARANHAO,352,528,176,50.0,282,300,18,6.38,1,0,-1,-100.0,122,87,-35,-28.69,642,445,-197,-30.69,1399,1360,-39,-2.79,CAMPESTRE DO MARANHAO MA,-6.1729113,-47.3640512,9,495
MA,CANDIDO MENDES,2,4,2,100.0,14,13,-1,-7.14,45,56,11,24.44,67,67,0,0.0,589,571,-18,-3.06,717,711,-6,-0.84,CANDIDO MENDES MA,-1.4531117,-45.7273136,9,496
MA,CANTANHEDE,6,18,12,200.0,2,2,0,0.0,14,9,-5,-35.71,58,59,1,1.72,692,601,-91,-13.15,772,689,-83,-10.75,CANTANHEDE MA,-3.6355005,-44.3778738,9,497
MA,CAPINZAL DO NORTE,132,149,17,12.88,1,1,0,0.0,0,241,241,0.0,89,75,-14,-15.73,368,321,-47,-12.77,590,787,197,33.39,CAPINZAL DO NORTE MA,-4.7304006,-44.3249063,9,498
MA,CAROLINA,469,477,8,1.71,428,354,-74,-17.29,10,1,-9,-90.0,445,456,11,2.47,1699,1171,-528,-31.08,3051,2459,-592,-19.4,CAROLINA MA,-7.3313437,-47.4738762,9,499
MA,CARUTAPERA,95,75,-20,-21.05,21,29,8,38.1,84,24,-60,-71.43,212,196,-16,-7.55,1280,968,-312,-24.38,1692,1292,-400,-23.64,CARUTAPERA MA,-1.2016638,-46.0205618,9,500
MA,CAXIAS,268,287,19,7.09,897,911,14,1.56,152,438,286,188.16,4212,4094,-118,-2.8,5807,5832,25,0.43,11336,11562,226,1.99,CAXIAS MA,-4.8654201,-43.353664,9,501
MA,CEDRAL,0,0,0,0.0,0,0,0,0.0,0,0,0,0.0,10,17,7,70.0,620,618,-2,-0.32,630,635,5,0.79,CEDRAL MA,-2.000269,-44.528114,9,502
MA,CENTRAL DO MARANHAO,1,1,0,0.0,0,1,1,0.0,0,0,0,0.0,1,1,0,0.0,184,13,-171,-92.93,186,16,-170,-91.4,CENTRAL DO MARANHAO MA,-2.1967253,-44.8290757,9,503
MA,CENTRO DO GUILHERME,2,1,-1,-50.0,0,0,0,0.0,0,0,0,0.0,24,26,2,8.33,560,352,-208,-37.14,586,379,-207,-35.32,CENTRO DO GUILHERME MA,-2.4511749,-46.039127,9,504
MA,CENTRO NOVO DO MARANHAO,24,21,-3,-12.5,59,40,-19,-32.2,0,0,0,0.0,43,29,-14,-32.56,567,538,-29,-5.11,693,628,-65,-9.38,CENTRO NOVO DO MARANHAO MA,-2.1361032,-46.1248528,9,505
MA,CHAPADINHA,94,91,-3,-3.19,244,379,135,55.33,23,22,-1,-4.35,1557,1616,59,3.79,2800,2524,-276,-9.86,4718,4632,-86,-1.82,CHAPADINHA MA,-3.7416803,-43.3548006,9,506
MA,CIDELANDIA,157,158,1,0.64,18,17,-1,-5.56,7,8,1,14.29,107,110,3,2.8,603,601,-2,-0.33,892,894,2,0.22,CIDELANDIA MA,-5.174655,-47.7833531,9,507
MA,CODO,293,280,-13,-4.44,788,1067,279,35.41,156,454,298,191.03,2577,2844,267,10.36,5035,3587,-1448,-28.76,8849,8232,-617,-6.97,CODO MA,-4.455623,-43.892354,9,508
MA,COELHO NETO,77,76,-1,-1.3,1121,1365,244,21.77,0,9,9,0.0,671,679,8,1.19,1509,1527,18,1.19,3378,3656,278,8.23,COELHO NETO MA,-4.2535154,-43.0149321,9,509
MA,COLINAS,43,35,-8,-18.6,163,134,-29,-17.79,219,194,-25,-11.42,615,562,-53,-8.62,1592,1980,388,24.37,2632,2905,273,10.37,COLINAS MA,-6.0332631,-44.2528542,9,510
MA,CONCEICAO DO LAGO-ACU,21,12,-9,-42.86,1,0,-1,-100.0,1,0,-1,-100.0,24,22,-2,-8.33,776,779,3,0.39,823,813,-10,-1.22,CONCEICAO DO LAGO-ACU MA,-3.8410056,-44.8930565,9,511
MA,COROATA,57,37,-20,-35.09,132,156,24,18.18,21,27,6,28.57,802,901,99,12.34,2400,2551,151,6.29,3412,3672,260,7.62,COROATA MA,-4.1282283,-44.1360269,9,512
MA,CURURUPU,0,0,0,0.0,7,4,-3,-42.86,0,1,1,0.0,160,149,-11,-6.88,1239,1236,-3,-0.24,1406,1390,-16,-1.14,CURURUPU MA,-1.824255,-44.872996,9,513
MA,DOM PEDRO,7,23,16,228.57,211,211,0,0.0,34,32,-2,-5.88,475,405,-70,-14.74,782,783,1,0.13,1509,1454,-55,-3.64,DOM PEDRO MA,-5.0398278,-44.4385724,9,515
MA,DUQUE BACELAR,0,0,0,0.0,0,0,0,0.0,0,0,0,0.0,27,28,1,3.7,410,322,-88,-21.46,437,350,-87,-19.91,DUQUE BACELAR MA,-4.1542795,-42.946096,9,516
MA,ESPERANTINOPOLIS,1,0,-1,-100.0,1,3,2,200.0,12,13,1,8.33,154,139,-15,-9.74,931,677,-254,-27.28,1099,832,-267,-24.29,ESPERANTINOPOLIS MA,-4.8751875,-44.8801032,9,517
MA,ESTREITO,316,104,-212,-67.09,180,147,-33,-18.33,92,88,-4,-4.35,977,1090,113,11.57,2185,1508,-677,-30.98,3750,2937,-813,-21.68,ESTREITO MA,-6.5583016,-47.4432212,9,518
MA,FEIRA NOVA DO MARANHAO,3,5,2,66.67,8,0,-8,-100.0,15,84,69,460.0,42,52,10,23.81,409,307,-102,-24.94,477,448,-29,-6.08,FEIRA NOVA DO MARANHAO MA,-6.965082,-46.678577,9,519
MA,FERNANDO FALCAO,0,45,45,0.0,0,0,0,0.0,0,0,0,0.0,2,3,1,50.0,277,294,17,6.14,279,342,63,22.58,FERNANDO FALCAO MA,-6.1512461,-44.9022436,9,520
MA,FORMOSA DA SERRA NEGRA,12,13,1,8.33,3,4,1,33.33,0,1,1,0.0,107,112,5,4.67,644,633,-11,-1.71,766,763,-3,-0.39,FORMOSA DA SERRA NEGRA MA,-6.4437601,-46.1905789,9,521
MA,FORTALEZA DOS NOGUEIRAS,92,104,12,13.04,11,10,-1,-9.09,16,14,-2,-12.5,157,155,-2,-1.27,651,621,-30,-4.61,927,904,-23,-2.48,FORTALEZA DOS NOGUEIRAS MA,-6.9643779,-46.1703933,9,522
MA,FORTUNA,2,0,-2,-100.0,0,10,10,0.0,0,0,0,0.0,38,46,8,21.05,445,421,-24,-5.39,485,477,-8,-1.65,FORTUNA MA,-5.7331469,-44.154276,9,523
MA,GODOFREDO VIANA,0,0,0,0.0,279,350,71,25.45,460,525,65,14.13,28,24,-4,-14.29,550,658,108,19.64,1317,1557,240,18.22,GODOFREDO VIANA MA,-1.4147105,-45.7713182,9,524
MA,GONCALVES DIAS,0,0,0,0.0,1,1,0,0.0,0,26,26,0.0,56,43,-13,-23.21,586,524,-62,-10.58,643,594,-49,-7.62,GONCALVES DIAS MA,-5.1532875,-44.2997071,9,525
MA,GOVERNADOR ARCHER,31,24,-7,-22.58,0,0,0,0.0,0,0,0,0.0,13,8,-5,-38.46,280,314,34,12.14,324,346,22,6.79,GOVERNADOR ARCHER MA,-5.023562,-44.2709924,9,526
MA,GOVERNADOR EDISON LOBAO,130,116,-14,-10.77,655,663,8,1.22,9,9,0,0.0,175,173,-2,-1.14,1119,1154,35,3.13,2088,2115,27,1.29,GOVERNADOR EDISON LOBAO MA,-5.7456705,-47.363091,9,527
MA,GOVERNADOR EUGENIO BARROS,9,15,6,66.67,0,0,0,0.0,0,0,0,0.0,38,44,6,15.79,442,433,-9,-2.04,489,492,3,0.61,GOVERNADOR EUGENIO BARROS MA,-5.3200262,-44.2440583,9,528
MA,GOVERNADOR LUIZ ROCHA,4,9,5,125.0,0,0,0,0.0,0,0,0,0.0,28,26,-2,-7.14,508,495,-13,-2.56,540,530,-10,-1.85,GOVERNADOR LUIZ ROCHA MA,-5.470776,-44.0720572,9,529
MA,GOVERNADOR NEWTON BELLO,32,35,3,9.38,0,0,0,0.0,0,0,0,0.0,6,5,-1,-16.67,275,276,1,0.36,313,316,3,0.96,GOVERNADOR NEWTON BELLO MA,-3.4285914,-45.6714297,9,530
MA,GOVERNADOR NUNES FREIRE,8,10,2,25.0,2,3,1,50.0,0,0,0,0.0,191,179,-12,-6.28,1005,1000,-5,-0.5,1206,1192,-14,-1.16,GOVERNADOR NUNES FREIRE MA,-2.1303959,-45.8900498,9,531
MA,GRACA ARANHA,0,0,0,0.0,0,0,0,0.0,0,0,0,0.0,18,16,-2,-11.11,196,194,-2,-1.02,214,210,-4,-1.87,GRACA ARANHA MA,-5.4063519,-44.33271,9,532
MA,GRAJAU,1057,1138,81,7.66,430,470,40,9.3,56,61,5,8.93,1200,1336,136,11.33,3411,3222,-189,-5.54,6154,6227,73,1.19,GRAJAU MA,-5.8154034,-46.1361454,9,533
MA,GUIMARAES,0,0,0,0.0,0,0,0,0.0,0,0,0,0.0,13,14,1,7.69,457,393,-64,-14.0,470,407,-63,-13.4,GUIMARAES MA,-2.127551,-44.60199,9,534
MA,HUMBERTO DE CAMPOS,0,0,0,0.0,75,38,-37,-49.33,27,0,-27,-100.0,99,94,-5,-5.05,1464,1678,214,14.62,1665,1810,145,8.71,HUMBERTO DE CAMPOS MA,-2.598282,-43.464877,9,535
MA,ICATU,0,0,0,0.0,0,0,0,0.0,1,1,0,0.0,102,96,-6,-5.88,1004,953,-51,-5.08,1107,1050,-57,-5.15,ICATU MA,-2.772065,-44.050061,9,536
MA,IGARAPE DO MEIO,63,30,-33,-52.38,441,432,-9,-2.04,0,0,0,0.0,51,25,-26,-50.98,324,334,10,3.09,879,821,-58,-6.6,IGARAPE DO MEIO MA,-3.6397814,-45.1872837,9,537
MA,IGARAPE GRANDE,7,6,-1,-14.29,35,35,0,0.0,9,15,6,66.67,39,37,-2,-5.13,316,301,-15,-4.75,406,394,-12,-2.96,IGARAPE GRANDE MA,-4.6621855,-44.8546609,9,538
MA,IMPERATRIZ,589,1457,868,147.37,4671,5144,473,10.13,3124,3871,747,23.91,18300,19069,769,4.2,29776,29565,-211,-0.71,56460,59106,2646,4.69,IMPERATRIZ MA,-5.5269279,-47.478115,9,539
MA,ITAIPAVA DO GRAJAU,4,0,-4,-100.0,0,0,0,0.0,0,0,0,0.0,35,30,-5,-14.29,226,212,-14,-6.19,265,242,-23,-8.68,ITAIPAVA DO GRAJAU MA,-5.1421474,-45.7878573,9,540
MA,ITAPECURU MIRIM,35,58,23,65.71,625,770,145,23.2,65,317,252,387.69,922,1062,140,15.18,2299,2153,-146,-6.35,3946,4360,414,10.49,ITAPECURU MIRIM MA,-3.3973569,-44.3560724,9,541
MA,ITINGA DO MARANHAO,740,767,27,3.65,185,164,-21,-11.35,16,17,1,6.25,434,392,-42,-9.68,1452,1360,-92,-6.34,2827,2700,-127,-4.49,ITINGA DO MARANHAO MA,-4.452925,-47.5253727,9,542
MA,JATOBA,1,1,0,0.0,0,0,0,0.0,0,1,1,0.0,1,2,1,100.0,376,354,-22,-5.85,378,358,-20,-5.29,JATOBA MA,-5.8195391,-44.223188,9,543
MA,JENIPAPO DOS VIEIRAS,0,0,0,0.0,0,0,0,0.0,0,0,0,0.0,31,28,-3,-9.68,539,541,2,0.37,570,569,-1,-0.18,JENIPAPO DOS VIEIRAS MA,-5.3679814,-45.6348267,9,544
MA,JOAO LISBOA,122,102,-20,-16.39,153,173,20,13.07,7,13,6,85.71,170,197,27,15.88,1041,1065,24,2.31,1493,1550,57,3.82,JOAO LISBOA MA,-5.44363,-47.406388,9,545
MA,JOSELANDIA,0,0,0,0.0,0,0,0,0.0,0,0,0,0.0,39,41,2,5.13,477,476,-1,-0.21,516,517,1,0.19,JOSELANDIA MA,-4.9860047,-44.696953,9,546
MA,JUNCO DO MARANHAO,0,0,0,0.0,0,0,0,0.0,0,0,0,0.0,2,2,0,0.0,543,567,24,4.42,545,569,24,4.4,JUNCO DO MARANHAO MA,-1.8799132,-46.0726685,9,547
MA,LAGO DA PEDRA,66,57,-9,-13.64,63,66,3,4.76,16,13,-3,-18.75,640,683,43,6.72,1736,1766,30,1.73,2521,2585,64,2.54,LAGO DA PEDRA MA,-4.5627272,-45.1298628,9,548
MA,LAGO DO JUNCO,14,9,-5,-35.71,6,6,0,0.0,0,0,0,0.0,17,16,-1,-5.88,410,420,10,2.44,447,451,4,0.89,LAGO DO JUNCO MA,-4.6070838,-45.0530093,9,549
MA,LAGO VERDE,28,34,6,21.43,0,0,0,0.0,0,0,0,0.0,62,54,-8,-12.9,560,557,-3,-0.54,650,645,-5,-0.77,LAGO VERDE MA,-4.042525,-44.9364782,9,550
MA,LAGOA DO MATO,19,17,-2,-10.53,0,0,0,0.0,0,0,0,0.0,15,20,5,33.33,387,392,5,1.29,421,429,8,1.9,LAGOA DO MATO MA,-6.04865,-43.5273907,9,551
MA,LAGO DOS RODRIGUES,8,8,0,0.0,0,0,0,0.0,16,3,-13,-81.25,52,45,-7,-13.46,409,441,32,7.82,485,497,12,2.47,LAGO DOS RODRIGUES MA,-4.6119168,-44.9800419,9,552
MA,LAGOA GRANDE DO MARANHAO,0,3,3,0.0,0,0,0,0.0,0,0,0,0.0,38,28,-10,-26.32,354,359,5,1.41,392,390,-2,-0.51,LAGOA GRANDE DO MARANHAO MA,-4.9914281,-45.3832921,9,553
MA,LAJEADO NOVO,57,55,-2,-3.51,0,0,0,0.0,1,1,0,0.0,31,30,-1,-3.23,322,212,-110,-34.16,411,298,-113,-27.49,LAJEADO NOVO MA,-6.1898777,-47.0325965,9,554
MA,LIMA CAMPOS,9,4,-5,-55.56,14,14,0,0.0,4,2,-2,-50.0,78,80,2,2.56,516,456,-60,-11.63,621,556,-65,-10.47,LIMA CAMPOS MA,-4.5179809,-44.4671291,9,555
MA,LORETO,591,557,-34,-5.75,20,21,1,5.0,0,37,37,0.0,95,75,-20,-21.05,520,473,-47,-9.04,1226,1163,-63,-5.14,LORETO MA,-7.08562,-45.1397421,9,556
MA,LUIS DOMINGUES,0,0,0,0.0,0,0,0,0.0,0,0,0,0.0,7,10,3,42.86,383,3,-380,-99.22,390,13,-377,-96.67,LUIS DOMINGUES MA,-1.3284412,-45.8975062,9,557
MA,MAGALHAES DE ALMEIDA,95,59,-36,-37.89,0,0,0,0.0,2,2,0,0.0,67,62,-5,-7.46,881,870,-11,-1.25,1045,993,-52,-4.98,MAGALHAES DE ALMEIDA MA,-3.392319,-42.211743,9,558
MA,MARACACUME,54,55,1,1.85,15,19,4,26.67,0,1,1,0.0,180,200,20,11.11,700,615,-85,-12.14,949,890,-59,-6.22,MARACACUME MA,-2.049177,-45.958734,9,559
MA,MARAJA DO SENA,2,3,1,50.0,0,0,0,0.0,0,0,0,0.0,1,5,4,400.0,2,298,296,14800.0,5,306,301,6020.0,MARAJA DO SENA MA,-4.6213998,-45.4539567,9,560
MA,MARANHAOZINHO,0,10,10,0.0,0,0,0,0.0,15,16,1,6.67,25,20,-5,-20.0,717,556,-161,-22.45,757,602,-155,-20.48,MARANHAOZINHO MA,-2.2429316,-45.8588977,9,561
MA,MATA ROMA,52,62,10,19.23,2,2,0,0.0,269,134,-135,-50.19,78,70,-8,-10.26,700,653,-47,-6.71,1101,921,-180,-16.35,MATA ROMA MA,-3.6210147,-43.1156951,9,562
MA,MATINHA,36,36,0,0.0,25,19,-6,-24.0,24,26,2,8.33,96,77,-19,-19.79,876,827,-49,-5.59,1057,985,-72,-6.81,MATINHA MA,-3.102212,-45.032208,9,563
MA,MATOES,21,24,3,14.29,2,0,-2,-100.0,8,13,5,62.5,93,94,1,1.08,1258,1246,-12,-0.95,1382,1377,-5,-0.36,MATOES MA,-5.5210672,-43.2041534,9,564
MA,MATOES DO NORTE,16,17,1,6.25,0,6,6,0.0,0,0,0,0.0,8,8,0,0.0,249,573,324,130.12,273,604,331,121.25,MATOES DO NORTE MA,-3.6268881,-44.5547543,9,565
MA,MILAGRES DO MARANHAO,4,5,1,25.0,0,0,0,0.0,0,0,0,0.0,2,2,0,0.0,341,353,12,3.52,347,360,13,3.75,MILAGRES DO MARANHAO MA,-3.5815605,-42.6080355,9,566
MA,MIRADOR,29,70,41,141.38,1,0,-1,-100.0,7,0,-7,-100.0,131,143,12,9.16,433,450,17,3.93,601,663,62,10.32,MIRADOR MA,-6.3703992,-44.3621057,9,567
MA,MIRANDA DO NORTE,61,102,41,67.21,106,89,-17,-16.04,0,4,4,0.0,250,213,-37,-14.8,928,933,5,0.54,1345,1341,-4,-0.3,MIRANDA DO NORTE MA,-3.5658706,-44.5825329,9,568
MA,MIRINZAL,0,0,0,0.0,17,15,-2,-11.76,2,0,-2,-100.0,86,80,-6,-6.98,413,367,-46,-11.14,518,462,-56,-10.81,MIRINZAL MA,-2.0664539,-44.7837348,9,569
MA,MONCAO,35,33,-2,-5.71,0,0,0,0.0,32,26,-6,-18.75,51,54,3,5.88,1204,1168,-36,-2.99,1322,1281,-41,-3.1,MONCAO MA,-3.4842036,-45.2515472,9,570
MA,MONTES ALTOS,32,30,-2,-6.25,3,3,0,0.0,0,0,0,0.0,30,34,4,13.33,329,344,15,4.56,394,411,17,4.31,MONTES ALTOS MA,-5.8316731,-47.0658003,9,571
MA,NINA RODRIGUES,0,0,0,0.0,1,1,0,0.0,0,1,1,0.0,7,9,2,28.57,370,325,-45,-12.16,378,336,-42,-11.11,NINA RODRIGUES MA,-3.467884,-43.91342,9,573
MA,NOVA COLINAS,32,37,5,15.62,0,0,0,0.0,0,0,0,0.0,29,27,-2,-6.9,295,298,3,1.02,356,362,6,1.69,NOVA COLINAS MA,-7.1196897,-46.2610972,9,574
MA,NOVA IORQUE,58,55,-3,-5.17,0,0,0,0.0,1,0,-1,-100.0,8,8,0,0.0,205,200,-5,-2.44,272,263,-9,-3.31,NOVA IORQUE MA,-6.7357067,-44.046151,9,575
MA,NOVA OLINDA DO MARANHAO,42,27,-15,-35.71,20,16,-4,-20.0,5,1,-4,-80.0,50,50,0,0.0,257,345,88,34.24,374,439,65,17.38,NOVA OLINDA DO MARANHAO MA,-2.8043732,-45.7013215,9,576
MA,OLINDA NOVA DO MARANHAO,0,0,0,0.0,1,1,0,0.0,15,4,-11,-73.33,34,33,-1,-2.94,472,513,41,8.69,522,551,29,5.56,OLINDA NOVA DO MARANHAO MA,-2.9960265,-44.9946822,9,578
MA,PALMEIRANDIA,1,1,0,0.0,4,4,0,0.0,0,0,0,0.0,13,12,-1,-7.69,858,834,-24,-2.8,876,851,-25,-2.85,PALMEIRANDIA MA,-2.6474166,-44.8983779,9,580
MA,PARAIBANO,4,6,2,50.0,29,37,8,27.59,59,32,-27,-45.76,162,159,-3,-1.85,677,746,69,10.19,931,980,49,5.26,PARAIBANO MA,-6.4316929,-43.9877038,9,581
MA,PARNARAMA,247,249,2,0.81,8,6,-2,-25.0,15,72,57,380.0,141,145,4,2.84,1614,1508,-106,-6.57,2025,1980,-45,-2.22,PARNARAMA MA,-5.6823685,-43.0895346,9,582
MA,PASSAGEM FRANCA,72,80,8,11.11,41,19,-22,-53.66,44,35,-9,-20.45,193,149,-44,-22.8,50,445,395,790.0,400,728,328,82.0,PASSAGEM FRANCA MA,-6.177451,-43.775511,9,583
MA,PASTOS BONS,5,4,-1,-20.0,41,41,0,0.0,201,326,125,62.19,208,225,17,8.17,645,703,58,8.99,1100,1299,199,18.09,PASTOS BONS MA,-6.6013999,-44.0878124,9,584
MA,PAULINO NEVES,0,0,0,0.0,3,7,4,133.33,0,0,0,0.0,43,43,0,0.0,5,702,697,13940.0,51,752,701,1374.51,PAULINO NEVES MA,-2.7227359,-42.5397648,9,585
MA,PAULO RAMOS,6,25,19,316.67,5,5,0,0.0,4,4,0,0.0,138,122,-16,-11.59,777,767,-10,-1.29,930,923,-7,-0.75,PAULO RAMOS MA,-4.4491095,-45.2420345,9,586
MA,PEDREIRAS,36,31,-5,-13.89,133,219,86,64.66,35,25,-10,-28.57,1842,1832,-10,-0.54,2304,1966,-338,-14.67,4350,4073,-277,-6.37,PEDREIRAS MA,-4.5687989,-44.6003029,9,587
MA,PEDRO DO ROSARIO,5,4,-1,-20.0,0,0,0,0.0,0,4,4,0.0,22,29,7,31.82,697,910,213,30.56,724,947,223,30.8,PEDRO DO ROSARIO MA,-2.972719,-45.349316,9,588
MA,PENALVA,7,2,-5,-71.43,0,0,0,0.0,0,0,0,0.0,127,111,-16,-12.6,1136,1046,-90,-7.92,1270,1159,-111,-8.74,PENALVA MA,-3.2881215,-45.1742086,9,589
MA,PERI MIRIM,7,7,0,0.0,1,1,0,0.0,0,0,0,0.0,44,39,-5,-11.36,500,483,-17,-3.4,552,530,-22,-3.99,PERI MIRIM MA,-2.5768477,-44.8556207,9,590
MA,PERITORO,29,33,4,13.79,5,20,15,300.0,0,0,0,0.0,142,124,-18,-12.68,878,847,-31,-3.53,1054,1024,-30,-2.85,PERITORO MA,-4.3723643,-44.3317455,9,591
MA,PINDARE-MIRIM,240,275,35,14.58,141,151,10,7.09,17,7,-10,-58.82,291,316,25,8.59,1325,1157,-168,-12.68,2014,1906,-108,-5.36,PINDARE-MIRIM MA,-3.6124457,-45.3404235,9,592
MA,PINHEIRO,19,11,-8,-42.11,140,184,44,31.43,62,48,-14,-22.58,2407,2271,-136,-5.65,2226,2402,176,7.91,4854,4916,62,1.28,PINHEIRO MA,-2.5270459,-45.0866463,9,593
MA,PIRAPEMAS,0,0,0,0.0,0,0,0,0.0,2,0,-2,-100.0,51,48,-3,-5.88,609,617,8,1.31,662,665,3,0.45,PIRAPEMAS MA,-3.7270563,-44.2267429,9,595
MA,POCAO DE PEDRAS,8,15,7,87.5,1,1,0,0.0,0,0,0,0.0,74,63,-11,-14.86,690,647,-43,-6.23,773,726,-47,-6.08,POCAO DE PEDRAS MA,-4.751125,-44.9430514,9,596
MA,PORTO RICO DO MARANHAO,0,0,0,0.0,0,0,0,0.0,0,0,0,0.0,0,0,0,0.0,261,259,-2,-0.77,261,259,-2,-0.77,PORTO RICO DO MARANHAO MA,-1.8597328,-44.5854991,9,598
MA,PRESIDENTE DUTRA,42,40,-2,-4.76,196,526,330,168.37,97,103,6,6.19,1802,2171,369,20.48,1603,1957,354,22.08,3740,4797,1057,28.26,PRESIDENTE DUTRA MA,-5.289801,-44.49498,9,599
MA,PRESIDENTE MEDICI,199,204,5,2.51,540,531,-9,-1.67,58,99,41,70.69,583,665,82,14.07,1125,1107,-18,-1.6,2505,2606,101,4.03,PRESIDENTE MEDICI MA,-2.3764612,-45.8207313,9,601
MA,PRESIDENTE SARNEY,0,0,0,0.0,0,0,0,0.0,3,0,-3,-100.0,16,19,3,18.75,63,519,456,723.81,82,538,456,556.1,PRESIDENTE SARNEY MA,-2.5907563,-45.3623652,9,602
MA,PRESIDENTE VARGAS,1,1,0,0.0,0,0,0,0.0,0,0,0,0.0,12,5,-7,-58.33,691,424,-267,-38.64,704,430,-274,-38.92,PRESIDENTE VARGAS MA,-3.4065166,-44.0270508,9,603
MA,PRIMEIRA CRUZ,11,12,1,9.09,0,0,0,0.0,0,0,0,0.0,22,20,-2,-9.09,317,311,-6,-1.89,350,343,-7,-2.0,PRIMEIRA CRUZ MA,-2.5076725,-43.4385918,9,604
MA,RIACHAO,377,390,13,3.45,59,57,-2,-3.39,17,23,6,35.29,198,203,5,2.53,853,722,-131,-15.36,1504,1395,-109,-7.25,RIACHAO MA,-7.3642557,-46.6226095,9,606
MA,RIBAMAR FIQUENE,124,106,-18,-14.52,21,25,4,19.05,13,19,6,46.15,39,50,11,28.21,448,382,-66,-14.73,645,582,-63,-9.77,RIBAMAR FIQUENE MA,-5.930666,-47.388777,9,607
MA,ROSARIO,4,4,0,0.0,448,473,25,5.58,174,52,-122,-70.11,682,691,9,1.32,1675,1273,-402,-24.0,2983,2493,-490,-16.43,ROSARIO MA,-2.9405903,-44.2491088,9,608
MA,SAMBAIBA,336,314,-22,-6.55,2,1,-1,-50.0,2,0,-2,-100.0,17,25,8,47.06,479,275,-204,-42.59,836,615,-221,-26.44,SAMBAIBA MA,-7.134473,-45.351506,9,609
MA,SANTA FILOMENA DO MARANHAO,4,3,-1,-25.0,0,0,0,0.0,0,0,0,0.0,5,4,-1,-20.0,287,275,-12,-4.18,296,282,-14,-4.73,SANTA FILOMENA DO MARANHAO MA,-5.498196,-44.558146,9,610
MA,SANTA INES,184,187,3,1.63,176,231,55,31.25,101,112,11,10.89,4397,4456,59,1.34,4924,4549,-375,-7.62,9782,9535,-247,-2.53,SANTA INES MA,-3.6647821,-45.3826869,9,612
MA,SANTA LUZIA,389,382,-7,-1.8,17,16,-1,-5.88,0,0,0,0.0,525,505,-20,-3.81,2809,2607,-202,-7.19,3740,3510,-230,-6.15,SANTA LUZIA MA,-3.9633675,-45.6637956,9,613
MA,SANTA LUZIA DO PARUA,10,7,-3,-30.0,2,3,1,50.0,0,1,1,0.0,287,306,19,6.62,1386,1128,-258,-18.61,1685,1445,-240,-14.24,SANTA LUZIA DO PARUA MA,-2.5440662,-45.775757,9,614
MA,SANTA QUITERIA DO MARANHAO,24,16,-8,-33.33,6,6,0,0.0,1,1,0,0.0,129,135,6,4.65,855,843,-12,-1.4,1015,1001,-14,-1.38,SANTA QUITERIA DO MARANHAO MA,-3.4967557,-42.563878,9,615
MA,SANTA RITA,32,27,-5,-15.62,84,135,51,60.71,15,2,-13,-86.67,421,442,21,4.99,796,848,52,6.53,1348,1454,106,7.86,SANTA RITA MA,-3.1411146,-44.3270285,9,616
MA,SANTANA DO MARANHAO,0,0,0,0.0,0,0,0,0.0,0,0,0,0.0,14,21,7,50.0,377,365,-12,-3.18,391,386,-5,-1.28,SANTANA DO MARANHAO MA,-3.1156576,-42.4123538,9,617
MA,SANTO AMARO DO MARANHAO,0,0,0,0.0,4,2,-2,-50.0,0,0,0,0.0,19,22,3,15.79,597,606,9,1.51,620,630,10,1.61,SANTO AMARO DO MARANHAO MA,-2.4987599,-43.253274,9,618
MA,SANTO ANTONIO DOS LOPES,7,8,1,14.29,305,348,43,14.1,12,13,1,8.33,97,80,-17,-17.53,829,833,4,0.48,1250,1282,32,2.56,SANTO ANTONIO DOS LOPES MA,-4.866134,-44.365278,9,619
MA,SAO BENEDITO DO RIO PRETO,5,6,1,20.0,1,3,2,200.0,6,5,-1,-16.67,69,68,-1,-1.45,634,625,-9,-1.42,715,707,-8,-1.12,SAO BENEDITO DO RIO PRETO MA,-3.3306675,-43.5264074,9,620
MA,SAO BENTO,0,0,0,0.0,16,6,-10,-62.5,0,0,0,0.0,271,275,4,1.48,970,963,-7,-0.72,1257,1244,-13,-1.03,SAO BENTO MA,-2.6999089,-44.8331254,9,621
MA,SAO BERNARDO,2,0,-2,-100.0,15,65,50,333.33,4,13,9,225.0,387,378,-9,-2.33,803,479,-324,-40.35,1211,935,-276,-22.79,SAO BERNARDO MA,-3.3650267,-42.4224814,9,622
MA,SAO DOMINGOS DO AZEITAO,90,105,15,16.67,0,0,0,0.0,1,9,8,800.0,133,168,35,26.32,395,310,-85,-21.52,619,592,-27,-4.36,SAO DOMINGOS DO AZEITAO MA,-6.810868,-44.6445713,9,623
MA,SAO DOMINGOS DO MARANHAO,6,8,2,33.33,24,24,0,0.0,3,1,-2,-66.67,327,459,132,40.37,801,906,105,13.11,1161,1398,237,20.41,SAO DOMINGOS DO MARANHAO MA,-5.5799743,-44.3841617,9,624
MA,SAO FELIX DE BALSAS,4,8,4,100.0,0,0,0,0.0,11,13,2,18.18,15,17,2,13.33,287,282,-5,-1.74,317,320,3,0.95,SAO FELIX DE BALSAS MA,-7.0834586,-44.8139329,9,625
MA,SAO FRANCISCO DO BREJAO,109,115,6,5.5,35,30,-5,-14.29,0,0,0,0.0,43,37,-6,-13.95,423,357,-66,-15.6,610,539,-71,-11.64,SAO FRANCISCO DO BREJAO MA,-5.124869,-47.3871865,9,626
MA,SAO JOAO BATISTA,0,0,0,0.0,0,0,0,0.0,0,0,0,0.0,51,51,0,0.0,1052,941,-111,-10.55,1103,992,-111,-10.06,SAO JOAO BATISTA MA,-3.1283972,-58.3804917,9,628
MA,SAO JOAO DO CARU,9,0,-9,-100.0,0,0,0,0.0,0,0,0,0.0,20,28,8,40.0,19,7,-12,-63.16,48,35,-13,-27.08,SAO JOAO DO CARU MA,-3.5556764,-46.2569799,9,629
MA,SAO JOAO DO PARAISO,49,40,-9,-18.37,6,0,-6,-100.0,0,0,0,0.0,64,63,-1,-1.56,597,580,-17,-2.85,716,683,-33,-4.61,SAO JOAO DO PARAISO MA,-6.4637943,-47.0567941,9,630
MA,SAO JOAO DO SOTER,10,22,12,120.0,2,5,3,150.0,0,0,0,0.0,26,24,-2,-7.69,388,417,29,7.47,426,468,42,9.86,SAO JOAO DO SOTER MA,-5.1122323,-43.8109269,9,631
MA,SAO JOAO DOS PATOS,49,40,-9,-18.37,42,137,95,226.19,62,72,10,16.13,576,546,-30,-5.21,1508,1463,-45,-2.98,2237,2258,21,0.94,SAO JOAO DOS PATOS MA,-6.4934,-43.703623,9,632
MA,SAO JOSE DOS BASILIOS,7,7,0,0.0,0,0,0,0.0,0,4,4,0.0,17,14,-3,-17.65,207,202,-5,-2.42,231,227,-4,-1.73,SAO JOSE DOS BASILIOS MA,-5.0530693,-44.5843209,9,634
MA,SAO LUIS,155,161,6,3.87,11876,13825,1949,16.41,22987,24644,1657,7.21,55774,56994,1220,2.19,253743,249449,-4294,-1.69,344535,345073,538,0.16,SAO LUIS MA,-2.5295265,-44.2963942,9,635
MA,SAO LUIS GONZAGA DO MARANHAO,66,65,-1,-1.52,0,0,0,0.0,2,1,-1,-50.0,61,50,-11,-18.03,798,759,-39,-4.89,927,875,-52,-5.61,SAO LUIS GONZAGA DO MARANHAO MA,-4.3727458,-44.6690368,9,636
MA,SAO MATEUS DO MARANHAO,30,34,4,13.33,25,12,-13,-52.0,25,19,-6,-24.0,437,440,3,0.69,1453,1429,-24,-1.65,1970,1934,-36,-1.83,SAO MATEUS DO MARANHAO MA,-4.0289169,-44.4667342,9,637
MA,SAO PEDRO DA AGUA BRANCA,26,18,-8,-30.77,42,53,11,26.19,0,0,0,0.0,71,88,17,23.94,509,417,-92,-18.07,648,576,-72,-11.11,SAO PEDRO DA AGUA BRANCA MA,-5.083403,-48.4299175,9,638
MA,SAO PEDRO DOS CRENTES,5,5,0,0.0,0,0,0,0.0,0,0,0,0.0,47,49,2,4.26,257,206,-51,-19.84,309,260,-49,-15.86,SAO PEDRO DOS CRENTES MA,-6.823889,-46.531864,9,639
MA,SAO RAIMUNDO DAS MANGABEIRAS,486,480,-6,-1.23,762,773,11,1.44,156,139,-17,-10.9,329,330,1,0.3,961,827,-134,-13.94,2694,2549,-145,-5.38,SAO RAIMUNDO DAS MANGABEIRAS MA,-7.023608,-45.4769436,9,640
MA,SAO RAIMUNDO DO DOCA BEZERRA,0,0,0,0.0,0,0,0,0.0,0,0,0,0.0,12,2,-10,-83.33,276,279,3,1.09,288,281,-7,-2.43,SAO RAIMUNDO DO DOCA BEZERRA MA,-5.1042784,-45.0847117,9,641
MA,SAO ROBERTO,0,0,0,0.0,0,0,0,0.0,0,0,0,0.0,2,2,0,0.0,289,272,-17,-5.88,291,274,-17,-5.84,SAO ROBERTO MA,-5.0188478,-44.9925058,9,642
MA,SAO VICENTE FERRER,0,0,0,0.0,0,3,3,0.0,1,1,0,0.0,77,77,0,0.0,705,680,-25,-3.55,783,761,-22,-2.81,SAO VICENTE FERRER MA,-2.8927449,-44.8803633,9,643
MA,SATUBINHA,4,3,-1,-25.0,0,0,0,0.0,0,0,0,0.0,5,11,6,120.0,410,381,-29,-7.07,419,395,-24,-5.73,SATUBINHA MA,-3.847807,-45.2563709,9,644
MA,SENADOR ALEXANDRE COSTA,3,28,25,833.33,0,0,0,0.0,0,1,1,0.0,37,32,-5,-13.51,275,308,33,12.0,315,369,54,17.14,SENADOR ALEXANDRE COSTA MA,-5.2597445,-44.0542395,9,645
MA,SENADOR LA ROCQUE,101,100,-1,-0.99,5,0,-5,-100.0,1,1,0,0.0,110,110,0,0.0,703,674,-29,-4.13,920,885,-35,-3.8,SENADOR LA ROCQUE MA,-5.4444319,-47.2921001,9,646
MA,SERRANO DO MARANHAO,0,0,0,0.0,8,8,0,0.0,0,0,0,0.0,9,9,0,0.0,518,522,4,0.77,535,539,4,0.75,SERRANO DO MARANHAO MA,-1.8535718,-45.1158856,9,647
MA,SITIO NOVO,72,22,-50,-69.44,20,18,-2,-10.0,0,0,0,0.0,82,81,-1,-1.22,819,781,-38,-4.64,993,902,-91,-9.16,SITIO NOVO MA,-5.881254,-46.7017184,9,648
MA,SUCUPIRA DO NORTE,50,56,6,12.0,0,0,0,0.0,1,0,-1,-100.0,45,55,10,22.22,389,363,-26,-6.68,485,474,-11,-2.27,SUCUPIRA DO NORTE MA,-6.478392,-44.191889,9,649
MA,SUCUPIRA DO RIACHAO,3,0,-3,-100.0,7,7,0,0.0,0,0,0,0.0,17,17,0,0.0,220,239,19,8.64,247,263,16,6.48,SUCUPIRA DO RIACHAO MA,-6.4136163,-43.5453433,9,650
MA,TASSO FRAGOSO,1027,1087,60,5.84,6,9,3,50.0,4,2,-2,-50.0,96,114,18,18.75,654,640,-14,-2.14,1787,1852,65,3.64,TASSO FRAGOSO MA,-8.4729347,-45.7461798,9,651
MA,TIMBIRAS,6,6,0,0.0,15,8,-7,-46.67,1,1,0,0.0,180,180,0,0.0,31,1070,1039,3351.61,233,1265,1032,442.92,TIMBIRAS MA,-4.2551056,-43.9386212,9,652
MA,TUFILANDIA,5,9,4,80.0,0,0,0,0.0,0,0,0,0.0,5,4,-1,-20.0,304,307,3,0.99,314,320,6,1.91,TUFILANDIA MA,-3.6734127,-45.6357014,9,655
MA,TUNTUM,87,83,-4,-4.6,65,58,-7,-10.77,0,0,0,0.0,285,283,-2,-0.7,770,133,-637,-82.73,1207,557,-650,-53.85,TUNTUM MA,-5.2630885,-44.6448502,9,656
MA,TURIACU,4,7,3,75.0,0,0,0,0.0,0,4,4,0.0,51,60,9,17.65,1330,1334,4,0.3,1385,1405,20,1.44,TURIACU MA,-1.6710652,-45.3684095,9,657
MA,TUTOIA,0,0,0,0.0,75,128,53,70.67,5,6,1,20.0,702,853,151,21.51,3227,2517,-710,-22.0,4009,3504,-505,-12.6,TUTOIA MA,-2.761413,-42.275531,9,659
MA,URBANO SANTOS,198,185,-13,-6.57,3,2,-1,-33.33,0,1,1,0.0,215,289,74,34.42,1507,1692,185,12.28,1923,2169,246,12.79,URBANO SANTOS MA,-3.2036233,-43.3929106,9,660
MA,VARGEM GRANDE,83,104,21,25.3,114,82,-32,-28.07,7,3,-4,-57.14,448,455,7,1.56,1806,1663,-143,-7.92,2458,2307,-151,-6.14,VARGEM GRANDE MA,-3.5443611,-43.9149128,9,661
MA,VIANA,32,23,-9,-28.12,13,12,-1,-7.69,7,10,3,42.86,691,700,9,1.3,1223,1439,216,17.66,1966,2184,218,11.09,VIANA MA,-3.2099341,-45.0002456,9,662
MA,VILA NOVA DOS MARTIRIOS,413,661,248,60.05,23,40,17,73.91,1,0,-1,-100.0,52,50,-2,-3.85,508,387,-121,-23.82,997,1138,141,14.14,VILA NOVA DOS MARTIRIOS MA,-5.1879409,-48.1377908,9,663
MA,VITORIA DO MEARIM,10,8,-2,-20.0,19,17,-2,-10.53,0,12,12,0.0,240,240,0,0.0,1181,1167,-14,-1.19,1450,1444,-6,-0.41,VITORIA DO MEARIM MA,-3.4622876,-44.869715,9,664
MA,VITORINO FREIRE,163,167,4,2.45,13,11,-2,-15.38,5,1,-4,-80.0,250,328,78,31.2,1541,1567,26,1.69,1972,2074,102,5.17,VITORINO FREIRE MA,-4.2885303,-45.2417582,9,665
MA,ZE DOCA,39,25,-14,-35.9,63,74,11,17.46,5,3,-2,-40.0,675,609,-66,-9.78,2353,2289,-64,-2.72,3135,3000,-135,-4.31,ZE DOCA MA,-3.270145,-45.655344,9,666
PI,ACAUA,1,1,0,0.0,20,20,0,0.0,7,1,-6,-85.71,22,19,-3,-13.64,245,248,3,1.22,295,289,-6,-2.03,ACAUA PI,-8.219542,-41.083059,16,667
PI,AGRICOLANDIA,2,2,0,0.0,2,2,0,0.0,0,2,2,0.0,17,22,5,29.41,129,29,-100,-77.52,150,57,-93,-62.0,AGRICOLANDIA PI,-5.7967843,-42.6605131,16,668
PI,AGUA BRANCA,4,5,1,25.0,87,105,18,20.69,30,18,-12,-40.0,702,770,68,9.69,633,460,-173,-27.33,1456,1358,-98,-6.73,AGUA BRANCA PI,-5.8913922,-42.6361148,16,669
PI,ALAGOINHA DO PIAUI,0,0,0,0.0,0,0,0,0.0,0,0,0,0.0,9,13,4,44.44,258,214,-44,-17.05,267,227,-40,-14.98,ALAGOINHA DO PIAUI PI,-7.0090952,-40.939675,16,670
PI,ALEGRETE DO PIAUI,0,0,0,0.0,68,20,-48,-70.59,0,0,0,0.0,13,13,0,0.0,225,206,-19,-8.44,306,239,-67,-21.9,ALEGRETE DO PIAUI PI,-7.2440138,-40.8602296,16,671
PI,ALTO LONGA,3,2,-1,-33.33,12,6,-6,-50.0,2,11,9,450.0,88,96,8,9.09,648,596,-52,-8.02,753,711,-42,-5.58,ALTO LONGA PI,-5.2549051,-42.2072388,16,672
PI,ALTOS,27,36,9,33.33,242,250,8,3.31,205,132,-73,-35.61,697,714,17,2.44,1796,1312,-484,-26.95,2967,2444,-523,-17.63,ALTOS PI,-5.0393915,-42.4611694,16,673
PI,ALVORADA DO GURGUEIA,20,19,-1,-5.0,0,0,0,0.0,0,0,0,0.0,29,30,1,3.45,341,287,-54,-15.84,390,336,-54,-13.85,ALVORADA DO GURGUEIA PI,-8.4465288,-43.8655915,16,674
PI,ANGICAL DO PIAUI,8,6,-2,-25.0,3,3,0,0.0,0,0,0,0.0,83,81,-2,-2.41,275,188,-87,-31.64,369,278,-91,-24.66,ANGICAL DO PIAUI PI,-6.0872666,-42.7366138,16,676
PI,ANISIO DE ABREU,0,0,0,0.0,19,19,0,0.0,13,5,-8,-61.54,95,91,-4,-4.21,334,185,-149,-44.61,461,300,-161,-34.92,ANISIO DE ABREU PI,-9.183959,-43.049115,16,677
PI,ANTONIO ALMEIDA,111,101,-10,-9.01,49,67,18,36.73,0,0,0,0.0,20,18,-2,-10.0,223,188,-35,-15.7,403,374,-29,-7.2,ANTONIO ALMEIDA PI,-7.2186016,-44.1950248,16,678
PI,AROAZES,37,36,-1,-2.7,1,1,0,0.0,0,0,0,0.0,56,53,-3,-5.36,80,298,218,272.5,174,388,214,122.99,AROAZES PI,-6.1109109,-41.7881792,16,679
PI,AROEIRAS DO ITAIM,0,0,0,0.0,49,47,-2,-4.08,0,0,0,0.0,0,0,0,0.0,132,131,-1,-0.76,181,178,-3,-1.66,AROEIRAS DO ITAIM PI,-7.2797031,-41.5629681,16,680
PI,ARRAIAL,0,0,0,0.0,2,2,0,0.0,0,0,0,0.0,30,33,3,10.0,255,168,-87,-34.12,287,203,-84,-29.27,ARRAIAL PI,-6.6541632,-42.5335332,16,681
PI,ASSUNCAO DO PIAUI,0,0,0,0.0,0,0,0,0.0,0,0,0,0.0,2,2,0,0.0,350,339,-11,-3.14,352,341,-11,-3.12,ASSUNCAO DO PIAUI PI,-5.8610212,-41.0485091,16,682
PI,AVELINO LOPES,2,2,0,0.0,4,4,0,0.0,8,11,3,37.5,53,40,-13,-24.53,384,397,13,3.39,451,454,3,0.67,AVELINO LOPES PI,-10.1346855,-43.9489525,16,683
PI,BAIXA GRANDE DO RIBEIRO,1424,1676,252,17.7,55,133,78,141.82,38,34,-4,-10.53,238,184,-54,-22.69,505,374,-131,-25.94,2260,2401,141,6.24,BAIXA GRANDE DO RIBEIRO PI,-7.862861,-45.2113289,16,684
PI,BARRAS,17,16,-1,-5.88,135,136,1,0.74,38,44,6,15.79,596,617,21,3.52,1850,1803,-47,-2.54,2636,2616,-20,-0.76,BARRAS PI,-4.2446153,-42.2920241,16,686
PI,BARREIRAS DO PIAUI,104,113,9,8.65,1,1,0,0.0,0,0,0,0.0,3,2,-1,-33.33,133,109,-24,-18.05,241,225,-16,-6.64,BARREIRAS DO PIAUI PI,-9.9224524,-45.4763776,16,687
PI,BARRO DURO,0,0,0,0.0,13,13,0,0.0,17,7,-10,-58.82,52,86,34,65.38,339,211,-128,-37.76,421,317,-104,-24.7,BARRO DURO PI,-5.8180139,-42.5106589,16,688
PI,BATALHA,15,11,-4,-26.67,26,25,-1,-3.85,35,22,-13,-37.14,215,204,-11,-5.12,881,771,-110,-12.49,1172,1033,-139,-11.86,BATALHA PI,-4.022391,-42.0780926,16,689
PI,BELA VISTA DO PIAUI,0,0,0,0.0,0,0,0,0.0,1,1,0,0.0,16,21,5,31.25,210,152,-58,-27.62,227,174,-53,-23.35,BELA VISTA DO PIAUI PI,-7.9716353,-41.8715061,16,690
PI,BELEM DO PIAUI,0,0,0,0.0,0,0,0,0.0,25,34,9,36.0,3,4,1,33.33,157,160,3,1.91,185,198,13,7.03,BELEM DO PIAUI PI,-7.3767305,-40.9712156,16,691
PI,BENEDITINOS,5,3,-2,-40.0,5,5,0,0.0,0,1,1,0.0,59,64,5,8.47,429,372,-57,-13.29,498,445,-53,-10.64,BENEDITINOS PI,-5.4565671,-42.3605061,16,692
PI,BERTOLINIA,0,1,1,0.0,3,3,0,0.0,9,1,-8,-88.89,39,34,-5,-12.82,235,224,-11,-4.68,286,263,-23,-8.04,BERTOLINIA PI,-7.6372159,-43.9540611,16,693
PI,BETANIA DO PIAUI,0,0,0,0.0,0,0,0,0.0,0,0,0,0.0,20,23,3,15.0,294,280,-14,-4.76,314,303,-11,-3.5,BETANIA DO PIAUI PI,-8.1460635,-40.7961387,16,694
PI,BOA HORA,5,8,3,60.0,0,0,0,0.0,0,0,0,0.0,15,13,-2,-13.33,329,307,-22,-6.69,349,328,-21,-6.02,BOA HORA PI,-4.4097328,-42.1253651,16,695
PI,BOCAINA,0,0,0,0.0,0,1,1,0.0,0,0,0,0.0,10,10,0,0.0,321,158,-163,-50.78,331,169,-162,-48.94,BOCAINA PI,-6.9445939,-41.3224599,16,696
PI,BOM JESUS,438,424,-14,-3.2,117,144,27,23.08,60,53,-7,-11.67,1206,1243,37,3.07,1703,1381,-322,-18.91,3524,3245,-279,-7.92,BOM JESUS PI,-9.0711644,-44.3583926,16,697
PI,BOM PRINCIPIO DO PIAUI,0,0,0,0.0,4,20,16,400.0,0,0,0,0.0,8,6,-2,-25.0,400,428,28,7.0,412,454,42,10.19,BOM PRINCIPIO DO PIAUI PI,-3.1912777,-41.6430185,16,698
PI,BONFIM DO PIAUI,0,0,0,0.0,0,0,0,0.0,0,0,0,0.0,35,38,3,8.57,81,80,-1,-1.23,116,118,2,1.72,BONFIM DO PIAUI PI,-9.1648678,-42.8734415,16,699
PI,BOQUEIRAO DO PIAUI,0,0,0,0.0,0,0,0,0.0,0,0,0,0.0,16,18,2,12.5,272,216,-56,-20.59,288,234,-54,-18.75,BOQUEIRAO DO PIAUI PI,-4.4850148,-42.1095161,16,700
PI,BRASILEIRA,12,9,-3,-25.0,0,0,0,0.0,12,18,6,50.0,32,26,-6,-18.75,324,313,-11,-3.4,380,366,-14,-3.68,BRASILEIRA PI,-4.131182,-41.7824969,16,701
PI,BREJO DO PIAUI,0,0,0,0.0,0,6,6,0.0,0,0,0,0.0,14,15,1,7.14,219,213,-6,-2.74,233,234,1,0.43,BREJO DO PIAUI PI,-8.207583,-42.8359849,16,702
PI,BURITI DOS LOPES,66,84,18,27.27,165,159,-6,-3.64,0,0,0,0.0,168,153,-15,-8.93,663,580,-83,-12.52,1062,976,-86,-8.1,BURITI DOS LOPES PI,-3.1776723,-41.8707444,16,703
PI,BURITI DOS MONTES,0,0,0,0.0,8,0,-8,-100.0,3,1,-2,-66.67,11,15,4,36.36,295,256,-39,-13.22,317,272,-45,-14.2,BURITI DOS MONTES PI,-5.3136171,-41.0971256,16,704
PI,CABECEIRAS DO PIAUI,1,1,0,0.0,27,37,10,37.04,8,0,-8,-100.0,56,62,6,10.71,418,215,-203,-48.56,510,315,-195,-38.24,CABECEIRAS DO PIAUI PI,-4.4733665,-42.3098716,16,705
PI,CAJAZEIRAS DO PIAUI,0,2,2,0.0,0,0,0,0.0,0,0,0,0.0,11,11,0,0.0,240,263,23,9.58,251,276,25,9.96,CAJAZEIRAS DO PIAUI PI,-6.794271,-42.3935024,16,706
PI,CAJUEIRO DA PRAIA,186,173,-13,-6.99,2,2,0,0.0,16,51,35,218.75,43,57,14,32.56,643,554,-89,-13.84,890,837,-53,-5.96,CAJUEIRO DA PRAIA PI,-2.9289603,-41.3381617,16,707
PI,CALDEIRAO GRANDE DO PIAUI,0,0,0,0.0,0,13,13,0.0,3,2,-1,-33.33,11,7,-4,-36.36,185,150,-35,-18.92,199,172,-27,-13.57,CALDEIRAO GRANDE DO PIAUI PI,-7.3310393,-40.6374433,16,708
PI,CAMPINAS DO PIAUI,0,0,0,0.0,1,1,0,0.0,0,0,0,0.0,15,16,1,6.67,237,13,-224,-94.51,253,30,-223,-88.14,CAMPINAS DO PIAUI PI,-7.6593687,-41.8814875,16,709
PI,CAMPO ALEGRE DO FIDALGO,0,0,0,0.0,8,10,2,25.0,0,0,0,0.0,25,29,4,16.0,241,239,-2,-0.83,274,278,4,1.46,CAMPO ALEGRE DO FIDALGO PI,-8.3753852,-41.8364191,16,710
PI,CAMPO GRANDE DO PIAUI,0,0,0,0.0,4,0,-4,-100.0,0,0,0,0.0,21,22,1,4.76,281,255,-26,-9.25,306,277,-29,-9.48,CAMPO GRANDE DO PIAUI PI,-7.1327559,-41.0381164,16,711
PI,CAMPO LARGO DO PIAUI,0,1,1,0.0,0,0,0,0.0,0,0,0,0.0,6,9,3,50.0,286,249,-37,-12.94,292,259,-33,-11.3,CAMPO LARGO DO PIAUI PI,-3.8104731,-42.6288333,16,712
PI,CAMPO MAIOR,48,37,-11,-22.92,730,567,-163,-22.33,40,97,57,142.5,1486,1436,-50,-3.36,1940,1535,-405,-20.88,4244,3672,-572,-13.48,CAMPO MAIOR PI,-4.8339574,-42.1739786,16,713
PI,CANAVIEIRA,7,14,7,100.0,2,2,0,0.0,0,0,0,0.0,8,11,3,37.5,231,189,-42,-18.18,248,216,-32,-12.9,CANAVIEIRA PI,-7.6924041,-43.7190063,16,714
PI,CANTO DO BURITI,197,238,41,20.81,62,70,8,12.9,0,33,33,0.0,294,287,-7,-2.38,1076,920,-156,-14.5,1629,1548,-81,-4.97,CANTO DO BURITI PI,-8.1104735,-42.94784392019382,16,715
PI,CAPITAO DE CAMPOS,1,0,-1,-100.0,5,11,6,120.0,0,0,0,0.0,93,92,-1,-1.08,517,412,-105,-20.31,616,515,-101,-16.4,CAPITAO DE CAMPOS PI,-4.4584198,-41.9415301,16,716
PI,CAPITAO GERVASIO OLIVEIRA,0,0,0,0.0,17,19,2,11.76,0,0,0,0.0,29,27,-2,-6.9,162,156,-6,-3.7,208,202,-6,-2.88,CAPITAO GERVASIO OLIVEIRA PI,-8.4954657,-41.8169342,16,717
PI,CARACOL,0,0,0,0.0,6,6,0,0.0,0,1,1,0.0,88,92,4,4.55,405,285,-120,-29.63,499,384,-115,-23.05,CARACOL PI,-9.2804898,-43.3284924,16,718
PI,CARAUBAS DO PIAUI,0,1,1,0.0,0,0,0,0.0,0,0,0,0.0,14,15,1,7.14,285,196,-89,-31.23,299,212,-87,-29.1,CARAUBAS DO PIAUI PI,-3.4760094,-41.8412188,16,719
PI,CARIDADE DO PIAUI,0,0,0,0.0,145,0,-145,-100.0,0,0,0,0.0,6,9,3,50.0,325,340,15,4.62,476,349,-127,-26.68,CARIDADE DO PIAUI PI,-7.7331063,-40.9883665,16,720
PI,CASTELO DO PIAUI,15,11,-4,-26.67,107,139,32,29.91,6,3,-3,-50.0,252,212,-40,-15.87,686,698,12,1.75,1066,1063,-3,-0.28,CASTELO DO PIAUI PI,-5.3230426,-41.5546185,16,721
PI,CAXINGO,0,0,0,0.0,10,6,-4,-40.0,0,0,0,0.0,13,18,5,38.46,365,241,-124,-33.97,388,265,-123,-31.7,CAXINGO PI,-3.4208396,-41.8925637,16,722
PI,COCAL,0,0,0,0.0,17,18,1,5.88,1,5,4,400.0,182,191,9,4.95,970,923,-47,-4.85,1170,1137,-33,-2.82,COCAL PI,-3.4691882,-41.555851,16,723
PI,COCAL DE TELHA,19,19,0,0.0,2,3,1,50.0,0,0,0,0.0,43,37,-6,-13.95,231,219,-12,-5.19,295,278,-17,-5.76,COCAL DE TELHA PI,-4.5553648,-41.9722429,16,724
PI,COCAL DOS ALVES,0,0,0,0.0,0,0,0,0.0,0,0,0,0.0,7,6,-1,-14.29,301,266,-35,-11.63,308,272,-36,-11.69,COCAL DOS ALVES PI,-3.59964,-41.444741,16,725
PI,COIVARAS,0,0,0,0.0,0,0,0,0.0,0,0,0,0.0,22,22,0,0.0,231,169,-62,-26.84,253,191,-62,-24.51,COIVARAS PI,-5.0927005,-42.2052489,16,726
PI,COLONIA DO GURGUEIA,2,2,0,0.0,3,0,-3,-100.0,0,0,0,0.0,75,78,3,4.0,226,232,6,2.65,306,312,6,1.96,COLONIA DO GURGUEIA PI,-8.183697,-43.793999,16,727
PI,COLONIA DO PIAUI,0,0,0,0.0,0,0,0,0.0,2,2,0,0.0,35,41,6,17.14,332,287,-45,-13.55,369,330,-39,-10.57,COLONIA DO PIAUI PI,-7.2320268,-42.1777122,16,728
PI,CONCEICAO DO CANINDE,1,1,0,0.0,2,2,0,0.0,0,0,0,0.0,19,22,3,15.79,210,132,-78,-37.14,232,157,-75,-32.33,CONCEICAO DO CANINDE PI,-7.8774025,-41.5961417,16,729
PI,CORONEL JOSE DIAS,0,0,0,0.0,56,53,-3,-5.36,0,0,0,0.0,13,11,-2,-15.38,246,198,-48,-19.51,315,262,-53,-16.83,CORONEL JOSE DIAS PI,-8.8252316,-42.4782948,16,730
PI,CORRENTE,90,79,-11,-12.22,85,100,15,17.65,7,4,-3,-42.86,760,845,85,11.18,1395,3207,1812,129.89,2337,4235,1898,81.22,CORRENTE PI,-10.4401356,-45.1627472,16,731
PI,CRISTALANDIA DO PIAUI,8,6,-2,-25.0,2,3,1,50.0,5,0,-5,-100.0,30,37,7,23.33,330,304,-26,-7.88,375,350,-25,-6.67,CRISTALANDIA DO PIAUI PI,-10.6525894,-45.1847405,16,732
PI,CRISTINO CASTRO,5,4,-1,-20.0,15,11,-4,-26.67,0,0,0,0.0,186,194,8,4.3,454,445,-9,-1.98,660,654,-6,-0.91,CRISTINO CASTRO PI,-8.8163934,-44.2211062,16,733
PI,CURIMATA,11,12,1,9.09,5,5,0,0.0,0,0,0,0.0,106,118,12,11.32,584,610,26,4.45,706,745,39,5.52,CURIMATA PI,-10.0349005,-44.3033114,16,734
PI,CURRAIS,288,250,-38,-13.19,12,5,-7,-58.33,0,0,0,0.0,13,12,-1,-7.69,225,229,4,1.78,538,496,-42,-7.81,CURRAIS PI,-9.0146796,-44.3999284,16,735
PI,CURRALINHOS,0,1,1,0.0,0,0,0,0.0,0,0,0,0.0,11,10,-1,-9.09,148,119,-29,-19.59,159,130,-29,-18.24,CURRALINHOS PI,-5.6190404,-42.8280018,16,736
PI,CURRAL NOVO DO PIAUI,0,0,0,0.0,0,0,0,0.0,1,3,2,200.0,2,2,0,0.0,353,378,25,7.08,356,383,27,7.58,CURRAL NOVO DO PIAUI PI,-7.8316503,-40.9006904,16,737
PI,DEMERVAL LOBAO,10,18,8,80.0,197,243,46,23.35,28,14,-14,-50.0,193,186,-7,-3.63,693,402,-291,-41.99,1121,863,-258,-23.02,DEMERVAL LOBAO PI,-5.3640643,-42.673993,16,738
PI,DIRCEU ARCOVERDE,0,1,1,0.0,0,1,1,0.0,0,0,0,0.0,38,47,9,23.68,298,288,-10,-3.36,336,337,1,0.3,DIRCEU ARCOVERDE PI,-9.3413101,-42.4362055,16,739
PI,DOM EXPEDITO LOPES,0,0,0,0.0,28,31,3,10.71,0,0,0,0.0,97,90,-7,-7.22,229,196,-33,-14.41,354,317,-37,-10.45,DOM EXPEDITO LOPES PI,-6.9644926,-41.648155,16,740
PI,DOMINGOS MOURAO,0,0,0,0.0,1,1,0,0.0,0,0,0,0.0,4,6,2,50.0,171,147,-24,-14.04,176,154,-22,-12.5,DOMINGOS MOURAO PI,-4.2544732,-41.2722903,16,741
PI,DOM INOCENCIO,0,0,0,0.0,9,9,0,0.0,0,145,145,0.0,25,31,6,24.0,237,249,12,5.06,271,434,163,60.15,DOM INOCENCIO PI,-9.0009167,-41.974038,16,742
PI,ELESBAO VELOSO,145,149,4,2.76,16,13,-3,-18.75,4,3,-1,-25.0,199,201,2,1.01,665,689,24,3.61,1029,1055,26,2.53,ELESBAO VELOSO PI,-6.2032654,-42.1376937,16,743
PI,ELISEU MARTINS,3,6,3,100.0,4,4,0,0.0,17,2,-15,-88.24,51,42,-9,-17.65,234,225,-9,-3.85,309,279,-30,-9.71,ELISEU MARTINS PI,-8.0984137,-43.6637067,16,744
PI,ESPERANTINA,15,14,-1,-6.67,4,5,1,25.0,0,0,0,0.0,36,23,-13,-36.11,440,431,-9,-2.05,495,473,-22,-4.44,ESPERANTINA PI,-3.8950963,-42.2370595,16,745
PI,FARTURA DO PIAUI,0,0,0,0.0,0,0,0,0.0,0,0,0,0.0,15,12,-3,-20.0,257,252,-5,-1.95,272,264,-8,-2.94,FARTURA DO PIAUI PI,-9.4839171,-42.7906894,16,746
PI,FLORES DO PIAUI,0,0,0,0.0,2,2,0,0.0,7,3,-4,-57.14,15,19,4,26.67,384,268,-116,-30.21,408,292,-116,-28.43,FLORES DO PIAUI PI,-7.7917152,-42.9236162,16,747
PI,FLORESTA DO PIAUI,1,0,-1,-100.0,0,0,0,0.0,0,0,0,0.0,12,10,-2,-16.67,174,153,-21,-12.07,187,163,-24,-12.83,FLORESTA DO PIAUI PI,-7.4679466,-41.800522,16,748
PI,FLORIANO,73,94,21,28.77,1013,801,-212,-20.93,144,90,-54,-37.5,3903,4126,223,5.71,4992,4355,-637,-12.76,10125,9466,-659,-6.51,FLORIANO PI,-6.7726534,-43.0070616,16,749
PI,FRANCINOPOLIS,4,3,-1,-25.0,2,2,0,0.0,0,21,21,0.0,25,18,-7,-28.0,170,114,-56,-32.94,201,158,-43,-21.39,FRANCINOPOLIS PI,-6.3962771,-42.2635654,16,750
PI,FRANCISCO AYRES,2,1,-1,-50.0,3,3,0,0.0,0,0,0,0.0,7,8,1,14.29,244,193,-51,-20.9,256,205,-51,-19.92,FRANCISCO AYRES PI,-6.6217571,-42.6941944,16,751
PI,FRANCISCO MACEDO,0,0,0,0.0,0,0,0,0.0,0,0,0,0.0,2,4,2,100.0,178,135,-43,-24.16,180,139,-41,-22.78,FRANCISCO MACEDO PI,-7.3276798,-40.7914329,16,752
PI,FRANCISCO SANTOS,0,0,0,0.0,1,1,0,0.0,0,0,0,0.0,33,30,-3,-9.09,336,346,10,2.98,370,377,7,1.89,FRANCISCO SANTOS PI,-6.9944754,-41.1345548,16,753
PI,FRONTEIRAS,0,1,1,0.0,62,84,22,35.48,8,11,3,37.5,51,50,-1,-1.96,432,439,7,1.62,553,585,32,5.79,FRONTEIRAS PI,-7.088607,-40.6147253,16,754
PI,GILBUES,116,110,-6,-5.17,5,26,21,420.0,6,17,11,183.33,159,180,21,13.21,512,533,21,4.1,798,866,68,8.52,GILBUES PI,-9.8295491,-45.3389933,16,756
PI,GUADALUPE,192,169,-23,-11.98,46,47,1,2.17,0,0,0,0.0,140,126,-14,-10.0,561,484,-77,-13.73,939,826,-113,-12.03,GUADALUPE PI,-6.7879775,-43.5708162,16,757
PI,GUARIBAS,0,0,0,0.0,0,0,0,0.0,0,0,0,0.0,5,6,1,20.0,236,233,-3,-1.27,241,239,-2,-0.83,GUARIBAS PI,-9.3957375,-43.6877965,16,758
PI,HUGO NAPOLEAO,1,2,1,100.0,6,8,2,33.33,0,0,0,0.0,11,14,3,27.27,190,178,-12,-6.32,208,202,-6,-2.88,HUGO NAPOLEAO PI,-5.989919,-42.5593218,16,759
PI,ILHA GRANDE,10,8,-2,-20.0,59,62,3,5.08,0,0,0,0.0,23,27,4,17.39,356,285,-71,-19.94,448,382,-66,-14.73,ILHA GRANDE PI,-2.8520082,-41.8166904,16,760
PI,INHUMA,5,3,-2,-40.0,34,32,-2,-5.88,0,4,4,0.0,130,136,6,4.62,536,514,-22,-4.1,705,689,-16,-2.27,INHUMA PI,-6.6694502,-41.7096008,16,761
PI,IPIRANGA DO PIAUI,0,0,0,0.0,35,32,-3,-8.57,0,0,0,0.0,49,46,-3,-6.12,288,280,-8,-2.78,372,358,-14,-3.76,IPIRANGA DO PIAUI PI,-6.8240832,-41.7377279,16,762
PI,ISAIAS COELHO,0,1,1,0.0,7,1,-6,-85.71,0,0,0,0.0,41,37,-4,-9.76,275,256,-19,-6.91,323,295,-28,-8.67,ISAIAS COELHO PI,-7.7359201,-41.6765311,16,763
PI,ITAINOPOLIS,2,1,-1,-50.0,8,7,-1,-12.5,0,0,0,0.0,60,47,-13,-21.67,342,298,-44,-12.87,412,353,-59,-14.32,ITAINOPOLIS PI,-7.4483425,-41.4796645,16,764
PI,ITAUEIRA,18,21,3,16.67,0,0,0,0.0,0,0,0,0.0,107,96,-11,-10.28,358,36,-322,-89.94,483,153,-330,-68.32,ITAUEIRA PI,-7.5991089,-43.0278778,16,765
PI,JACOBINA DO PIAUI,0,0,0,0.0,47,43,-4,-8.51,1,0,-1,-100.0,18,17,-1,-5.56,241,244,3,1.24,307,304,-3,-0.98,JACOBINA DO PIAUI PI,-7.9356495,-41.2106817,16,766
PI,JAICOS,0,0,0,0.0,13,20,7,53.85,0,9,9,0.0,173,163,-10,-5.78,514,540,26,5.06,700,732,32,4.57,JAICOS PI,-7.3584791,-41.1446059,16,767
PI,JARDIM DO MULATO,1,0,-1,-100.0,2,2,0,0.0,0,0,0,0.0,9,14,5,55.56,163,215,52,31.9,175,231,56,32.0,JARDIM DO MULATO PI,-6.0953808,-42.636034,16,768
PI,JATOBA DO PIAUI,0,0,0,0.0,46,44,-2,-4.35,0,0,0,0.0,5,3,-2,-40.0,187,178,-9,-4.81,238,225,-13,-5.46,JATOBA DO PIAUI PI,-4.7700202,-41.8181631,16,769
PI,JERUMENHA,63,51,-12,-19.05,67,60,-7,-10.45,0,0,0,0.0,30,32,2,6.67,273,262,-11,-4.03,433,405,-28,-6.47,JERUMENHA PI,-7.0880338,-43.5078454,16,770
PI,JOAO COSTA,0,0,0,0.0,0,0,0,0.0,1,0,-1,-100.0,9,12,3,33.33,233,166,-67,-28.76,243,178,-65,-26.75,JOAO COSTA PI,-8.4887363,-42.4174704,16,771
PI,JOAQUIM PIRES,6,0,-6,-100.0,27,30,3,11.11,0,2,2,0.0,90,87,-3,-3.33,547,503,-44,-8.04,670,622,-48,-7.16,JOAQUIM PIRES PI,-3.5083129,-42.1925425,16,772
PI,JOCA MARQUES,0,0,0,0.0,0,0,0,0.0,0,0,0,0.0,7,4,-3,-42.86,167,162,-5,-2.99,174,166,-8,-4.6,JOCA MARQUES PI,-3.4986388,-42.4317729,16,773
PI,JOSE DE FREITAS,48,23,-25,-52.08,74,108,34,45.95,33,49,16,48.48,511,530,19,3.72,1651,1296,-355,-21.5,2317,2006,-311,-13.42,JOSE DE FREITAS PI,-4.7578357,-42.5763777,16,774
PI,JUAZEIRO DO PIAUI,1,1,0,0.0,43,44,1,2.33,14,58,44,314.29,22,23,1,4.55,272,276,4,1.47,352,402,50,14.2,JUAZEIRO DO PIAUI PI,-5.1709582,-41.7070148,16,775
PI,JULIO BORGES,0,0,0,0.0,23,36,13,56.52,4,1,-3,-75.0,15,15,0,0.0,360,355,-5,-1.39,402,407,5,1.24,JULIO BORGES PI,-10.3273669,-44.2397326,16,776
PI,JUREMA,0,0,0,0.0,0,0,0,0.0,20,0,-20,-100.0,13,8,-5,-38.46,240,107,-133,-55.42,273,115,-158,-57.88,JUREMA PI,-5.4435001,-42.1470309,16,777
PI,LAGOINHA DO PIAUI,1,0,-1,-100.0,0,1,1,0.0,0,0,0,0.0,15,16,1,6.67,218,90,-128,-58.72,234,107,-127,-54.27,LAGOINHA DO PIAUI PI,-5.8324033,-42.6236706,16,778
PI,LAGOA ALEGRE,5,7,2,40.0,1,0,-1,-100.0,0,0,0,0.0,57,61,4,7.02,439,366,-73,-16.63,502,434,-68,-13.55,LAGOA ALEGRE PI,-4.5134956,-42.6234811,16,779
PI,LAGOA DO BARRO DO PIAUI,0,0,0,0.0,454,480,26,5.73,0,1,1,0.0,17,21,4,23.53,442,390,-52,-11.76,913,892,-21,-2.3,LAGOA DO BARRO DO PIAUI PI,-8.4798938,-41.5295775,16,780
PI,LAGOA DE SAO FRANCISCO,0,0,0,0.0,0,0,0,0.0,1,1,0,0.0,29,24,-5,-17.24,339,325,-14,-4.13,369,350,-19,-5.15,LAGOA DE SAO FRANCISCO PI,-4.3928921,-41.5988828,16,781
PI,LAGOA DO PIAUI,8,36,28,350.0,70,149,79,112.86,0,0,0,0.0,32,44,12,37.5,166,169,3,1.81,276,398,122,44.2,LAGOA DO PIAUI PI,-5.4116544,-42.6450588,16,782
PI,LAGOA DO SITIO,1,0,-1,-100.0,0,0,0,0.0,0,0,0,0.0,18,16,-2,-11.11,200,189,-11,-5.5,219,205,-14,-6.39,LAGOA DO SITIO PI,-6.5169858,-41.5722134,16,783
PI,LANDRI SALES,8,45,37,462.5,3,3,0,0.0,2,7,5,250.0,26,23,-3,-11.54,279,283,4,1.43,318,361,43,13.52,LANDRI SALES PI,-7.2609081,-43.9311019,16,784
PI,LUIS CORREIA,119,89,-30,-25.21,22,29,7,31.82,47,18,-29,-61.7,428,447,19,4.44,1613,1269,-344,-21.33,2229,1852,-377,-16.91,LUIS CORREIA PI,-2.8818164,-41.6658458,16,785
PI,LUZILANDIA,0,0,0,0.0,69,66,-3,-4.35,3,3,0,0.0,233,203,-30,-12.88,925,899,-26,-2.81,1230,1171,-59,-4.8,LUZILANDIA PI,-3.4648887,-42.3689528,16,786
PI,MADEIRO,0,0,0,0.0,0,0,0,0.0,0,0,0,0.0,9,18,9,100.0,307,303,-4,-1.3,316,321,5,1.58,MADEIRO PI,-3.4834038,-42.4994625,16,787
PI,MANOEL EMIDIO,19,17,-2,-10.53,5,4,-1,-20.0,0,0,0,0.0,37,37,0,0.0,340,143,-197,-57.94,401,201,-200,-49.88,MANOEL EMIDIO PI,-8.0054022,-43.8730321,16,788
PI,MARCOS PARENTE,20,23,3,15.0,1,2,1,100.0,2,2,0,0.0,54,46,-8,-14.81,231,227,-4,-1.73,308,300,-8,-2.6,MARCOS PARENTE PI,-7.1216428,-43.8892251,16,790
PI,MASSAPE DO PIAUI,1,7,6,600.0,0,0,0,0.0,4,2,-2,-50.0,5,6,1,20.0,265,247,-18,-6.79,275,262,-13,-4.73,MASSAPE DO PIAUI PI,-7.4628039,-41.1260827,16,791
PI,MATIAS OLIMPIO,0,0,0,0.0,12,10,-2,-16.67,4,4,0,0.0,83,87,4,4.82,448,426,-22,-4.91,547,527,-20,-3.66,MATIAS OLIMPIO PI,-3.7150636,-42.5547925,16,792
PI,MIGUEL ALVES,51,37,-14,-27.45,57,58,1,1.75,0,5,5,0.0,192,219,27,14.06,1009,808,-201,-19.92,1309,1127,-182,-13.9,MIGUEL ALVES PI,-4.1730384,-42.8955677,16,793
PI,MIGUEL LEAO,19,14,-5,-26.32,25,26,1,4.0,0,0,0,0.0,10,9,-1,-10.0,111,83,-28,-25.23,165,132,-33,-20.0,MIGUEL LEAO PI,-5.681461,-42.7371703,16,794
PI,MILTON BRANDAO,0,0,0,0.0,0,0,0,0.0,0,0,0,0.0,9,8,-1,-11.11,350,231,-119,-34.0,359,239,-120,-33.43,MILTON BRANDAO PI,-4.7023518,-41.4473767,16,795
PI,MONSENHOR GIL,104,91,-13,-12.5,47,50,3,6.38,6,2,-4,-66.67,112,122,10,8.93,410,432,22,5.37,679,697,18,2.65,MONSENHOR GIL PI,-5.5609098,-42.6127716,16,796
PI,MONSENHOR HIPOLITO,0,0,0,0.0,3,3,0,0.0,0,0,0,0.0,15,16,1,6.67,198,14,-184,-92.93,216,33,-183,-84.72,MONSENHOR HIPOLITO PI,-6.9972682,-41.029733,16,797
PI,MONTE ALEGRE DO PIAUI,257,322,65,25.29,28,12,-16,-57.14,0,0,0,0.0,104,101,-3,-2.88,518,579,61,11.78,907,1014,107,11.8,MONTE ALEGRE DO PIAUI PI,-9.7483373,-45.3048117,16,798
PI,MORRO CABECA NO TEMPO,0,0,0,0.0,12,1,-11,-91.67,0,0,0,0.0,1,3,2,200.0,249,217,-32,-12.85,262,221,-41,-15.65,MORRO CABECA NO TEMPO PI,-9.7236848,-43.9037699,16,799
PI,MORRO DO CHAPEU DO PIAUI,0,0,0,0.0,0,0,0,0.0,14,14,0,0.0,18,17,-1,-5.56,334,347,13,3.89,366,378,12,3.28,MORRO DO CHAPEU DO PIAUI PI,-3.7415834,-42.3117139,16,800
PI,MURICI DOS PORTELAS,3,3,0,0.0,0,0,0,0.0,0,0,0,0.0,27,26,-1,-3.7,418,378,-40,-9.57,448,407,-41,-9.15,MURICI DOS PORTELAS PI,-3.3222798,-42.0904339,16,801
PI,NAZARE DO PIAUI,0,0,0,0.0,28,23,-5,-17.86,56,51,-5,-8.93,34,31,-3,-8.82,337,265,-72,-21.36,455,370,-85,-18.68,NAZARE DO PIAUI PI,-6.9709737,-42.6707675,16,802
PI,NAZARIA,17,24,7,41.18,294,347,53,18.03,0,0,0,0.0,45,51,6,13.33,919,775,-144,-15.67,1275,1197,-78,-6.12,NAZARIA PI,-5.3512851,-42.8152823,16,803
PI,NOSSA SENHORA DE NAZARE,8,0,-8,-100.0,0,0,0,0.0,0,0,0,0.0,8,5,-3,-37.5,250,229,-21,-8.4,266,234,-32,-12.03,NOSSA SENHORA DE NAZARE PI,-4.6333634,-42.1716341,16,804
PI,NOSSA SENHORA DOS REMEDIOS,0,0,0,0.0,1,1,0,0.0,0,0,0,0.0,27,29,2,7.41,164,155,-9,-5.49,192,185,-7,-3.65,NOSSA SENHORA DOS REMEDIOS PI,-3.9792637,-42.6216791,16,805
PI,NOVO ORIENTE DO PIAUI,1,1,0,0.0,1,1,0,0.0,0,0,0,0.0,29,25,-4,-13.79,300,273,-27,-9.0,331,300,-31,-9.37,NOVO ORIENTE DO PIAUI PI,-6.4504258,-41.9219571,16,806
PI,NOVO SANTO ANTONIO,0,0,0,0.0,0,0,0,0.0,0,0,0,0.0,17,16,-1,-5.88,132,131,-1,-0.76,149,147,-2,-1.34,NOVO SANTO ANTONIO PI,-5.2870106,-41.9359942,16,807
PI,OEIRAS,15,14,-1,-6.67,115,148,33,28.7,192,205,13,6.77,1161,1234,73,6.29,1557,1390,-167,-10.73,3040,2991,-49,-1.61,OEIRAS PI,-7.0174887,-42.1314478,16,808
PI,PADRE MARCOS,0,0,0,0.0,1,2,1,100.0,8,4,-4,-50.0,75,69,-6,-8.0,324,343,19,5.86,408,418,10,2.45,PADRE MARCOS PI,-7.3534527,-40.9063953,16,810
PI,PAES LANDIM,0,0,0,0.0,18,20,2,11.11,0,0,0,0.0,22,24,2,9.09,151,115,-36,-23.84,191,159,-32,-16.75,PAES LANDIM PI,-7.7781616,-42.2552274,16,811
PI,PAJEU DO PIAUI,0,0,0,0.0,0,0,0,0.0,0,0,0,0.0,8,12,4,50.0,202,118,-84,-41.58,210,130,-80,-38.1,PAJEU DO PIAUI PI,-7.855242,-42.8220764,16,812
PI,PALMEIRA DO PIAUI,65,71,6,9.23,1,2,1,100.0,0,0,0,0.0,16,29,13,81.25,127,125,-2,-1.57,209,227,18,8.61,PALMEIRA DO PIAUI PI,-8.7252097,-44.2355232,16,813
PI,PALMEIRAIS,19,17,-2,-10.53,12,13,1,8.33,0,0,0,0.0,67,69,2,2.99,506,393,-113,-22.33,604,492,-112,-18.54,PALMEIRAIS PI,-5.9761427,-43.0637158,16,814
PI,PAQUETA,0,1,1,0.0,5,2,-3,-60.0,0,0,0,0.0,1,1,0,0.0,205,143,-62,-30.24,211,147,-64,-30.33,PAQUETA PI,-7.1041208,-41.7030366,16,815
PI,PARNAGUA,99,107,8,8.08,4,5,1,25.0,0,0,0,0.0,46,60,14,30.43,400,338,-62,-15.5,549,510,-39,-7.1,PARNAGUA PI,-10.2240273,-44.6374373,16,816
PI,PARNAIBA,462,431,-31,-6.71,1975,1878,-97,-4.91,864,694,-170,-19.68,7518,7580,62,0.82,10933,9546,-1387,-12.69,21752,20129,-1623,-7.46,PARNAIBA PI,-2.9147515,-41.7661953,16,817
PI,PASSAGEM FRANCA DO PIAUI,0,0,0,0.0,2,1,-1,-50.0,7,0,-7,-100.0,10,14,4,40.0,194,158,-36,-18.56,213,173,-40,-18.78,PASSAGEM FRANCA DO PIAUI PI,-5.8574824,-42.4402452,16,818
PI,PATOS DO PIAUI,0,0,0,0.0,0,0,0,0.0,0,0,0,0.0,11,12,1,9.09,259,257,-2,-0.77,270,269,-1,-0.37,PATOS DO PIAUI PI,-7.6799549,-41.245425,16,819
PI,PAULISTANA,1,1,0,0.0,17,30,13,76.47,14,18,4,28.57,286,294,8,2.8,976,885,-91,-9.32,1294,1228,-66,-5.1,PAULISTANA PI,-8.1389174,-41.1380533,16,821
PI,PAVUSSU,29,13,-16,-55.17,0,0,0,0.0,0,0,0,0.0,25,29,4,16.0,181,192,11,6.08,235,234,-1,-0.43,PAVUSSU PI,-7.9646111,-43.2232032,16,822
PI,PEDRO LAURENTINO,0,0,0,0.0,0,0,0,0.0,0,0,0,0.0,6,7,1,16.67,202,197,-5,-2.48,208,204,-4,-1.92,PEDRO LAURENTINO PI,-8.0660549,-42.2874621,16,824
PI,NOVA SANTA RITA,0,0,0,0.0,3,1,-2,-66.67,1,1,0,0.0,8,7,-1,-12.5,177,173,-4,-2.26,189,182,-7,-3.7,NOVA SANTA RITA PI,-8.0739703,-42.0504725,16,825
PI,PICOS,26,49,23,88.46,1200,1193,-7,-0.58,610,554,-56,-9.18,5345,5255,-90,-1.68,7227,6018,-1209,-16.73,14408,13069,-1339,-9.29,PICOS PI,-7.083621,-41.4704187,16,826
PI,PIMENTEIRAS,1,1,0,0.0,8,2,-6,-75.0,1,1,0,0.0,78,68,-10,-12.82,396,251,-145,-36.62,484,323,-161,-33.26,PIMENTEIRAS PI,-6.2366098,-41.4192948,16,827
PI,PIRACURUCA,72,65,-7,-9.72,177,139,-38,-21.47,101,122,21,20.79,444,411,-33,-7.43,1110,932,-178,-16.04,1904,1669,-235,-12.34,PIRACURUCA PI,-3.9304804,-41.7150099,16,829
PI,PIRIPIRI,12,13,1,8.33,585,574,-11,-1.88,53,884,831,1567.92,1650,1695,45,2.73,3465,3115,-350,-10.1,5765,6281,516,8.95,PIRIPIRI PI,-4.2732339,-41.7785173,16,830
PI,PORTO,5,0,-5,-100.0,3,3,0,0.0,1,3,2,200.0,77,74,-3,-3.9,456,465,9,1.97,542,545,3,0.55,PORTO PI,-3.8929066,-42.7078344,16,831
PI,PORTO ALEGRE DO PIAUI,3,0,-3,-100.0,0,0,0,0.0,0,0,0,0.0,5,5,0,0.0,149,134,-15,-10.07,157,139,-18,-11.46,PORTO ALEGRE DO PIAUI PI,-6.9717253,-44.1965104,16,832
PI,PRATA DO PIAUI,1,1,0,0.0,1,1,0,0.0,0,0,0,0.0,21,18,-3,-14.29,136,82,-54,-39.71,159,102,-57,-35.85,PRATA DO PIAUI PI,-5.6692702,-42.2067899,16,833
PI,QUEIMADA NOVA,0,0,0,0.0,3,10,7,233.33,0,106,106,0.0,97,105,8,8.25,323,292,-31,-9.6,423,513,90,21.28,QUEIMADA NOVA PI,-8.5805141,-41.4173529,16,834
PI,REDENCAO DO GURGUEIA,11,11,0,0.0,0,0,0,0.0,0,0,0,0.0,62,53,-9,-14.52,397,326,-71,-17.88,470,390,-80,-17.02,REDENCAO DO GURGUEIA PI,-9.4862001,-44.5840178,16,835
PI,REGENERACAO,127,175,48,37.8,143,133,-10,-6.99,0,4,4,0.0,198,216,18,9.09,804,662,-142,-17.66,1272,1190,-82,-6.45,REGENERACAO PI,-6.231855,-42.6860897,16,836
PI,RIACHO FRIO,59,28,-31,-52.54,0,0,0,0.0,0,0,0,0.0,3,5,2,66.67,239,233,-6,-2.51,301,266,-35,-11.63,RIACHO FRIO PI,-10.1298278,-44.9527078,16,837
PI,RIBEIRA DO PIAUI,0,0,0,0.0,13,19,6,46.15,0,0,0,0.0,4,6,2,50.0,245,249,4,1.63,262,274,12,4.58,RIBEIRA DO PIAUI PI,-7.6912987,-42.7130999,16,838
PI,RIBEIRO GONCALVES,322,284,-38,-11.8,9,11,2,22.22,0,15,15,0.0,27,24,-3,-11.11,147,147,0,0.0,505,481,-24,-4.75,RIBEIRO GONCALVES PI,-7.5603126,-45.2417148,16,839
PI,RIO GRANDE DO PIAUI,0,0,0,0.0,3,4,1,33.33,0,0,0,0.0,43,45,2,4.65,286,218,-68,-23.78,332,267,-65,-19.58,RIO GRANDE DO PIAUI PI,-7.7767595,-43.140007,16,840
PI,SANTA CRUZ DO PIAUI,1,0,-1,-100.0,4,6,2,50.0,0,0,0,0.0,45,50,5,11.11,374,279,-95,-25.4,424,335,-89,-20.99,SANTA CRUZ DO PIAUI PI,-7.1827307,-41.7657024,16,841
PI,SANTA CRUZ DOS MILAGRES,1,2,1,100.0,0,2,2,0.0,0,0,0,0.0,22,20,-2,-9.09,226,203,-23,-10.18,249,227,-22,-8.84,SANTA CRUZ DOS MILAGRES PI,-5.8019654,-41.9590554,16,842
PI,SANTA LUZ,28,21,-7,-25.0,84,84,0,0.0,0,0,0,0.0,28,29,1,3.57,248,238,-10,-4.03,388,372,-16,-4.12,SANTA LUZ PI,-4.6947404,-41.9074345,16,844
PI,SANTANA DO PIAUI,0,0,0,0.0,0,0,0,0.0,0,0,0,0.0,14,15,1,7.14,184,180,-4,-2.17,198,195,-3,-1.52,SANTANA DO PIAUI PI,-6.9458076,-41.5190275,16,845
PI,SANTA ROSA DO PIAUI,13,1,-12,-92.31,8,2,-6,-75.0,8,5,-3,-37.5,35,35,0,0.0,187,139,-48,-25.67,251,182,-69,-27.49,SANTA ROSA DO PIAUI PI,-6.7983399,-42.2799407,16,846
PI,SANTO ANTONIO DE LISBOA,0,0,0,0.0,64,67,3,4.69,0,0,0,0.0,14,15,1,7.14,307,190,-117,-38.11,385,272,-113,-29.35,SANTO ANTONIO DE LISBOA PI,-6.9831426,-41.2283884,16,847
PI,SANTO INACIO DO PIAUI,0,4,4,0.0,8,8,0,0.0,0,0,0,0.0,9,8,-1,-11.11,250,171,-79,-31.6,267,191,-76,-28.46,SANTO INACIO DO PIAUI PI,-7.4224725,-41.9146001,16,849
PI,SAO BRAZ DO PIAUI,0,0,0,0.0,1,0,-1,-100.0,3,0,-3,-100.0,15,13,-2,-13.33,205,205,0,0.0,224,218,-6,-2.68,SAO BRAZ DO PIAUI PI,-9.065002,-42.9982797,16,850
PI,SAO FELIX DO PIAUI,0,0,0,0.0,2,2,0,0.0,0,2,2,0.0,14,13,-1,-7.14,229,150,-79,-34.5,245,167,-78,-31.84,SAO FELIX DO PIAUI PI,-5.9324414,-42.1119867,16,851
PI,SAO FRANCISCO DE ASSIS DO PIAUI,0,0,0,0.0,20,22,2,10.0,1,0,-1,-100.0,19,24,5,26.32,258,253,-5,-1.94,298,299,1,0.34,SAO FRANCISCO DE ASSIS DO PIAUI PI,-8.237476,-41.686332,16,852
PI,SAO FRANCISCO DO PIAUI,1,0,-1,-100.0,3,3,0,0.0,0,0,0,0.0,18,22,4,22.22,331,328,-3,-0.91,353,353,0,0.0,SAO FRANCISCO DO PIAUI PI,-7.2460489,-42.5414016,16,853
PI,SAO GONCALO DO GURGUEIA,21,19,-2,-9.52,407,61,-346,-85.01,0,0,0,0.0,7,10,3,42.86,178,194,16,8.99,613,284,-329,-53.67,SAO GONCALO DO GURGUEIA PI,-10.0303022,-45.3032826,16,854
PI,SAO GONCALO DO PIAUI,30,32,2,6.67,3,4,1,33.33,0,0,0,0.0,19,17,-2,-10.53,233,161,-72,-30.9,285,214,-71,-24.91,SAO GONCALO DO PIAUI PI,-5.9970067,-42.7041762,16,855
PI,SAO JOAO DA CANABRAVA,0,0,0,0.0,0,0,0,0.0,0,0,0,0.0,13,15,2,15.38,237,264,27,11.39,250,279,29,11.6,SAO JOAO DA CANABRAVA PI,-6.8175686,-41.3461715,16,856
PI,SAO JOAO DA FRONTEIRA,0,0,0,0.0,0,0,0,0.0,0,0,0,0.0,20,18,-2,-10.0,307,305,-2,-0.65,327,323,-4,-1.22,SAO JOAO DA FRONTEIRA PI,-3.9390215,-41.2592109,16,857
PI,SAO JOAO DA SERRA,3,4,1,33.33,2,2,0,0.0,0,0,0,0.0,21,32,11,52.38,284,238,-46,-16.2,310,276,-34,-10.97,SAO JOAO DA SERRA PI,-5.5163795,-41.8967078,16,858
PI,SAO JOAO DA VARJOTA,1,1,0,0.0,24,22,-2,-8.33,0,0,0,0.0,4,4,0,0.0,171,177,6,3.51,200,204,4,2.0,SAO JOAO DA VARJOTA PI,-6.9151806,-41.8643155,16,859
PI,SAO JOAO DO ARRAIAL,0,0,0,0.0,0,0,0,0.0,0,0,0,0.0,41,42,1,2.44,286,272,-14,-4.9,327,314,-13,-3.98,SAO JOAO DO ARRAIAL PI,-3.8126524,-42.4508146,16,860
PI,SAO JOAO DO PIAUI,5,5,0,0.0,229,135,-94,-41.05,800,1406,606,75.75,521,484,-37,-7.1,1174,768,-406,-34.58,2729,2798,69,2.53,SAO JOAO DO PIAUI PI,-8.3601426,-42.2487642,16,861
PI,SAO JOSE DO DIVINO,0,0,0,0.0,7,0,-7,-100.0,0,0,0,0.0,27,26,-1,-3.7,282,266,-16,-5.67,316,292,-24,-7.59,SAO JOSE DO DIVINO PI,-3.8108544,-41.8297546,16,862
PI,SAO JOSE DO PEIXE,0,0,0,0.0,1,3,2,200.0,0,0,0,0.0,22,23,1,4.55,254,284,30,11.81,277,310,33,11.91,SAO JOSE DO PEIXE PI,-7.4938166,-42.5661301,16,863
PI,SAO JOSE DO PIAUI,0,0,0,0.0,13,11,-2,-15.38,0,0,0,0.0,34,39,5,14.71,255,236,-19,-7.45,302,286,-16,-5.3,SAO JOSE DO PIAUI PI,-6.8725567,-41.4772864,16,864
PI,SAO JULIAO,0,0,0,0.0,2,2,0,0.0,0,0,0,0.0,28,29,1,3.57,275,203,-72,-26.18,305,234,-71,-23.28,SAO JULIAO PI,-7.0834413,-40.8362405,16,865
PI,SAO LOURENCO DO PIAUI,0,0,0,0.0,4,3,-1,-25.0,0,0,0,0.0,25,20,-5,-20.0,232,213,-19,-8.19,261,236,-25,-9.58,SAO LOURENCO DO PIAUI PI,-9.1680968,-42.545289,16,866
PI,SAO LUIS DO PIAUI,0,0,0,0.0,0,0,0,0.0,0,0,0,0.0,1,5,4,400.0,138,147,9,6.52,139,152,13,9.35,SAO LUIS DO PIAUI PI,-6.8256095,-41.322949,16,867
PI,SAO MIGUEL DA BAIXA GRANDE,4,4,0,0.0,0,0,0,0.0,0,0,0,0.0,15,9,-6,-40.0,178,241,63,35.39,197,254,57,28.93,SAO MIGUEL DA BAIXA GRANDE PI,-5.8648279,-42.1864332,16,868
PI,SAO MIGUEL DO FIDALGO,0,0,0,0.0,0,0,0,0.0,0,0,0,0.0,0,0,0,0.0,179,130,-49,-27.37,179,130,-49,-27.37,SAO MIGUEL DO FIDALGO PI,-7.5834113,-42.3709452,16,869
PI,SAO MIGUEL DO TAPUIO,0,10,10,0.0,3,2,-1,-33.33,38,22,-16,-42.11,90,108,18,20.0,499,525,26,5.21,630,667,37,5.87,SAO MIGUEL DO TAPUIO PI,-5.5015262,-41.3214276,16,870
PI,SAO PEDRO DO PIAUI,13,3,-10,-76.92,37,18,-19,-51.35,0,1,1,0.0,69,81,12,17.39,530,435,-95,-17.92,649,538,-111,-17.1,SAO PEDRO DO PIAUI PI,-5.923768,-42.7195114,16,871
PI,SAO RAIMUNDO NONATO,1,1,0,0.0,120,133,13,10.83,123,179,56,45.53,1253,1209,-44,-3.51,1753,1769,16,0.91,3250,3291,41,1.26,SAO RAIMUNDO NONATO PI,-9.0150522,-42.6886909,16,872
PI,SEBASTIAO BARROS,3,2,-1,-33.33,0,0,0,0.0,0,0,0,0.0,5,5,0,0.0,250,259,9,3.6,258,266,8,3.1,SEBASTIAO BARROS PI,-10.8149125,-44.8330743,16,873
PI,SEBASTIAO LEAL,427,433,6,1.41,10,12,2,20.0,5,3,-2,-40.0,15,22,7,46.67,256,333,77,30.08,713,803,90,12.62,SEBASTIAO LEAL PI,-7.5679515,-44.0648363,16,874
PI,SIGEFREDO PACHECO,0,0,0,0.0,1,0,-1,-100.0,0,2,2,0.0,32,31,-1,-3.12,352,247,-105,-29.83,385,280,-105,-27.27,SIGEFREDO PACHECO PI,-4.9148779,-41.7304149,16,875
PI,SIMOES,0,0,0,0.0,18,30,12,66.67,5,6,1,20.0,114,129,15,13.16,570,469,-101,-17.72,707,634,-73,-10.33,SIMOES PI,-7.5970469,-40.8176003,16,876
PI,SIMPLICIO MENDES,1,2,1,100.0,9,5,-4,-44.44,365,244,-121,-33.15,274,256,-18,-6.57,409,461,52,12.71,1058,968,-90,-8.51,SIMPLICIO MENDES PI,-7.860528,-41.9081183,16,877
PI,SOCORRO DO PIAUI,0,0,0,0.0,2,2,0,0.0,0,0,0,0.0,7,10,3,42.86,213,183,-30,-14.08,222,195,-27,-12.16,SOCORRO DO PIAUI PI,-7.8631876,-42.4994689,16,878
PI,SUSSUAPARA,1,8,7,700.0,62,66,4,6.45,0,0,0,0.0,47,51,4,8.51,340,334,-6,-1.76,450,459,9,2.0,SUSSUAPARA PI,-7.0110259,-41.3830041,16,879
PI,TAMBORIL DO PIAUI,0,0,0,0.0,0,0,0,0.0,0,0,0,0.0,9,10,1,11.11,204,146,-58,-28.43,213,156,-57,-26.76,TAMBORIL DO PIAUI PI,-8.4007816,-42.9112793,16,880
PI,TANQUE DO PIAUI,3,3,0,0.0,0,0,0,0.0,0,0,0,0.0,5,7,2,40.0,205,185,-20,-9.76,213,195,-18,-8.45,TANQUE DO PIAUI PI,-6.5971682,-42.2840316,16,881
PI,TERESINA,579,720,141,24.35,18478,16670,-1808,-9.78,15895,15176,-719,-4.52,50158,48693,-1465,-2.92,192144,182869,-9275,-4.83,277254,264128,-13126,-4.73,TERESINA PI,-5.0896403,-42.809588,16,882
PI,UNIAO,83,97,14,16.87,2400,2255,-145,-6.04,28,29,1,3.57,605,679,74,12.23,1580,1292,-288,-18.23,4696,4352,-344,-7.33,UNIAO PI,-4.5892553,-42.8593348,16,883
PI,URUCUI,1233,1225,-8,-0.65,250,267,17,6.8,162,178,16,9.88,863,847,-16,-1.85,1613,1587,-26,-1.61,4121,4104,-17,-0.41,URUCUI PI,-7.2363099,-44.555387,16,884
PI,VALENCA DO PIAUI,181,197,16,8.84,158,176,18,11.39,18,17,-1,-5.56,544,536,-8,-1.47,882,826,-56,-6.35,1783,1752,-31,-1.74,VALENCA DO PIAUI PI,-6.4048149,-41.7382812,16,885
PI,VARZEA BRANCA,0,0,0,0.0,0,0,0,0.0,0,0,0,0.0,14,15,1,7.14,181,158,-23,-12.71,195,173,-22,-11.28,VARZEA BRANCA PI,-9.2371884,-42.9643784,16,886
PI,VARZEA GRANDE,0,0,0,0.0,4,4,0,0.0,0,0,0,0.0,32,33,1,3.12,177,148,-29,-16.38,213,185,-28,-13.15,VARZEA GRANDE PI,-6.5460829,-42.2480401,16,887
PI,VERA MENDES,0,0,0,0.0,0,0,0,0.0,0,0,0,0.0,8,5,-3,-37.5,113,107,-6,-5.31,121,112,-9,-7.44,VERA MENDES PI,-7.6041627,-41.4827889,16,888
PI,VILA NOVA DO PIAUI,0,0,0,0.0,0,0,0,0.0,0,0,0,0.0,18,19,1,5.56,164,176,12,7.32,182,195,13,7.14,VILA NOVA DO PIAUI PI,-7.1429224,-40.9378562,16,889
PI,WALL FERRAZ,0,1,1,0.0,0,0,0,0.0,0,0,0,0.0,3,3,0,0.0,186,173,-13,-6.99,189,177,-12,-6.35,WALL FERRAZ PI,-7.2339199,-41.911407,16,890
CE,ABAIARA,1,0,-1,-100.0,1,10,9,900.0,1,0,-1,-100.0,44,34,-10,-22.73,700,704,4,0.57,747,748,1,0.13,ABAIARA CE,-7.3607808,-39.0487878,5,891
CE,ACARAU,254,230,-24,-9.45,527,427,-100,-18.98,8,25,17,212.5,589,658,69,11.71,2400,2857,457,19.04,3778,4197,419,11.09,ACARAU CE,-2.8869514,-40.1194713,5,893
CE,ACOPIARA,31,89,58,187.1,208,198,-10,-4.81,3,2,-1,-33.33,656,670,14,2.13,1843,1415,-428,-23.22,2741,2374,-367,-13.39,ACOPIARA CE,-6.0936464,-39.4543204,5,894
CE,AIUABA,0,0,0,0.0,8,6,-2,-25.0,0,1,1,0.0,30,32,2,6.67,892,1143,251,28.14,930,1182,252,27.1,AIUABA CE,-6.5710836,-40.1212278,5,895
CE,ALCANTARAS,0,0,0,0.0,1,0,-1,-100.0,21,5,-16,-76.19,47,52,5,10.64,888,842,-46,-5.18,957,899,-58,-6.06,ALCANTARAS CE,-3.586247,-40.5457641,5,896
CE,ALTANEIRA,0,0,0,0.0,2,2,0,0.0,0,0,0,0.0,24,22,-2,-8.33,700,348,-352,-50.29,726,372,-354,-48.76,ALTANEIRA CE,-6.9980933,-39.7385742,5,897
CE,ALTO SANTO,46,1,-45,-97.83,260,292,32,12.31,0,0,0,0.0,110,113,3,2.73,642,504,-138,-21.5,1058,910,-148,-13.99,ALTO SANTO CE,-5.5190371,-38.2719351,5,898
CE,AMONTADA,109,89,-20,-18.35,419,411,-8,-1.91,1,1,0,0.0,257,258,1,0.39,2196,1850,-346,-15.76,2982,2609,-373,-12.51,AMONTADA CE,-3.3634586,-39.8284791,5,899
CE,ANTONINA DO NORTE,0,0,0,0.0,1,3,2,200.0,0,0,0,0.0,72,70,-2,-2.78,568,497,-71,-12.5,641,570,-71,-11.08,ANTONINA DO NORTE CE,-6.7756797,-39.9873337,5,900
CE,APUIARES,1,0,-1,-100.0,345,331,-14,-4.06,0,0,0,0.0,86,81,-5,-5.81,479,437,-42,-8.77,911,849,-62,-6.81,APUIARES CE,-3.9460303,-39.4313298,5,901
CE,ARACATI,1302,1367,65,4.99,1419,1683,264,18.6,224,157,-67,-29.91,2447,2269,-178,-7.27,5138,3509,-1629,-31.7,10530,8985,-1545,-14.67,ARACATI CE,-4.558259,-37.767894,5,903
CE,ARACOIABA,29,27,-2,-6.9,479,489,10,2.09,3,5,2,66.67,276,236,-40,-14.49,1165,1173,8,0.69,1952,1930,-22,-1.13,ARACOIABA CE,-4.3702577,-38.8084313,5,904
CE,ARARENDA,0,0,0,0.0,4,0,-4,-100.0,43,8,-35,-81.4,31,45,14,45.16,648,733,85,13.12,726,786,60,8.26,ARARENDA CE,-4.7504395,-40.8303611,5,905
CE,ARARIPE,0,0,0,0.0,2,2,0,0.0,19,16,-3,-15.79,96,93,-3,-3.12,1003,1038,35,3.49,1120,1149,29,2.59,ARARIPE CE,-7.212861,-40.1359222,5,906
CE,ARATUBA,2,0,-2,-100.0,1,1,0,0.0,0,0,0,0.0,97,102,5,5.15,748,677,-71,-9.49,848,780,-68,-8.02,ARATUBA CE,-4.4195958,-39.0463737,5,907
CE,ARNEIROZ,0,0,0,0.0,0,0,0,0.0,0,0,0,0.0,25,25,0,0.0,347,261,-86,-24.78,372,286,-86,-23.12,ARNEIROZ CE,-6.3235099,-40.1603859,5,908
CE,ASSARE,2,0,-2,-100.0,17,17,0,0.0,3,6,3,100.0,233,202,-31,-13.3,1269,707,-562,-44.29,1524,932,-592,-38.85,ASSARE CE,-6.8746791,-39.8741385,5,909
CE,AURORA,1,1,0,0.0,2,1,-1,-50.0,9,0,-9,-100.0,211,210,-1,-0.47,1369,1042,-327,-23.89,1592,1254,-338,-21.23,AURORA CE,-6.9426019,-38.9693765,5,910
CE,BAIXIO,1,1,0,0.0,0,0,0,0.0,0,0,0,0.0,3,2,-1,-33.33,691,608,-83,-12.01,695,611,-84,-12.09,BAIXIO CE,-6.7303544,-38.7170095,5,911
CE,BANABUIU,3,0,-3,-100.0,191,187,-4,-2.09,50,16,-34,-68.0,108,119,11,10.19,1176,548,-628,-53.4,1528,870,-658,-43.06,BANABUIU CE,-5.3046404,-38.919766,5,912
CE,BARREIRA,23,23,0,0.0,97,86,-11,-11.34,1,9,8,800.0,149,159,10,6.71,820,691,-129,-15.73,1090,968,-122,-11.19,BARREIRA CE,-4.2883361,-38.641094,5,914
CE,BARRO,0,0,0,0.0,10,11,1,10.0,1,1,0,0.0,243,218,-25,-10.29,1089,871,-218,-20.02,1343,1101,-242,-18.02,BARRO CE,-7.1713587,-38.7742136,5,915
CE,BARROQUINHA,58,55,-3,-5.17,3,1,-2,-66.67,6,0,-6,-100.0,47,37,-10,-21.28,910,951,41,4.51,1024,1044,20,1.95,BARROQUINHA CE,-3.0200371,-41.1339229,5,916
CE,BATURITE,13,12,-1,-7.69,194,193,-1,-0.52,20,19,-1,-5.0,813,717,-96,-11.81,2136,2175,39,1.83,3176,3116,-60,-1.89,BATURITE CE,-4.3290203,-38.8821055,5,917
CE,BEBERIBE,1251,1453,202,16.15,216,181,-35,-16.2,89,55,-34,-38.2,496,555,59,11.9,2907,2130,-777,-26.73,4959,4374,-585,-11.8,BEBERIBE CE,-4.1810469,-38.1298101,5,918
CE,BELA CRUZ,31,12,-19,-61.29,210,198,-12,-5.71,11,8,-3,-27.27,89,100,11,12.36,1347,1516,169,12.55,1688,1834,146,8.65,BELA CRUZ CE,-3.0529129,-40.167582,5,919
CE,BOA VIAGEM,0,0,0,0.0,237,167,-70,-29.54,151,204,53,35.1,540,521,-19,-3.52,2545,2383,-162,-6.37,3473,3275,-198,-5.7,BOA VIAGEM CE,-5.1261877,-39.7300055,5,920
CE,BREJO SANTO,64,44,-20,-31.25,1944,1999,55,2.83,111,58,-53,-47.75,1175,1202,27,2.3,3253,2588,-665,-20.44,6547,5891,-656,-10.02,BREJO SANTO CE,-7.4909841,-38.9859152,5,921
CE,CAMOCIM,381,328,-53,-13.91,876,551,-325,-37.1,28,21,-7,-25.0,1005,984,-21,-2.09,3226,2947,-279,-8.65,5516,4831,-685,-12.42,CAMOCIM CE,-2.9009918,-40.8427389,5,922
CE,CAMPOS SALES,0,0,0,0.0,34,22,-12,-35.29,0,0,0,0.0,339,312,-27,-7.96,1620,1543,-77,-4.75,1993,1877,-116,-5.82,CAMPOS SALES CE,-7.0750814,-40.3830178,5,923
CE,CANINDE,3,3,0,0.0,1401,1339,-62,-4.43,633,647,14,2.21,1260,1378,118,9.37,3796,3231,-565,-14.88,7093,6598,-495,-6.98,CANINDE CE,-4.3547946,-39.3108516,5,924
CE,CAPISTRANO,0,0,0,0.0,1,1,0,0.0,2,2,0,0.0,91,71,-20,-21.98,908,1019,111,12.22,1002,1093,91,9.08,CAPISTRANO CE,-4.4644692,-38.8956734,5,925
CE,CARIDADE,48,73,25,52.08,132,137,5,3.79,2,2,0,0.0,65,62,-3,-4.62,747,645,-102,-13.65,994,919,-75,-7.55,CARIDADE CE,-4.2316487,-39.1946515,5,926
CE,CARIRE,0,7,7,0.0,339,178,-161,-47.49,0,0,0,0.0,44,49,5,11.36,1138,880,-258,-22.67,1521,1114,-407,-26.76,CARIRE CE,-3.948584,-40.476028,5,927
CE,CARIRIACU,0,0,0,0.0,13,12,-1,-7.69,3,20,17,566.67,111,106,-5,-4.5,1666,1275,-391,-23.47,1793,1413,-380,-21.19,CARIRIACU CE,-7.0417053,-39.2835527,5,928
CE,CARNAUBAL,25,25,0,0.0,3,3,0,0.0,4,6,2,50.0,73,72,-1,-1.37,890,835,-55,-6.18,995,941,-54,-5.43,CARNAUBAL CE,-4.1611842,-40.9412317,5,930
CE,CASCAVEL,727,721,-6,-0.83,2204,2395,191,8.67,17,17,0,0.0,1496,1588,92,6.15,2593,2197,-396,-15.27,7037,6918,-119,-1.69,CASCAVEL CE,-4.129666,-38.241178,5,931
CE,CATARINA,0,0,0,0.0,0,1,1,0.0,0,0,0,0.0,39,39,0,0.0,484,397,-87,-17.98,523,437,-86,-16.44,CATARINA CE,-6.1340485,-39.8791754,5,932
CE,CATUNDA,0,0,0,0.0,4,4,0,0.0,7,0,-7,-100.0,27,27,0,0.0,619,481,-138,-22.29,657,512,-145,-22.07,CATUNDA CE,-4.6494224,-40.2002603,5,933
CE,CEDRO,6,8,2,33.33,24,20,-4,-16.67,11,3,-8,-72.73,205,232,27,13.17,1095,946,-149,-13.61,1341,1209,-132,-9.84,CEDRO CE,-6.6065382,-39.0599487,5,935
CE,CHAVAL,26,25,-1,-3.85,27,22,-5,-18.52,0,0,0,0.0,78,73,-5,-6.41,1710,1527,-183,-10.7,1841,1647,-194,-10.54,CHAVAL CE,-3.0339874,-41.2438452,5,936
CE,CHORO,1,1,0,0.0,0,0,0,0.0,0,0,0,0.0,47,40,-7,-14.89,626,496,-130,-20.77,674,537,-137,-20.33,CHORO CE,-4.8435726,-39.1393071,5,937
CE,CHOROZINHO,15,17,2,13.33,407,493,86,21.13,6,8,2,33.33,176,140,-36,-20.45,918,753,-165,-17.97,1522,1411,-111,-7.29,CHOROZINHO CE,-4.3010895,-38.4976923,5,938
CE,COREAU,0,0,0,0.0,56,62,6,10.71,1,1,0,0.0,94,88,-6,-6.38,1052,883,-169,-16.06,1203,1034,-169,-14.05,COREAU CE,-3.5519794,-40.6528409,5,939
CE,CRATEUS,0,1,1,0.0,167,150,-17,-10.18,200,265,65,32.5,1675,1607,-68,-4.06,3698,3512,-186,-5.03,5740,5535,-205,-3.57,CRATEUS CE,-5.1782451,-40.6696545,5,940
CE,CROATA,0,0,0,0.0,2,1,-1,-50.0,1,1,0,0.0,65,73,8,12.31,721,628,-93,-12.9,789,703,-86,-10.9,CROATA CE,-4.4156199,-40.9048081,5,942
CE,CRUZ,25,9,-16,-64.0,47,51,4,8.51,5,12,7,140.0,246,273,27,10.98,1410,1299,-111,-7.87,1733,1644,-89,-5.14,CRUZ CE,-2.918128,-40.175981,5,943
CE,DEPUTADO IRAPUAN PINHEIRO,0,0,0,0.0,1,1,0,0.0,0,0,0,0.0,60,53,-7,-11.67,527,478,-49,-9.3,588,532,-56,-9.52,DEPUTADO IRAPUAN PINHEIRO CE,-5.9173532,-39.2672104,5,944
CE,ERERE,0,0,0,0.0,23,22,-1,-4.35,0,0,0,0.0,14,13,-1,-7.14,419,519,100,23.87,456,554,98,21.49,ERERE CE,-6.0311304,-38.3482173,5,945
CE,FARIAS BRITO,0,0,0,0.0,14,15,1,7.14,0,0,0,0.0,148,140,-8,-5.41,1007,861,-146,-14.5,1169,1016,-153,-13.09,FARIAS BRITO CE,-6.9272823,-39.5714222,5,947
CE,FORTALEZA,1600,1276,-324,-20.25,65534,60543,-4991,-7.62,41247,44040,2793,6.77,135755,128607,-7148,-5.27,515158,519894,4736,0.92,759294,754360,-4934,-0.65,FORTALEZA CE,-3.7304512,-38.5217989,5,949
CE,FORTIM,50,35,-15,-30.0,59,79,20,33.9,138,69,-69,-50.0,238,229,-9,-3.78,766,617,-149,-19.45,1251,1029,-222,-17.75,FORTIM CE,-4.451256,-37.798056,5,950
CE,FRECHEIRINHA,0,0,0,0.0,1957,2184,227,11.6,10,11,1,10.0,92,71,-21,-22.83,724,674,-50,-6.91,2783,2940,157,5.64,FRECHEIRINHA CE,-3.755572,-40.818019,5,951
CE,GENERAL SAMPAIO,0,0,0,0.0,0,4,4,0.0,1,0,-1,-100.0,37,38,1,2.7,557,525,-32,-5.75,595,567,-28,-4.71,GENERAL SAMPAIO CE,-4.0517636,-39.4509271,5,952
CE,GRACA,2,2,0,0.0,0,0,0,0.0,0,0,0,0.0,28,22,-6,-21.43,740,779,39,5.27,770,803,33,4.29,GRACA CE,-4.0453849,-40.7527195,5,953
CE,GRANJA,58,64,6,10.34,35,57,22,62.86,19,17,-2,-10.53,270,254,-16,-5.93,1985,1480,-505,-25.44,2367,1872,-495,-20.91,GRANJA CE,-3.1212057,-40.8284124,5,954
CE,GRANJEIRO,0,0,0,0.0,4,0,-4,-100.0,3,0,-3,-100.0,3,4,1,33.33,612,354,-258,-42.16,622,358,-264,-42.44,GRANJEIRO CE,-6.8889524,-39.2179315,5,955
CE,GROAIRAS,1,1,0,0.0,70,75,5,7.14,0,14,14,0.0,65,134,69,106.15,507,355,-152,-29.98,643,579,-64,-9.95,GROAIRAS CE,-3.9157768,-40.3855093,5,956
CE,GUAIUBA,357,362,5,1.4,126,108,-18,-14.29,1,2,1,100.0,229,234,5,2.18,1151,645,-506,-43.96,1864,1351,-513,-27.52,GUAIUBA CE,-4.0412656,-38.6369079,5,957
CE,GUARACIABA DO NORTE,51,46,-5,-9.8,115,104,-11,-9.57,9,5,-4,-44.44,534,536,2,0.37,2099,1870,-229,-10.91,2808,2561,-247,-8.8,GUARACIABA DO NORTE CE,-4.1632924,-40.7495985,5,958
CE,GUARAMIRANGA,26,17,-9,-34.62,2,2,0,0.0,0,0,0,0.0,73,82,9,12.33,728,527,-201,-27.61,829,628,-201,-24.25,GUARAMIRANGA CE,-4.2615431,-38.9339337,5,959
CE,HIDROLANDIA,1,1,0,0.0,43,53,10,23.26,9,7,-2,-22.22,103,92,-11,-10.68,966,86,-880,-91.1,1122,239,-883,-78.7,HIDROLANDIA CE,-4.4084745,-40.4065472,5,960
CE,HORIZONTE,648,704,56,8.64,11600,13002,1402,12.09,446,413,-33,-7.4,1388,1428,40,2.88,3662,3075,-587,-16.03,17744,18622,878,4.95,HORIZONTE CE,-4.0964618,-38.4965574,5,961
CE,IBARETAMA,66,49,-17,-25.76,19,15,-4,-21.05,0,0,0,0.0,64,74,10,15.62,697,536,-161,-23.1,846,674,-172,-20.33,IBARETAMA CE,-4.8194345,-38.8208476,5,962
CE,IBIAPINA,47,49,2,4.26,23,19,-4,-17.39,1,0,-1,-100.0,236,238,2,0.85,1303,978,-325,-24.94,1610,1284,-326,-20.25,IBIAPINA CE,-3.9228792,-40.8890296,5,963
CE,IBICUITINGA,1,0,-1,-100.0,2,0,-2,-100.0,0,0,0,0.0,20,24,4,20.0,931,606,-325,-34.91,954,630,-324,-33.96,IBICUITINGA CE,-4.9751759,-38.6368754,5,964
CE,ICAPUI,1562,1720,158,10.12,244,217,-27,-11.07,15,43,28,186.67,331,310,-21,-6.34,856,790,-66,-7.71,3008,3080,72,2.39,ICAPUI CE,-4.7475624,-37.2840614,5,965
CE,ICO,13,11,-2,-15.38,213,213,0,0.0,242,265,23,9.5,839,838,-1,-0.12,3037,2795,-242,-7.97,4344,4122,-222,-5.11,ICO CE,-6.4003992,-38.8575946,5,966
CE,IGUATU,236,256,20,8.47,2957,2862,-95,-3.21,242,283,41,16.94,4409,4336,-73,-1.66,5951,5234,-717,-12.05,13795,12971,-824,-5.97,IGUATU CE,-6.361934,-39.2972233,5,967
CE,INDEPENDENCIA,0,0,0,0.0,8,8,0,0.0,21,39,18,85.71,162,148,-14,-8.64,1383,1396,13,0.94,1574,1591,17,1.08,INDEPENDENCIA CE,-5.3958538,-40.3108896,5,968
CE,IPAPORANGA,0,0,0,0.0,4,7,3,75.0,0,0,0,0.0,52,49,-3,-5.77,712,419,-293,-41.15,768,475,-293,-38.15,IPAPORANGA CE,-4.903227,-40.760079,5,969
CE,IPAUMIRIM,2,2,0,0.0,85,78,-7,-8.24,8,7,-1,-12.5,119,112,-7,-5.88,737,603,-134,-18.18,951,802,-149,-15.67,IPAUMIRIM CE,-6.7883197,-38.7172034,5,970
CE,IPU,1,1,0,0.0,202,191,-11,-5.45,44,48,4,9.09,642,613,-29,-4.52,2330,2221,-109,-4.68,3219,3074,-145,-4.5,IPU CE,-4.3239824,-40.7097463,5,971
CE,IPUEIRAS,54,53,-1,-1.85,2,2,0,0.0,0,0,0,0.0,4,2,-2,-50.0,186,154,-32,-17.2,246,211,-35,-14.23,IPUEIRAS CE,-4.5427141,-40.7168461,5,972
CE,IRACEMA,24,20,-4,-16.67,0,0,0,0.0,0,0,0,0.0,22,29,7,31.82,395,205,-190,-48.1,441,254,-187,-42.4,IRACEMA CE,-5.8106219,-38.3028294,5,973
CE,IRAUCUBA,23,17,-6,-26.09,622,432,-190,-30.55,7,33,26,371.43,129,112,-17,-13.18,987,881,-106,-10.74,1768,1475,-293,-16.57,IRAUCUBA CE,-3.7466828,-39.7840904,5,974
CE,ITAICABA,44,48,4,9.09,39,36,-3,-7.69,7,7,0,0.0,44,48,4,9.09,498,279,-219,-43.98,632,418,-214,-33.86,ITAICABA CE,-4.68054,-37.8239968,5,975
CE,ITAPIPOCA,54,53,-1,-1.85,3585,4132,547,15.26,279,532,253,90.68,2129,1964,-165,-7.75,5696,6115,419,7.36,11743,12796,1053,8.97,ITAPIPOCA CE,-3.499329,-39.583571,5,978
CE,ITAPIUNA,3,0,-3,-100.0,1,1,0,0.0,0,7,7,0.0,54,54,0,0.0,757,714,-43,-5.68,815,776,-39,-4.79,ITAPIUNA CE,-4.5654191,-38.9211537,5,979
CE,ITAREMA,262,203,-59,-22.52,367,353,-14,-3.81,12,32,20,166.67,244,261,17,6.97,1714,1626,-88,-5.13,2599,2475,-124,-4.77,ITAREMA CE,-2.9224684,-39.9152184,5,980
CE,ITATIRA,0,0,0,0.0,1,0,-1,-100.0,1,1,0,0.0,55,67,12,21.82,1207,1259,52,4.31,1264,1327,63,4.98,ITATIRA CE,-4.5305504,-39.6210481,5,981
CE,JAGUARETAMA,0,0,0,0.0,7,6,-1,-14.29,14,55,41,292.86,200,186,-14,-7.0,901,814,-87,-9.66,1122,1061,-61,-5.44,JAGUARETAMA CE,-5.6092417,-38.7630077,5,982
CE,JAGUARIBARA,13,11,-2,-15.38,12,15,3,25.0,4,4,0,0.0,128,131,3,2.34,656,561,-95,-14.48,813,722,-91,-11.19,JAGUARIBARA CE,-5.454494,-38.4679295,5,983
CE,JAGUARIBE,120,126,6,5.0,503,591,88,17.5,32,72,40,125.0,744,773,29,3.9,1458,1364,-94,-6.45,2857,2926,69,2.42,JAGUARIBE CE,-5.8854585,-38.6212957,5,984
CE,JAGUARUANA,441,438,-3,-0.68,795,814,19,2.39,127,101,-26,-20.47,402,382,-20,-4.98,1741,1344,-397,-22.8,3506,3079,-427,-12.18,JAGUARUANA CE,-4.831508,-37.780997,5,985
CE,JARDIM,0,0,0,0.0,57,52,-5,-8.77,10,14,4,40.0,153,168,15,9.8,1351,1300,-51,-3.77,1571,1534,-37,-2.36,JARDIM CE,-7.5838966,-39.279713,5,986
CE,JATI,3,2,-1,-33.33,20,7,-13,-65.0,2,1,-1,-50.0,48,29,-19,-39.58,595,553,-42,-7.06,668,592,-76,-11.38,JATI CE,-7.6894344,-39.006074,5,987
CE,JIJOCA DE JERICOACOARA,0,0,0,0.0,102,90,-12,-11.76,78,34,-44,-56.41,517,485,-32,-6.19,3728,2206,-1522,-40.83,4425,2815,-1610,-36.38,JIJOCA DE JERICOACOARA CE,-2.8986278,-40.4506081,5,988
CE,JUAZEIRO DO NORTE,17,12,-5,-29.41,7692,7108,-584,-7.59,1596,1653,57,3.57,12834,12525,-309,-2.41,27573,22855,-4718,-17.11,49712,44153,-5559,-11.18,JUAZEIRO DO NORTE CE,-7.2153453,-39.3153336,5,989
CE,LAVRAS DA MANGABEIRA,2,0,-2,-100.0,13,13,0,0.0,13,96,83,638.46,134,138,4,2.99,1347,1176,-171,-12.69,1509,1423,-86,-5.7,LAVRAS DA MANGABEIRA CE,-6.7533331,-38.96538686618186,5,991
CE,LIMOEIRO DO NORTE,1342,1459,117,8.72,928,931,3,0.32,206,1002,796,386.41,1712,1717,5,0.29,2756,3279,523,18.98,6944,8388,1444,20.79,LIMOEIRO DO NORTE CE,-5.1455607,-38.0984936,5,992
CE,MADALENA,81,92,11,13.58,132,142,10,7.58,3,6,3,100.0,101,125,24,23.76,885,799,-86,-9.72,1202,1164,-38,-3.16,MADALENA CE,-4.8542961,-39.5766436,5,993
CE,MARCO,79,73,-6,-7.59,1564,1003,-561,-35.87,11,6,-5,-45.45,326,307,-19,-5.83,1386,1169,-217,-15.66,3366,2558,-808,-24.0,MARCO CE,-3.1221945,-40.1514585,5,996
CE,MARTINOPOLE,1,0,-1,-100.0,9,8,-1,-11.11,0,0,0,0.0,32,54,22,68.75,799,828,29,3.63,841,890,49,5.83,MARTINOPOLE CE,-3.2235114,-40.6958832,5,997
CE,MASSAPE,29,30,1,3.45,226,261,35,15.49,20,31,11,55.0,248,273,25,10.08,1758,938,-820,-46.64,2281,1533,-748,-32.79,MASSAPE CE,-3.5239058,-40.3423107,5,998
CE,MAURITI,37,43,6,16.22,144,139,-5,-3.47,16,16,0,0.0,407,413,6,1.47,2035,1851,-184,-9.04,2639,2462,-177,-6.71,MAURITI CE,-7.3870095,-38.7737751,5,999
CE,MERUOCA,2,2,0,0.0,4,8,4,100.0,47,28,-19,-40.43,55,51,-4,-7.27,1013,1028,15,1.48,1121,1117,-4,-0.36,MERUOCA CE,-3.5390209,-40.4546107,5,1000
CE,MILAGRES,0,0,0,0.0,116,117,1,0.86,75,330,255,340.0,246,235,-11,-4.47,1360,1106,-254,-18.68,1797,1788,-9,-0.5,MILAGRES CE,-7.3106846,-38.9447146,5,1001
CE,MILHA,0,0,0,0.0,4,2,-2,-50.0,0,0,0,0.0,96,100,4,4.17,533,452,-81,-15.2,633,554,-79,-12.48,MILHA CE,-5.6834601,-39.1970885,5,1002
CE,MIRAIMA,0,0,0,0.0,0,0,0,0.0,0,0,0,0.0,11,11,0,0.0,854,841,-13,-1.52,865,852,-13,-1.5,MIRAIMA CE,-3.568674,-39.966267,5,1003
CE,MISSAO VELHA,629,620,-9,-1.43,128,95,-33,-25.78,5,3,-2,-40.0,306,335,29,9.48,1606,1459,-147,-9.15,2674,2512,-162,-6.06,MISSAO VELHA CE,-7.248491,-39.1434843,5,1004
CE,MOMBACA,1,1,0,0.0,115,73,-42,-36.52,6,229,223,3716.67,559,603,44,7.87,1885,1361,-524,-27.8,2566,2267,-299,-11.65,MOMBACA CE,-5.7450899,-39.6293519,5,1005
CE,MONSENHOR TABOSA,0,0,0,0.0,2,2,0,0.0,4,2,-2,-50.0,156,161,5,3.21,1105,1059,-46,-4.16,1267,1224,-43,-3.39,MONSENHOR TABOSA CE,-4.7879512,-40.063949,5,1006
CE,MORADA NOVA,190,168,-22,-11.58,3395,4346,951,28.01,371,270,-101,-27.22,981,995,14,1.43,2840,2890,50,1.76,7777,8669,892,11.47,MORADA NOVA CE,-5.1076699,-38.3727852,5,1007
CE,MORAUJO,0,0,0,0.0,0,0,0,0.0,1,1,0,0.0,19,13,-6,-31.58,567,673,106,18.69,587,687,100,17.04,MORAUJO CE,-3.4657654,-40.679146,5,1008
CE,MORRINHOS,0,0,0,0.0,45,41,-4,-8.89,1,12,11,1100.0,115,150,35,30.43,569,525,-44,-7.73,730,728,-2,-0.27,MORRINHOS CE,-3.2275749,-40.1280783,5,1009
CE,MUCAMBO,4,2,-2,-50.0,5,2,-3,-60.0,5,5,0,0.0,103,84,-19,-18.45,703,443,-260,-36.98,820,536,-284,-34.63,MUCAMBO CE,-3.9043285,-40.7454425,5,1010
CE,MULUNGU,29,28,-1,-3.45,0,2,2,0.0,2,11,9,450.0,56,61,5,8.93,784,875,91,11.61,871,977,106,12.17,MULUNGU CE,-5.888418,-39.384758,5,1011
CE,NOVA OLINDA,90,81,-9,-10.0,626,639,13,2.08,3,1,-2,-66.67,255,235,-20,-7.84,358,319,-39,-10.89,1332,1275,-57,-4.28,NOVA OLINDA CE,-7.0934174,-39.6789815,5,1012
CE,NOVA RUSSAS,0,0,0,0.0,93,87,-6,-6.45,103,50,-53,-51.46,540,554,14,2.59,1346,1370,24,1.78,2082,2061,-21,-1.01,NOVA RUSSAS CE,-4.7051681,-40.565519,5,1013
CE,NOVO ORIENTE,0,0,0,0.0,6,5,-1,-16.67,18,33,15,83.33,104,119,15,14.42,1288,1134,-154,-11.96,1416,1291,-125,-8.83,NOVO ORIENTE CE,-5.5350339,-40.7748902,5,1014
CE,OCARA,20,19,-1,-5.0,91,114,23,25.27,2,14,12,600.0,77,103,26,33.77,977,873,-104,-10.64,1167,1123,-44,-3.77,OCARA CE,-4.4910653,-38.5964829,5,1015
CE,OROS,13,12,-1,-7.69,11,10,-1,-9.09,0,0,0,0.0,149,142,-7,-4.7,644,659,15,2.33,817,823,6,0.73,OROS CE,-6.2427541,-38.9141151,5,1016
CE,PACAJUS,448,483,35,7.81,2566,2354,-212,-8.26,98,85,-13,-13.27,1589,1590,1,0.06,3112,2758,-354,-11.38,7813,7270,-543,-6.95,PACAJUS CE,-4.171073,-38.464988,5,1017
CE,PACOTI,22,10,-12,-54.55,31,42,11,35.48,0,0,0,0.0,93,97,4,4.3,850,856,6,0.71,996,1005,9,0.9,PACOTI CE,-4.2253561,-38.9208352,5,1019
CE,PACUJA,0,0,0,0.0,0,0,0,0.0,1,0,-1,-100.0,16,16,0,0.0,371,308,-63,-16.98,388,324,-64,-16.49,PACUJA CE,-3.9802066,-40.6986251,5,1020
CE,PALHANO,0,3,3,0.0,16,50,34,212.5,1,6,5,500.0,70,70,0,0.0,560,29,-531,-94.82,647,158,-489,-75.58,PALHANO CE,-4.7449408,-37.9608401,5,1021
CE,PALMACIA,22,17,-5,-22.73,4,5,1,25.0,1,2,1,100.0,53,56,3,5.66,740,516,-224,-30.27,820,596,-224,-27.32,PALMACIA CE,-4.1478012,-38.8460317,5,1022
CE,PARACURU,383,364,-19,-4.96,174,141,-33,-18.97,95,72,-23,-24.21,494,531,37,7.49,2224,2478,254,11.42,3370,3586,216,6.41,PARACURU CE,-3.41436,-39.030028,5,1023
CE,PARAIPABA,471,428,-43,-9.13,545,686,141,25.87,507,457,-50,-9.86,375,325,-50,-13.33,1960,1905,-55,-2.81,3858,3801,-57,-1.48,PARAIPABA CE,-3.437987,-39.147868,5,1024
CE,PARAMBU,0,0,0,0.0,3,4,1,33.33,4,1,-3,-75.0,144,144,0,0.0,1706,1734,28,1.64,1857,1883,26,1.4,PARAMBU CE,-6.2123856,-40.6954982,5,1025
CE,PARAMOTI,0,0,0,0.0,1,18,17,1700.0,0,0,0,0.0,51,54,3,5.88,618,563,-55,-8.9,670,635,-35,-5.22,PARAMOTI CE,-4.0964461,-39.2390411,5,1026
CE,PEDRA BRANCA,0,0,0,0.0,61,36,-25,-40.98,1,1,0,0.0,358,335,-23,-6.42,2679,1431,-1248,-46.58,3099,1803,-1296,-41.82,PEDRA BRANCA CE,-5.455674,-39.7166286,5,1027
CE,PENAFORTE,1,1,0,0.0,0,0,0,0.0,4,4,0,0.0,115,103,-12,-10.43,635,552,-83,-13.07,755,660,-95,-12.58,PENAFORTE CE,-7.8288372,-39.0751908,5,1028
CE,PENTECOSTE,156,153,-3,-1.92,1644,1651,7,0.43,6,7,1,16.67,438,466,28,6.39,2146,1779,-367,-17.1,4390,4056,-334,-7.61,PENTECOSTE CE,-3.7952282,-39.2713219,5,1029
CE,PEREIRO,4,0,-4,-100.0,227,302,75,33.04,5,6,1,20.0,62,68,6,9.68,3182,2527,-655,-20.58,3480,2903,-577,-16.58,PEREIRO CE,-6.046269,-38.4604192,5,1030
CE,PINDORETAMA,66,78,12,18.18,297,267,-30,-10.1,24,29,5,20.83,263,313,50,19.01,822,520,-302,-36.74,1472,1207,-265,-18.0,PINDORETAMA CE,-4.0265183,-38.3066829,5,1031
CE,PIQUET CARNEIRO,0,0,0,0.0,13,6,-7,-53.85,0,0,0,0.0,175,175,0,0.0,879,884,5,0.57,1067,1065,-2,-0.19,PIQUET CARNEIRO CE,-5.800251,-39.417017,5,1032
CE,PIRES FERREIRA,0,0,0,0.0,3,3,0,0.0,2,3,1,50.0,35,26,-9,-25.71,419,582,163,38.9,459,614,155,33.77,PIRES FERREIRA CE,-4.2453181,-40.6437501,5,1033
CE,PORANGA,0,0,0,0.0,17,19,2,11.76,0,0,0,0.0,59,72,13,22.03,606,641,35,5.78,682,732,50,7.33,PORANGA CE,-4.7446727,-40.9249168,5,1034
CE,PORTEIRAS,6,6,0,0.0,0,0,0,0.0,28,8,-20,-71.43,114,116,2,1.75,929,932,3,0.32,1077,1062,-15,-1.39,PORTEIRAS CE,-7.5341572,-39.1153149,5,1035
CE,POTENGI,4,3,-1,-25.0,0,0,0,0.0,4,10,6,150.0,77,75,-2,-2.6,531,497,-34,-6.4,616,585,-31,-5.03,POTENGI CE,-7.0915205,-40.0268241,5,1036
CE,POTIRETAMA,2,1,-1,-50.0,0,0,0,0.0,0,0,0,0.0,18,15,-3,-16.67,586,246,-340,-58.02,606,262,-344,-56.77,POTIRETAMA CE,-5.7226924,-38.154107,5,1037
CE,QUITERIANOPOLIS,0,0,0,0.0,8,6,-2,-25.0,2,1,-1,-50.0,62,62,0,0.0,1226,1119,-107,-8.73,1298,1188,-110,-8.47,QUITERIANOPOLIS CE,-5.8458117,-40.7021812,5,1038
CE,QUIXADA,405,418,13,3.21,605,643,38,6.28,77,82,5,6.49,1860,1892,32,1.72,5064,4460,-604,-11.93,8011,7495,-516,-6.44,QUIXADA CE,-4.9706021,-39.0158403,5,1039
CE,QUIXELO,10,8,-2,-20.0,10,7,-3,-30.0,0,1,1,0.0,151,165,14,9.27,702,632,-70,-9.97,873,813,-60,-6.87,QUIXELO CE,-6.2511238,-39.1995458,5,1040
CE,QUIXERAMOBIM,198,202,4,2.02,5577,4688,-889,-15.94,427,214,-213,-49.88,1284,1233,-51,-3.97,4185,4169,-16,-0.38,11671,10506,-1165,-9.98,QUIXERAMOBIM CE,-5.1983553,-39.2955573,5,1041
CE,QUIXERE,833,1090,257,30.85,880,1433,553,62.84,6,5,-1,-16.67,230,226,-4,-1.74,933,838,-95,-10.18,2882,3592,710,24.64,QUIXERE CE,-5.0742841,-37.9892825,5,1042
CE,RERIUTABA,1,1,0,0.0,30,30,0,0.0,81,43,-38,-46.91,117,154,37,31.62,1166,1042,-124,-10.63,1395,1270,-125,-8.96,RERIUTABA CE,-4.1418352,-40.5824356,5,1044
CE,RUSSAS,519,577,58,11.18,3400,3085,-315,-9.26,151,139,-12,-7.95,2007,1968,-39,-1.94,3970,3555,-415,-10.45,10047,9324,-723,-7.2,RUSSAS CE,-4.9441876,-37.9811859,5,1045
CE,SABOEIRO,0,0,0,0.0,43,37,-6,-13.95,0,3,3,0.0,37,38,1,2.7,725,653,-72,-9.93,805,731,-74,-9.19,SABOEIRO CE,-6.539564,-39.9047802,5,1046
CE,SALITRE,0,0,0,0.0,0,0,0,0.0,0,0,0,0.0,23,19,-4,-17.39,1523,1616,93,6.11,1546,1635,89,5.76,SALITRE CE,-7.285445,-40.457306,5,1047
CE,SANTANA DO ACARAU,12,13,1,8.33,17,17,0,0.0,13,26,13,100.0,95,117,22,23.16,1378,1358,-20,-1.45,1515,1531,16,1.06,SANTANA DO ACARAU CE,-3.4596492,-40.2090987,5,1048
CE,SANTANA DO CARIRI,21,20,-1,-4.76,2,2,0,0.0,0,0,0,0.0,65,49,-16,-24.62,1093,1095,2,0.18,1181,1166,-15,-1.27,SANTANA DO CARIRI CE,-7.1844749,-39.73683102569594,5,1049
CE,SANTA QUITERIA,5,6,1,20.0,1442,1515,73,5.06,31,15,-16,-51.61,452,451,-1,-0.22,2121,1539,-582,-27.44,4051,3526,-525,-12.96,SANTA QUITERIA CE,-4.3336553,-40.1544913,5,1050
CE,SAO BENEDITO,352,842,490,139.2,291,351,60,20.62,30,23,-7,-23.33,648,581,-67,-10.34,2439,2399,-40,-1.64,3760,4196,436,11.6,SAO BENEDITO CE,-4.0479952,-40.8643488,5,1051
CE,SAO GONCALO DO AMARANTE,98,137,39,39.8,4938,5153,215,4.35,436,506,70,16.06,703,749,46,6.54,6460,6327,-133,-2.06,12635,12872,237,1.88,SAO GONCALO DO AMARANTE CE,-3.5929237,-39.03653251900945,5,1052
CE,SAO JOAO DO JAGUARIBE,31,19,-12,-38.71,3,0,-3,-100.0,0,0,0,0.0,39,34,-5,-12.82,413,361,-52,-12.59,486,414,-72,-14.81,SAO JOAO DO JAGUARIBE CE,-5.2719441,-38.271993,5,1053
CE,SAO LUIS DO CURU,35,35,0,0.0,45,88,43,95.56,0,1,1,0.0,54,49,-5,-9.26,642,385,-257,-40.03,776,558,-218,-28.09,SAO LUIS DO CURU CE,-3.672399,-39.2364881,5,1054
CE,SENADOR POMPEU,1,1,0,0.0,1228,1636,408,33.22,22,7,-15,-68.18,450,452,2,0.44,1156,961,-195,-16.87,2857,3057,200,7.0,SENADOR POMPEU CE,-5.5874386,-39.3730901,5,1055
CE,SENADOR SA,0,0,0,0.0,1,2,1,100.0,0,0,0,0.0,21,27,6,28.57,449,371,-78,-17.37,471,400,-71,-15.07,SENADOR SA CE,-3.3528,-40.4644057,5,1056
CE,SOBRAL,14,17,3,21.43,16093,18249,2156,13.4,1135,1221,86,7.58,7807,7352,-455,-5.83,20079,21271,1192,5.94,45128,48110,2982,6.61,SOBRAL CE,-3.6879135,-40.3456372,5,1057
CE,SOLONOPOLE,0,0,0,0.0,287,393,106,36.93,4,11,7,175.0,248,237,-11,-4.44,1072,909,-163,-15.21,1611,1550,-61,-3.79,SOLONOPOLE CE,-5.7329092,-39.0098669,5,1058
CE,TABULEIRO DO NORTE,64,41,-23,-35.94,190,134,-56,-29.47,1,4,3,300.0,675,689,14,2.07,1378,1402,24,1.74,2308,2270,-38,-1.65,TABULEIRO DO NORTE CE,-5.2440865,-38.1284605,5,1059
CE,TAMBORIL,0,0,0,0.0,3,2,-1,-33.33,0,2,2,0.0,99,87,-12,-12.12,1128,1017,-111,-9.84,1230,1108,-122,-9.92,TAMBORIL CE,-4.8330075,-40.3210323,5,1060
CE,TARRAFAS,0,0,0,0.0,0,0,0,0.0,4,2,-2,-50.0,21,24,3,14.29,793,445,-348,-43.88,818,471,-347,-42.42,TARRAFAS CE,-6.6819901,-39.7575709,5,1061
CE,TAUA,19,18,-1,-5.26,852,954,102,11.97,233,56,-177,-75.97,1033,1009,-24,-2.32,2546,3511,965,37.9,4683,5548,865,18.47,TAUA CE,-6.0031372,-40.2947268,5,1062
CE,TEJUCUOCA,0,0,0,0.0,141,125,-16,-11.35,3,8,5,166.67,62,58,-4,-6.45,1109,1147,38,3.43,1315,1338,23,1.75,TEJUCUOCA CE,-3.9884273,-39.5797395,5,1063
CE,TIANGUA,368,352,-16,-4.35,908,846,-62,-6.83,732,755,23,3.14,2152,2311,159,7.39,4437,4482,45,1.01,8597,8746,149,1.73,TIANGUA CE,-3.7307332,-41.0004019,5,1064
CE,TRAIRI,154,146,-8,-5.19,359,389,30,8.36,40,70,30,75.0,231,281,50,21.65,2634,2372,-262,-9.95,3418,3258,-160,-4.68,TRAIRI CE,-3.2777494,-39.2680677,5,1065
CE,TURURU,2,3,1,50.0,87,87,0,0.0,0,0,0,0.0,43,41,-2,-4.65,748,676,-72,-9.63,880,807,-73,-8.3,TURURU CE,-3.5985489,-39.4358101,5,1066
CE,UBAJARA,533,443,-90,-16.89,459,445,-14,-3.05,32,54,22,68.75,560,567,7,1.25,1331,1222,-109,-8.19,2915,2731,-184,-6.31,UBAJARA CE,-3.8534468,-40.9185642,5,1067
CE,UMARI,3,3,0,0.0,5,4,-1,-20.0,0,5,5,0.0,12,13,1,8.33,542,321,-221,-40.77,562,346,-216,-38.43,UMARI CE,-6.6465102,-38.6995155,5,1068
CE,UMIRIM,149,172,23,15.44,131,120,-11,-8.4,10,10,0,0.0,36,39,3,8.33,926,619,-307,-33.15,1252,960,-292,-23.32,UMIRIM CE,-3.6777738,-39.348725,5,1069
CE,URUBURETAMA,5,4,-1,-20.0,1429,1227,-202,-14.14,1,1,0,0.0,99,91,-8,-8.08,982,802,-180,-18.33,2516,2125,-391,-15.54,URUBURETAMA CE,-3.6235302,-39.5050697,5,1070
CE,URUOCA,7,11,4,57.14,309,326,17,5.5,3,1,-2,-66.67,78,69,-9,-11.54,802,758,-44,-5.49,1199,1165,-34,-2.84,URUOCA CE,-3.3147591,-40.558957,5,1071
CE,VARJOTA,0,0,0,0.0,38,46,8,21.05,20,45,25,125.0,197,195,-2,-1.02,1228,1232,4,0.33,1483,1518,35,2.36,VARJOTA CE,-4.1958345,-40.4735305,5,1072
CE,VARZEA ALEGRE,0,0,0,0.0,424,453,29,6.84,30,13,-17,-56.67,604,662,58,9.6,2230,2121,-109,-4.89,3288,3249,-39,-1.19,VARZEA ALEGRE CE,-6.7936089,-39.2989333,5,1073
CE,VICOSA DO CEARA,7,6,-1,-14.29,26,89,63,242.31,4,3,-1,-25.0,313,343,30,9.58,2835,2420,-415,-14.64,3185,2861,-324,-10.17,VICOSA DO CEARA CE,-3.5667684,-41.091504,5,1074
RN,ACARI,30,23,-7,-23.33,298,249,-49,-16.44,3,1,-2,-66.67,195,180,-15,-7.69,476,466,-10,-2.1,1002,919,-83,-8.28,ACARI RN,-6.4364689,-36.6394777,19,1075
RN,ACU,395,363,-32,-8.1,747,743,-4,-0.54,106,109,3,2.83,1717,1704,-13,-0.76,2847,2794,-53,-1.86,5812,5713,-99,-1.7,ACU RN,-5.5836157,-36.9139541,19,1076
RN,AFONSO BEZERRA,228,237,9,3.95,7,5,-2,-28.57,0,263,263,0.0,41,47,6,14.63,342,306,-36,-10.53,618,858,240,38.83,AFONSO BEZERRA RN,-5.4745,-36.57625071327935,19,1077
RN,AGUA NOVA,0,0,0,0.0,1,1,0,0.0,4,0,-4,-100.0,6,8,2,33.33,240,198,-42,-17.5,251,207,-44,-17.53,AGUA NOVA RN,-6.2063221,-38.2912678,19,1078
RN,ALEXANDRIA,3,3,0,0.0,32,37,5,15.62,8,3,-5,-62.5,111,115,4,3.6,745,496,-249,-33.42,899,654,-245,-27.25,ALEXANDRIA RN,-6.414779,-38.0135516,19,1079
RN,ALMINO AFONSO,0,0,0,0.0,5,4,-1,-20.0,0,0,0,0.0,13,12,-1,-7.69,157,132,-25,-15.92,175,148,-27,-15.43,ALMINO AFONSO RN,-6.1544208,-37.7649018,19,1080
RN,ALTO DO RODRIGUES,109,114,5,4.59,398,331,-67,-16.83,460,273,-187,-40.65,336,321,-15,-4.46,1481,1584,103,6.95,2784,2623,-161,-5.78,ALTO DO RODRIGUES RN,-5.290868,-36.7616726,19,1081
RN,ANGICOS,5,6,1,20.0,65,76,11,16.92,11,5,-6,-54.55,227,250,23,10.13,481,130,-351,-72.97,789,467,-322,-40.81,ANGICOS RN,-5.6666344,-36.6009064,19,1082
RN,ANTONIO MARTINS,0,1,1,0.0,38,37,-1,-2.63,10,10,0,0.0,37,32,-5,-13.51,225,198,-27,-12.0,310,278,-32,-10.32,ANTONIO MARTINS RN,-6.2155812,-37.8890129,19,1083
RN,APODI,1461,1355,-106,-7.26,214,190,-24,-11.21,14,13,-1,-7.14,567,560,-7,-1.23,1496,1288,-208,-13.9,3752,3406,-346,-9.22,APODI RN,-5.6631109,-37.796927,19,1084
RN,AREIA BRANCA,12,11,-1,-8.33,1295,1343,48,3.71,246,153,-93,-37.8,555,540,-15,-2.7,2295,881,-1414,-61.61,4403,2928,-1475,-33.5,AREIA BRANCA RN,-4.9506652,-37.1263312,19,1085
RN,ARES,178,553,375,210.67,1509,1770,261,17.3,2,1,-1,-50.0,142,116,-26,-18.31,796,94,-702,-88.19,2627,2534,-93,-3.54,ARES RN,-6.1969216,-35.1642968,19,1086
RN,AUGUSTO SEVERO,4,2,-2,-50.0,4,5,1,25.0,19,21,2,10.53,35,34,-1,-2.86,444,384,-60,-13.51,506,446,-60,-11.86,AUGUSTO SEVERO RN,-5.8697839,-35.3609613,19,1087
RN,BAIA FORMOSA,170,150,-20,-11.76,2187,2253,66,3.02,11,4,-7,-63.64,54,53,-1,-1.85,496,335,-161,-32.46,2918,2795,-123,-4.22,BAIA FORMOSA RN,-6.3691885,-35.0063741,19,1088
RN,BARAUNA,1698,1754,56,3.3,497,629,132,26.56,88,99,11,12.5,435,461,26,5.98,1322,1158,-164,-12.41,4040,4101,61,1.51,BARAUNA RN,-5.0775002,-37.61752,19,1089
RN,BARCELONA,0,0,0,0.0,1,9,8,800.0,0,0,0,0.0,29,33,4,13.79,206,166,-40,-19.42,236,208,-28,-11.86,BARCELONA RN,-5.9514918,-35.9260284,19,1090
RN,BENTO FERNANDES,3,2,-1,-33.33,2,2,0,0.0,0,0,0,0.0,8,6,-2,-25.0,353,447,94,26.63,366,457,91,24.86,BENTO FERNANDES RN,-5.6926846,-35.8207423,19,1091
RN,BODO,6,7,1,16.67,89,75,-14,-15.73,0,0,0,0.0,9,10,1,11.11,338,198,-140,-41.42,442,290,-152,-34.39,BODO RN,-5.9866104,-36.4134824,19,1092
RN,BOM JESUS,438,424,-14,-3.2,117,144,27,23.08,60,53,-7,-11.67,1206,1243,37,3.07,1703,1381,-322,-18.91,3524,3245,-279,-7.92,BOM JESUS RN,-5.9887544,-35.5821149,19,1093
RN,BREJINHO,32,26,-6,-18.75,104,80,-24,-23.08,19,11,-8,-42.11,164,197,33,20.12,532,489,-43,-8.08,851,803,-48,-5.64,BREJINHO RN,-6.1957907,-35.3583019,19,1094
RN,CAICARA DO NORTE,105,94,-11,-10.48,3,3,0,0.0,26,23,-3,-11.54,92,77,-15,-16.3,14,144,130,928.57,240,341,101,42.08,CAICARA DO NORTE RN,-5.0645017,-36.0561226,19,1095
RN,CAICARA DO RIO DO VENTO,3,3,0,0.0,2,5,3,150.0,0,0,0,0.0,30,28,-2,-6.67,155,144,-11,-7.1,190,180,-10,-5.26,CAICARA DO RIO DO VENTO RN,-5.757968,-36.00089,19,1096
RN,CAICO,41,41,0,0.0,1636,1496,-140,-8.56,144,99,-45,-31.25,3430,3465,35,1.02,4825,4613,-212,-4.39,10076,9714,-362,-3.59,CAICO RN,-6.4594544,-37.0971911,19,1097
RN,CAMPO REDONDO,0,0,0,0.0,17,18,1,5.88,1,2,1,100.0,31,31,0,0.0,532,414,-118,-22.18,581,465,-116,-19.97,CAMPO REDONDO RN,-6.2420373,-36.1830606,19,1098
RN,CANGUARETAMA,1277,1045,-232,-18.17,47,49,2,4.26,7,12,5,71.43,580,624,44,7.59,1448,1322,-126,-8.7,3359,3052,-307,-9.14,CANGUARETAMA RN,-6.3751942,-35.137463,19,1099
RN,CARAUBAS,156,113,-43,-27.56,124,137,13,10.48,319,316,-3,-0.94,321,312,-9,-2.8,1052,470,-582,-55.32,1972,1348,-624,-31.64,CARAUBAS RN,-5.7889323,-37.5548751,19,1100
RN,CARNAUBA DOS DANTAS,0,0,0,0.0,550,574,24,4.36,16,20,4,25.0,170,172,2,1.18,502,339,-163,-32.47,1238,1105,-133,-10.74,CARNAUBA DOS DANTAS RN,-6.5560588,-36.5930811,19,1101
RN,CARNAUBAIS,104,93,-11,-10.58,29,31,2,6.9,1,5,4,400.0,69,64,-5,-7.25,568,338,-230,-40.49,771,531,-240,-31.13,CARNAUBAIS RN,-5.3383681,-36.8335566,19,1102
RN,CEARA-MIRIM,455,464,9,1.98,842,924,82,9.74,72,111,39,54.17,1366,1338,-28,-2.05,2924,2770,-154,-5.27,5659,5607,-52,-0.92,CEARA-MIRIM RN,-5.6322641,-35.4213273,19,1103
RN,CERRO CORA,1,1,0,0.0,237,202,-35,-14.77,0,0,0,0.0,138,135,-3,-2.17,389,392,3,0.77,765,730,-35,-4.58,CERRO CORA RN,-6.0412685,-36.3464694,19,1104
RN,CORONEL EZEQUIEL,0,0,0,0.0,30,30,0,0.0,0,0,0,0.0,7,9,2,28.57,283,277,-6,-2.12,320,316,-4,-1.25,CORONEL EZEQUIEL RN,-6.3853153,-36.2151622,19,1105
RN,CORONEL JOAO PESSOA,0,0,0,0.0,1,1,0,0.0,0,0,0,0.0,12,12,0,0.0,297,187,-110,-37.04,310,200,-110,-35.48,CORONEL JOAO PESSOA RN,-6.2607263,-38.4425693,19,1106
RN,CRUZETA,1,1,0,0.0,271,287,16,5.9,0,0,0,0.0,191,181,-10,-5.24,477,388,-89,-18.66,940,857,-83,-8.83,CRUZETA RN,-6.4113343,-36.7872964,19,1107
RN,CURRAIS NOVOS,22,20,-2,-9.09,970,936,-34,-3.51,416,365,-51,-12.26,1586,1482,-104,-6.56,2491,2399,-92,-3.69,5485,5202,-283,-5.16,CURRAIS NOVOS RN,-6.2626676,-36.5173039,19,1108
RN,DOUTOR SEVERIANO,0,0,0,0.0,11,10,-1,-9.09,0,0,0,0.0,18,15,-3,-16.67,378,360,-18,-4.76,407,385,-22,-5.41,DOUTOR SEVERIANO RN,-6.0948339,-38.3748,19,1109
RN,ENCANTO,0,0,0,0.0,26,21,-5,-19.23,0,0,0,0.0,24,24,0,0.0,304,266,-38,-12.5,354,311,-43,-12.15,ENCANTO RN,-6.1107477,-38.3050953,19,1111
RN,EQUADOR,0,0,0,0.0,204,204,0,0.0,3,0,-3,-100.0,63,65,2,3.17,273,262,-11,-4.03,543,531,-12,-2.21,EQUADOR RN,-6.89071355,-36.66447219982531,19,1112
RN,ESPIRITO SANTO,5,6,1,20.0,15,9,-6,-40.0,0,0,0,0.0,56,57,1,1.79,507,541,34,6.71,583,613,30,5.15,ESPIRITO SANTO RN,-6.3317917,-35.3096508,19,1113
RN,FELIPE GUERRA,6,8,2,33.33,3,3,0,0.0,0,0,0,0.0,34,33,-1,-2.94,400,313,-87,-21.75,443,357,-86,-19.41,FELIPE GUERRA RN,-5.5981386,-37.6962757,19,1115
RN,FERNANDO PEDROZA,10,10,0,0.0,3,3,0,0.0,0,0,0,0.0,8,35,27,337.5,223,162,-61,-27.35,244,210,-34,-13.93,FERNANDO PEDROZA RN,-5.6972558,-36.5316864,19,1116
RN,FLORANIA,1,0,-1,-100.0,75,72,-3,-4.0,13,16,3,23.08,90,115,25,27.78,425,399,-26,-6.12,604,602,-2,-0.33,FLORANIA RN,-6.1268685,-36.8183238,19,1117
RN,FRANCISCO DANTAS,4,1,-3,-75.0,1,1,0,0.0,0,0,0,0.0,5,6,1,20.0,279,272,-7,-2.51,289,280,-9,-3.11,FRANCISCO DANTAS RN,-6.0873602,-38.1229256,19,1118
RN,FRUTUOSO GOMES,0,0,0,0.0,5,6,1,20.0,4,4,0,0.0,5,5,0,0.0,183,194,11,6.01,197,209,12,6.09,FRUTUOSO GOMES RN,-6.1585113,-37.8408614,19,1119
RN,GALINHOS,92,93,1,1.09,188,165,-23,-12.23,0,0,0,0.0,5,5,0,0.0,411,292,-119,-28.95,696,555,-141,-20.26,GALINHOS RN,-5.0923928,-36.2744827,19,1120
RN,GOIANINHA,501,299,-202,-40.32,363,396,33,9.09,46,117,71,154.35,767,829,62,8.08,1403,1352,-51,-3.64,3080,2993,-87,-2.82,GOIANINHA RN,-6.2663538,-35.2092447,19,1121
RN,GOVERNADOR DIX-SEPT ROSADO,469,478,9,1.92,76,77,1,1.32,18,20,2,11.11,98,105,7,7.14,652,427,-225,-34.51,1313,1107,-206,-15.69,GOVERNADOR DIX-SEPT ROSADO RN,-5.4577723,-37.5207493,19,1122
RN,GROSSOS,28,13,-15,-53.57,346,353,7,2.02,0,0,0,0.0,256,261,5,1.95,616,272,-344,-55.84,1246,899,-347,-27.85,GROSSOS RN,-4.9843455,-37.1511253,19,1123
RN,GUAMARE,83,86,3,3.61,346,266,-80,-23.12,65,13,-52,-80.0,294,309,15,5.1,1790,1650,-140,-7.82,2578,2324,-254,-9.85,GUAMARE RN,-5.1075611,-36.3195361,19,1124
RN,IELMO MARINHO,45,41,-4,-8.89,127,85,-42,-33.07,1,0,-1,-100.0,27,71,44,162.96,411,405,-6,-1.46,611,602,-9,-1.47,IELMO MARINHO RN,-5.8228157,-35.5527494,19,1125
RN,IPANGUACU,761,831,70,9.2,7,37,30,428.57,12,3,-9,-75.0,87,81,-6,-6.9,589,488,-101,-17.15,1456,1440,-16,-1.1,IPANGUACU RN,-5.5090713,-36.8594421,19,1126
RN,IPUEIRA,2,3,1,50.0,1,1,0,0.0,0,0,0,0.0,15,19,4,26.67,239,197,-42,-17.57,257,220,-37,-14.4,IPUEIRA RN,-6.8152805,-37.1984637,19,1127
RN,ITAJA,1,2,1,100.0,345,340,-5,-1.45,3,1,-2,-66.67,84,73,-11,-13.1,383,267,-116,-30.29,816,683,-133,-16.3,ITAJA RN,-5.6374673,-36.8713272,19,1128
RN,ITAU,0,0,0,0.0,4,4,0,0.0,0,0,0,0.0,41,41,0,0.0,303,216,-87,-28.71,348,261,-87,-25.0,ITAU RN,-5.8413626,-37.9913221,19,1129
RN,JACANA,0,0,0,0.0,1,1,0,0.0,6,6,0,0.0,48,44,-4,-8.33,359,304,-55,-15.32,414,355,-59,-14.25,JACANA RN,-6.4290483,-36.2035537,19,1130
RN,JANDAIRA,569,480,-89,-15.64,5,1,-4,-80.0,0,0,0,0.0,31,31,0,0.0,275,319,44,16.0,880,831,-49,-5.57,JANDAIRA RN,-5.3556267,-36.1279455,19,1131
RN,JANDUIS,1,1,0,0.0,9,8,-1,-11.11,373,338,-35,-9.38,36,29,-7,-19.44,292,192,-100,-34.25,711,568,-143,-20.11,JANDUIS RN,-6.0021573,-37.47407798950412,19,1132
RN,JANUARIO CICCO,2,0,-2,-100.0,3,4,1,33.33,0,0,0,0.0,40,37,-3,-7.5,323,221,-102,-31.58,368,262,-106,-28.8,JANUARIO CICCO RN,-6.158053,-35.602085,19,1133
RN,JAPI,0,0,0,0.0,0,1,1,0.0,0,0,0,0.0,9,11,2,22.22,314,209,-105,-33.44,323,221,-102,-31.58,JAPI RN,-6.4634348,-35.9456879,19,1134
RN,JARDIM DE ANGICOS,1,1,0,0.0,1,1,0,0.0,0,0,0,0.0,2,1,-1,-50.0,253,306,53,20.95,257,309,52,20.23,JARDIM DE ANGICOS RN,-5.6520662,-35.9699312,19,1135
RN,JARDIM DE PIRANHAS,1,0,-1,-100.0,406,359,-47,-11.58,0,5,5,0.0,195,185,-10,-5.13,884,655,-229,-25.9,1486,1204,-282,-18.98,JARDIM DE PIRANHAS RN,-6.3796347,-37.3495566,19,1136
RN,JARDIM DO SERIDO,5,5,0,0.0,691,576,-115,-16.64,11,9,-2,-18.18,256,255,-1,-0.39,593,545,-48,-8.09,1556,1390,-166,-10.67,JARDIM DO SERIDO RN,-6.59043,-36.7736039,19,1137
RN,JOAO CAMARA,10,13,3,30.0,440,466,26,5.91,26,84,58,223.08,867,874,7,0.81,1420,1396,-24,-1.69,2763,2833,70,2.53,JOAO CAMARA RN,-5.5349637,-35.8150811,19,1138
RN,JOAO DIAS,0,0,0,0.0,1,0,-1,-100.0,0,0,0,0.0,3,3,0,0.0,185,9,-176,-95.14,189,12,-177,-93.65,JOAO DIAS RN,-6.2754366,-37.7951805,19,1139
RN,JOSE DA PENHA,0,0,0,0.0,3,2,-1,-33.33,0,0,0,0.0,25,23,-2,-8.0,339,368,29,8.55,367,393,26,7.08,JOSE DA PENHA RN,-6.3188,-38.2853568,19,1140
RN,JUCURUTU,18,20,2,11.11,674,645,-29,-4.3,4,447,443,11075.0,310,297,-13,-4.19,932,1265,333,35.73,1938,2674,736,37.98,JUCURUTU RN,-6.0343518,-37.0186249,19,1141
RN,JUNDIA,1,1,0,0.0,3,3,0,0.0,14,2,-12,-85.71,2,2,0,0.0,283,147,-136,-48.06,303,155,-148,-48.84,JUNDIA RN,-6.2707116,-35.3279507,19,1142
RN,LAGOA DE PEDRAS,1,1,0,0.0,7,1,-6,-85.71,1,17,16,1600.0,23,29,6,26.09,337,315,-22,-6.53,369,363,-6,-1.63,LAGOA DE PEDRAS RN,-6.1527678,-35.4368516,19,1144
RN,LAGOA DE VELHOS,6,1,-5,-83.33,48,86,38,79.17,69,67,-2,-2.9,5,6,1,20.0,245,188,-57,-23.27,373,348,-25,-6.7,LAGOA DE VELHOS RN,-6.003043,-35.8710877,19,1145
RN,LAGOA NOVA,8,5,-3,-37.5,54,59,5,9.26,30,23,-7,-23.33,207,212,5,2.42,855,705,-150,-17.54,1154,1004,-150,-13.0,LAGOA NOVA RN,-6.0948803,-36.4704991,19,1146
RN,LAGOA SALGADA,45,31,-14,-31.11,25,8,-17,-68.0,0,0,0,0.0,55,45,-10,-18.18,558,479,-79,-14.16,683,563,-120,-17.57,LAGOA SALGADA RN,-6.122954,-35.472394,19,1147
RN,LAJES,19,21,2,10.53,66,67,1,1.52,2,10,8,400.0,135,128,-7,-5.19,760,534,-226,-29.74,982,760,-222,-22.61,LAJES RN,-5.7014079,-36.246219,19,1148
RN,LAJES PINTADAS,0,0,0,0.0,6,1,-5,-83.33,1,0,-1,-100.0,19,21,2,10.53,384,288,-96,-25.0,410,310,-100,-24.39,LAJES PINTADAS RN,-6.1497352,-36.1166085,19,1149
RN,LUCRECIA,0,0,0,0.0,17,14,-3,-17.65,66,47,-19,-28.79,22,18,-4,-18.18,201,142,-59,-29.35,306,221,-85,-27.78,LUCRECIA RN,-6.1172522,-37.8134573,19,1150
RN,LUIS GOMES,0,0,0,0.0,23,23,0,0.0,0,0,0,0.0,47,44,-3,-6.38,419,420,1,0.24,489,487,-2,-0.41,LUIS GOMES RN,-6.4141793,-38.3872939,19,1151
RN,MACAU,344,316,-28,-8.14,624,639,15,2.4,84,22,-62,-73.81,588,687,99,16.84,1531,1265,-266,-17.37,3171,2929,-242,-7.63,MACAU RN,-5.1133665,-36.6349957,19,1153
RN,MAJOR SALES,2,2,0,0.0,0,0,0,0.0,0,0,0,0.0,15,16,1,6.67,228,187,-41,-17.98,245,205,-40,-16.33,MAJOR SALES RN,-6.4063378,-38.3226605,19,1154
RN,MARCELINO VIEIRA,14,14,0,0.0,5,3,-2,-40.0,0,0,0,0.0,26,24,-2,-7.69,289,261,-28,-9.69,334,302,-32,-9.58,MARCELINO VIEIRA RN,-6.2938597,-38.1622228,19,1155
RN,MARTINS,2,2,0,0.0,51,17,-34,-66.67,6,6,0,0.0,145,152,7,4.83,532,368,-164,-30.83,736,545,-191,-25.95,MARTINS RN,-6.0892841,-37.9114676,19,1156
RN,MAXARANGUAPE,60,71,11,18.33,99,122,23,23.23,0,3,3,0.0,75,67,-8,-10.67,895,732,-163,-18.21,1129,995,-134,-11.87,MAXARANGUAPE RN,-5.5175989,-35.2585401,19,1157
RN,MESSIAS TARGINO,0,0,0,0.0,37,38,1,2.7,42,3,-39,-92.86,20,22,2,10.0,257,250,-7,-2.72,356,313,-43,-12.08,MESSIAS TARGINO RN,-6.0772948,-37.511712,19,1158
RN,MONTANHAS,1,1,0,0.0,13,13,0,0.0,0,1,1,0.0,163,178,15,9.2,475,540,65,13.68,652,733,81,12.42,MONTANHAS RN,-6.4866542,-35.2853577,19,1159
RN,MONTE ALEGRE,55,66,11,20.0,72,84,12,16.67,11,21,10,90.91,442,412,-30,-6.79,2655,2466,-189,-7.12,3235,3049,-186,-5.75,MONTE ALEGRE RN,-6.069901,-35.333635,19,1160
RN,MONTE DAS GAMELEIRAS,0,0,0,0.0,1,1,0,0.0,0,0,0,0.0,10,11,1,10.0,281,290,9,3.2,292,302,10,3.42,MONTE DAS GAMELEIRAS RN,-6.43975,-35.7851631,19,1161
RN,MOSSORO,3817,3647,-170,-4.45,8554,7933,-621,-7.26,4196,4197,1,0.02,14634,14844,210,1.44,28181,29210,1029,3.65,59382,59831,449,0.76,MOSSORO RN,-5.1904332,-37.3443872,19,1162
RN,NATAL,888,779,-109,-12.27,21053,20461,-592,-2.81,12952,12773,-179,-1.38,49147,46911,-2236,-4.55,209577,199947,-9630,-4.59,293617,280871,-12746,-4.34,NATAL RN,-5.8821365,-35.1722172,19,1163
RN,NOVA CRUZ,21,42,21,100.0,89,75,-14,-15.73,189,221,32,16.93,847,801,-46,-5.43,1693,1618,-75,-4.43,2839,2757,-82,-2.89,NOVA CRUZ RN,-6.482111,-35.4332326,19,1165
RN,OURO BRANCO,0,0,0,0.0,142,65,-77,-54.23,0,2,2,0.0,54,51,-3,-5.56,276,268,-8,-2.9,472,386,-86,-18.22,OURO BRANCO RN,-6.703294,-36.9429599,19,1167
RN,PARANA,116,106,-10,-8.62,34,34,0,0.0,18,11,-7,-38.89,94,102,8,8.51,459,42,-417,-90.85,721,295,-426,-59.08,PARANA RN,-6.4836791,-38.3117943,19,1168
RN,PARAU,2,2,0,0.0,2,4,2,100.0,4,7,3,75.0,27,19,-8,-29.63,277,183,-94,-33.94,312,215,-97,-31.09,PARAU RN,-5.7760443,-37.1012637,19,1169
RN,PARAZINHO,4,4,0,0.0,16,21,5,31.25,0,0,0,0.0,26,47,21,80.77,226,244,18,7.96,272,316,44,16.18,PARAZINHO RN,-5.22597,-35.8403865,19,1170
RN,PARELHAS,8,7,-1,-12.5,1550,1458,-92,-5.94,19,24,5,26.32,589,579,-10,-1.7,1197,1006,-191,-15.96,3363,3074,-289,-8.59,PARELHAS RN,-6.691369,-36.6584475,19,1171
RN,RIO DO FOGO,132,159,27,20.45,18,32,14,77.78,1,3,2,200.0,29,29,0,0.0,480,369,-111,-23.12,660,592,-68,-10.3,RIO DO FOGO RN,-5.2748534,-35.3825802,19,1172
RN,PASSAGEM,1,2,1,100.0,1,1,0,0.0,0,1,1,0.0,17,14,-3,-17.65,201,133,-68,-33.83,220,151,-69,-31.36,PASSAGEM RN,-6.2780162,-35.3768806,19,1174
RN,PATU,0,0,0,0.0,9,8,-1,-11.11,123,17,-106,-86.18,160,156,-4,-2.5,780,783,3,0.38,1072,964,-108,-10.07,PATU RN,-6.1006213,-37.6385148,19,1175
RN,SANTA MARIA,20,20,0,0.0,7,3,-4,-57.14,1,2,1,100.0,66,71,5,7.58,347,227,-120,-34.58,441,323,-118,-26.76,SANTA MARIA RN,-5.838022,-35.691409,19,1176
RN,PAU DOS FERROS,1,3,2,200.0,177,189,12,6.78,64,58,-6,-9.38,1559,1530,-29,-1.86,2150,2001,-149,-6.93,3951,3781,-170,-4.3,PAU DOS FERROS RN,-6.1124964,-38.2062628,19,1177
RN,PEDRA GRANDE,56,36,-20,-35.71,469,912,443,94.46,5,15,10,200.0,9,9,0,0.0,373,417,44,11.8,912,1389,477,52.3,PEDRA GRANDE RN,-5.1508135,-35.8784127,19,1178
RN,PEDRA PRETA,0,0,0,0.0,0,0,0,0.0,0,0,0,0.0,10,9,-1,-10.0,217,144,-73,-33.64,227,153,-74,-32.6,PEDRA PRETA RN,-5.5811667,-36.1044516,19,1179
RN,PEDRO AVELINO,15,9,-6,-40.0,4,3,-1,-25.0,0,0,0,0.0,22,21,-1,-4.55,476,394,-82,-17.23,517,427,-90,-17.41,PEDRO AVELINO RN,-5.5218651,-36.3850166,19,1180
RN,PEDRO VELHO,34,30,-4,-11.76,51,51,0,0.0,0,0,0,0.0,122,104,-18,-14.75,940,807,-133,-14.15,1147,992,-155,-13.51,PEDRO VELHO RN,-6.4356,-35.219539,19,1181
RN,PENDENCIAS,411,359,-52,-12.65,603,611,8,1.33,4,3,-1,-25.0,175,150,-25,-14.29,764,409,-355,-46.47,1957,1532,-425,-21.72,PENDENCIAS RN,-5.2572092,-36.7182487,19,1182
RN,PILOES,0,0,0,0.0,1,1,0,0.0,0,0,0,0.0,33,29,-4,-12.12,197,177,-20,-10.15,231,207,-24,-10.39,PILOES RN,-6.2685621,-38.0440115,19,1183
RN,POCO BRANCO,35,36,1,2.86,4,3,-1,-25.0,0,36,36,0.0,50,60,10,20.0,112,121,9,8.04,201,256,55,27.36,POCO BRANCO RN,-5.6224378,-35.6615774,19,1184
RN,PORTALEGRE,1,1,0,0.0,4,4,0,0.0,48,30,-18,-37.5,36,39,3,8.33,351,342,-9,-2.56,440,416,-24,-5.45,PORTALEGRE RN,-6.0265733,-37.9872478,19,1185
RN,PORTO DO MANGUE,68,86,18,26.47,217,236,19,8.76,0,0,0,0.0,31,30,-1,-3.23,426,358,-68,-15.96,742,710,-32,-4.31,PORTO DO MANGUE RN,-5.0672477,-36.7807779,19,1186
RN,PUREZA,105,72,-33,-31.43,3,18,15,500.0,0,4,4,0.0,40,39,-1,-2.5,495,516,21,4.24,643,649,6,0.93,PUREZA RN,-5.4672793,-35.5559115,19,1188
RN,RAFAEL FERNANDES,0,0,0,0.0,4,5,1,25.0,9,5,-4,-44.44,24,25,1,4.17,169,203,34,20.12,206,238,32,15.53,RAFAEL FERNANDES RN,-6.1892485,-38.2238647,19,1189
RN,RAFAEL GODEIRO,0,0,0,0.0,1,1,0,0.0,0,25,25,0.0,15,17,2,13.33,279,268,-11,-3.94,295,311,16,5.42,RAFAEL GODEIRO RN,-6.0757937,-37.7173064,19,1190
RN,RIACHO DA CRUZ,0,0,0,0.0,3,2,-1,-33.33,6,6,0,0.0,4,5,1,25.0,230,237,7,3.04,243,250,7,2.88,RIACHO DA CRUZ RN,-5.9373463,-37.9488019,19,1191
RN,RIACHO DE SANTANA,0,0,0,0.0,5,3,-2,-40.0,0,0,0,0.0,8,8,0,0.0,151,112,-39,-25.83,164,123,-41,-25.0,RIACHO DE SANTANA RN,-6.2633948,-38.3143424,19,1192
RN,RIACHUELO,0,0,0,0.0,10,12,2,20.0,0,10,10,0.0,56,69,13,23.21,310,272,-38,-12.26,376,363,-13,-3.46,RIACHUELO RN,-5.8121386,-35.8234357,19,1193
RN,RODOLFO FERNANDES,0,0,0,0.0,3,3,0,0.0,0,0,0,0.0,30,29,-1,-3.33,312,303,-9,-2.88,345,335,-10,-2.9,RODOLFO FERNANDES RN,-5.7897503,-38.0607459,19,1194
RN,TIBAU,10,42,32,320.0,34,58,24,70.59,4,1,-3,-75.0,130,164,34,26.15,586,295,-291,-49.66,764,560,-204,-26.7,TIBAU RN,-4.8349636,-37.2542651,19,1195
RN,RUY BARBOSA,0,0,0,0.0,2,2,0,0.0,0,0,0,0.0,3,4,1,33.33,268,244,-24,-8.96,273,250,-23,-8.42,RUY BARBOSA RN,-5.8812801,-35.934666,19,1196
RN,SANTA CRUZ,50,60,10,20.0,419,351,-68,-16.23,193,184,-9,-4.66,943,949,6,0.64,1851,1518,-333,-17.99,3456,3062,-394,-11.4,SANTA CRUZ RN,-6.224752,-36.019297,19,1197
RN,SANTANA DO MATOS,8,8,0,0.0,25,32,7,28.0,1,1,0,0.0,130,132,2,1.54,578,526,-52,-9.0,742,699,-43,-5.8,SANTANA DO MATOS RN,-5.9468972,-36.6502541,19,1198
RN,SANTANA DO SERIDO,3,2,-1,-33.33,153,192,39,25.49,2,4,2,100.0,16,20,4,25.0,214,192,-22,-10.28,388,410,22,5.67,SANTANA DO SERIDO RN,-6.7708992,-36.7340383,19,1199
RN,SAO BENTO DO TRAIRI,3,1,-2,-66.67,0,1,1,0.0,0,0,0,0.0,7,7,0,0.0,330,311,-19,-5.76,340,320,-20,-5.88,SAO BENTO DO TRAIRI RN,-6.3426719,-36.0851109,19,1202
RN,SAO FERNANDO,3,3,0,0.0,74,54,-20,-27.03,44,39,-5,-11.36,35,41,6,17.14,270,198,-72,-26.67,426,335,-91,-21.36,SAO FERNANDO RN,-6.379745,-37.186362,19,1203
RN,SAO FRANCISCO DO OESTE,0,0,0,0.0,135,130,-5,-3.7,3,0,-3,-100.0,77,8,-69,-89.61,246,166,-80,-32.52,461,304,-157,-34.06,SAO FRANCISCO DO OESTE RN,-5.9995802,-38.1679964,19,1204
RN,SAO JOAO DO SABUGI,0,7,7,0.0,6,5,-1,-16.67,1,0,-1,-100.0,65,66,1,1.54,285,258,-27,-9.47,357,336,-21,-5.88,SAO JOAO DO SABUGI RN,-6.7189116,-37.1998215,19,1206
RN,SAO JOSE DO CAMPESTRE,0,0,0,0.0,36,28,-8,-22.22,0,1,1,0.0,59,66,7,11.86,583,333,-250,-42.88,678,428,-250,-36.87,SAO JOSE DO CAMPESTRE RN,-6.3148531,-35.7128188,19,1208
RN,SAO JOSE DO SERIDO,0,0,0,0.0,562,594,32,5.69,6,5,-1,-16.67,84,77,-7,-8.33,291,231,-60,-20.62,943,907,-36,-3.82,SAO JOSE DO SERIDO RN,-6.4488139,-36.878528,19,1209
RN,SAO MIGUEL,11,11,0,0.0,19,24,5,26.32,13,19,6,46.15,366,458,92,25.14,814,712,-102,-12.53,1223,1224,1,0.08,SAO MIGUEL RN,-6.2121764,-38.4977377,19,1210
RN,SAO MIGUEL DO GOSTOSO,17,17,0,0.0,19,16,-3,-15.79,11,13,2,18.18,129,125,-4,-3.1,717,680,-37,-5.16,893,851,-42,-4.7,SAO MIGUEL DO GOSTOSO RN,-5.1230207,-35.6353882,19,1211
RN,SAO PAULO DO POTENGI,18,16,-2,-11.11,16,104,88,550.0,37,26,-11,-29.73,403,359,-44,-10.92,776,735,-41,-5.28,1250,1240,-10,-0.8,SAO PAULO DO POTENGI RN,-5.8941684,-35.7648309,19,1212
RN,SAO PEDRO,33,22,-11,-33.33,2,5,3,150.0,0,0,0,0.0,19,25,6,31.58,259,229,-30,-11.58,313,281,-32,-10.22,SAO PEDRO RN,-5.8965573,-35.6340558,19,1213
RN,SAO RAFAEL,5,4,-1,-20.0,10,13,3,30.0,0,0,0,0.0,50,44,-6,-12.0,395,392,-3,-0.76,460,453,-7,-1.52,SAO RAFAEL RN,-5.8022027,-36.8835945,19,1214
RN,SAO TOME,1,1,0,0.0,4,3,-1,-25.0,0,2,2,0.0,114,107,-7,-6.14,575,396,-179,-31.13,694,509,-185,-26.66,SAO TOME RN,-5.9726443,-36.0736804,19,1215
RN,SAO VICENTE,1,1,0,0.0,232,238,6,2.59,0,0,0,0.0,52,54,2,3.85,361,393,32,8.86,646,686,40,6.19,SAO VICENTE RN,-6.2166906,-36.6823094,19,1216
RN,SENADOR ELOI DE SOUZA,3,2,-1,-33.33,3,3,0,0.0,0,2,2,0.0,20,19,-1,-5.0,219,13,-206,-94.06,245,39,-206,-84.08,SENADOR ELOI DE SOUZA RN,-6.0357055,-35.6923151,19,1217
RN,SENADOR GEORGINO AVELINO,35,45,10,28.57,5,6,1,20.0,1,0,-1,-100.0,13,10,-3,-23.08,269,284,15,5.58,323,345,22,6.81,SENADOR GEORGINO AVELINO RN,-6.1632427,-35.1233332,19,1218
RN,SERRA DE SAO BENTO,1,1,0,0.0,34,24,-10,-29.41,0,0,0,0.0,63,73,10,15.87,287,202,-85,-29.62,385,300,-85,-22.08,SERRA DE SAO BENTO RN,-6.4169271,-35.70478,19,1219
RN,SERRA DO MEL,2,2,0,0.0,60,87,27,45.0,138,408,270,195.65,94,84,-10,-10.64,655,685,30,4.58,949,1266,317,33.4,SERRA DO MEL RN,-5.1681228,-37.0413693,19,1220
RN,SERRA NEGRA DO NORTE,11,11,0,0.0,468,401,-67,-14.32,2,0,-2,-100.0,82,80,-2,-2.44,329,251,-78,-23.71,892,743,-149,-16.7,SERRA NEGRA DO NORTE RN,-6.6627568,-37.4010583,19,1221
RN,SERRINHA DOS PINTOS,0,0,0,0.0,3,3,0,0.0,7,5,-2,-28.57,43,33,-10,-23.26,228,220,-8,-3.51,281,261,-20,-7.12,SERRINHA DOS PINTOS RN,-6.112315,-37.9566189,19,1223
RN,SEVERIANO MELO,0,0,0,0.0,39,46,7,17.95,0,0,0,0.0,25,11,-14,-56.0,373,458,85,22.79,437,515,78,17.85,SEVERIANO MELO RN,-5.7811362,-37.9576772,19,1224
RN,TABOLEIRO GRANDE,0,0,0,0.0,61,62,1,1.64,0,0,0,0.0,6,3,-3,-50.0,214,142,-72,-33.64,281,207,-74,-26.33,TABOLEIRO GRANDE RN,-5.9289208,-38.044508,19,1226
RN,TAIPU,79,62,-17,-21.52,153,147,-6,-3.92,0,3,3,0.0,68,62,-6,-8.82,448,199,-249,-55.58,748,473,-275,-36.76,TAIPU RN,-5.6228594,-35.5991764,19,1227
RN,TANGARA,14,21,7,50.0,169,187,18,10.65,0,1,1,0.0,211,218,7,3.32,658,607,-51,-7.75,1052,1034,-18,-1.71,TANGARA RN,-6.19649,-35.798888,19,1228
RN,TENENTE ANANIAS,2,0,-2,-100.0,81,106,25,30.86,2,2,0,0.0,80,86,6,7.5,321,299,-22,-6.85,486,493,7,1.44,TENENTE ANANIAS RN,-6.4641549,-38.1791844,19,1229
RN,TENENTE LAURENTINO CRUZ,1,0,-1,-100.0,10,9,-1,-10.0,0,2,2,0.0,83,96,13,15.66,424,317,-107,-25.24,518,424,-94,-18.15,TENENTE LAURENTINO CRUZ RN,-6.1498142,-36.7174889,19,1230
RN,TIBAU DO SUL,41,43,2,4.88,91,60,-31,-34.07,200,88,-112,-56.0,480,460,-20,-4.17,3119,2588,-531,-17.02,3931,3239,-692,-17.6,TIBAU DO SUL RN,-6.1872965,-35.0905246,19,1231
RN,TIMBAUBA DOS BATISTAS,7,2,-5,-71.43,11,8,-3,-27.27,0,0,0,0.0,30,30,0,0.0,246,132,-114,-46.34,294,172,-122,-41.5,TIMBAUBA DOS BATISTAS RN,-6.4634028,-37.2696374,19,1232
RN,TOUROS,431,432,1,0.23,75,65,-10,-13.33,18,25,7,38.89,360,407,47,13.06,1556,1153,-403,-25.9,2440,2082,-358,-14.67,TOUROS RN,-5.1998625,-35.4595051,19,1233
RN,TRIUNFO POTIGUAR,2,2,0,0.0,6,4,-2,-33.33,0,0,0,0.0,1,1,0,0.0,232,208,-24,-10.34,241,215,-26,-10.79,TRIUNFO POTIGUAR RN,-5.866913,-37.1857379,19,1234
RN,UMARIZAL,0,0,0,0.0,19,16,-3,-15.79,30,2,-28,-93.33,164,162,-2,-1.22,527,400,-127,-24.1,740,580,-160,-21.62,UMARIZAL RN,-5.9855161,-37.8185889,19,1235
RN,UPANEMA,511,522,11,2.15,43,45,2,4.65,13,40,27,207.69,81,83,2,2.47,589,489,-100,-16.98,1237,1179,-58,-4.69,UPANEMA RN,-5.6431701,-37.2625341,19,1236
RN,VARZEA,6,7,1,16.67,3,3,0,0.0,0,0,0,0.0,39,39,0,0.0,310,322,12,3.87,358,371,13,3.63,VARZEA RN,-6.346412,-35.373182,19,1237
RN,VENHA-VER,0,0,0,0.0,0,0,0,0.0,0,1,1,0.0,7,8,1,14.29,298,219,-79,-26.51,305,228,-77,-25.25,VENHA-VER RN,-6.3205332,-38.4898965,19,1238
RN,VERA CRUZ,53,54,1,1.89,94,55,-39,-41.49,5,6,1,20.0,112,100,-12,-10.71,417,388,-29,-6.95,681,603,-78,-11.45,VERA CRUZ RN,-6.0493346,-35.4311152,19,1239
RN,VICOSA,0,4,4,0.0,1,1,0,0.0,0,0,0,0.0,2,2,0,0.0,153,106,-47,-30.72,156,113,-43,-27.56,VICOSA RN,-5.9919509,-37.945439,19,1240
RN,VILA FLOR,44,20,-24,-54.55,1,1,0,0.0,5,3,-2,-40.0,15,11,-4,-26.67,245,84,-161,-65.71,310,119,-191,-61.61,VILA FLOR RN,-6.3156226,-35.0757697,19,1241
PB,AGUA BRANCA,4,5,1,25.0,87,105,18,20.69,30,18,-12,-40.0,702,770,68,9.69,633,460,-173,-27.33,1456,1358,-98,-6.73,AGUA BRANCA PB,-7.5151046,-37.6394034,14,1242
PB,AGUIAR,0,0,0,0.0,33,40,7,21.21,6,2,-4,-66.67,13,11,-2,-15.38,327,160,-167,-51.07,379,213,-166,-43.8,AGUIAR PB,-7.0928404,-38.1727215,14,1243
PB,ALAGOA GRANDE,51,47,-4,-7.84,76,94,18,23.68,7,1,-6,-85.71,296,314,18,6.08,1568,1551,-17,-1.08,1998,2007,9,0.45,ALAGOA GRANDE PB,-7.0415212,-35.6285322,14,1244
PB,ALAGOA NOVA,398,499,101,25.38,971,929,-42,-4.33,1,1,0,0.0,149,149,0,0.0,766,795,29,3.79,2285,2373,88,3.85,ALAGOA NOVA PB,-7.0653703,-35.76695977336711,14,1245
PB,ALAGOINHA,34,31,-3,-8.82,20,18,-2,-10.0,2,2,0,0.0,83,84,1,1.2,703,725,22,3.13,842,860,18,2.14,ALAGOINHA PB,-6.97063215,-35.51490901897793,14,1246
PB,ALCANTIL,0,0,0,0.0,48,52,4,8.33,0,1,1,0.0,11,17,6,54.55,372,382,10,2.69,431,452,21,4.87,ALCANTIL PB,-7.7425491,-36.0609604,14,1247
PB,ALGODAO DE JANDAIRA,1,0,-1,-100.0,25,6,-19,-76.0,0,0,0,0.0,1,18,17,1700.0,352,4,-348,-98.86,379,28,-351,-92.61,ALGODAO DE JANDAIRA PB,-6.9040175,-36.0089879,14,1248
PB,ALHANDRA,343,368,25,7.29,671,683,12,1.79,321,33,-288,-89.72,1222,1001,-221,-18.09,1634,2472,838,51.29,4191,4557,366,8.73,ALHANDRA PB,-7.4304246,-34.9106103,14,1249
PB,SAO JOAO DO RIO DO PEIXE,14,19,5,35.71,64,69,5,7.81,20,19,-1,-5.0,347,367,20,5.76,884,697,-187,-21.15,1329,1171,-158,-11.89,SAO JOAO DO RIO DO PEIXE PB,-6.7291053,-38.4478745,14,1250
PB,AMPARO,1,1,0,0.0,0,0,0,0.0,3,4,1,33.33,12,11,-1,-8.33,316,314,-2,-0.63,332,330,-2,-0.6,AMPARO PB,-7.56394725,-37.04652873235175,14,1251
PB,APARECIDA,17,7,-10,-58.82,26,49,23,88.46,0,0,0,0.0,108,116,8,7.41,344,297,-47,-13.66,495,469,-26,-5.25,APARECIDA PB,-6.7859598,-38.0831353,14,1252
PB,ARACAGI,21,13,-8,-38.1,53,39,-14,-26.42,2,2,0,0.0,64,77,13,20.31,846,641,-205,-24.23,986,772,-214,-21.7,ARACAGI PB,-6.8519969,-35.3835602,14,1253
PB,ARARA,0,0,0,0.0,12,10,-2,-16.67,0,0,0,0.0,121,121,0,0.0,565,598,33,5.84,698,729,31,4.44,ARARA PB,-6.8271895,-35.7605703,14,1254
PB,ARARUNA,8,8,0,0.0,21,31,10,47.62,4,8,4,100.0,147,150,3,2.04,1104,876,-228,-20.65,1284,1073,-211,-16.43,ARARUNA PB,-6.5321155,-35.7397595,14,1255
PB,AREIA,179,169,-10,-5.59,115,110,-5,-4.35,28,42,14,50.0,230,251,21,9.13,1093,773,-320,-29.28,1645,1345,-300,-18.24,AREIA PB,-6.9680243,-35.6994783,14,1256
PB,AREIA DE BARAUNAS,0,0,0,0.0,0,0,0,0.0,0,0,0,0.0,0,1,1,0.0,254,184,-70,-27.56,254,185,-69,-27.17,AREIA DE BARAUNAS PB,-7.1233949,-36.9446216,14,1257
PB,AREIAL,0,0,0,0.0,3,4,1,33.33,0,1,1,0.0,46,40,-6,-13.04,435,337,-98,-22.53,484,382,-102,-21.07,AREIAL PB,-7.0501306,-35.9245244,14,1258
PB,AROEIRAS,0,31,31,0.0,26,13,-13,-50.0,0,0,0,0.0,164,159,-5,-3.05,955,1001,46,4.82,1145,1204,59,5.15,AROEIRAS PB,-7.5462904,-35.7080002,14,1259
PB,ASSUNCAO,0,0,0,0.0,34,43,9,26.47,0,0,0,0.0,17,19,2,11.76,291,288,-3,-1.03,342,350,8,2.34,ASSUNCAO PB,-7.073396,-36.7274003,14,1260
PB,BAIA DA TRAICAO,0,0,0,0.0,0,0,0,0.0,0,0,0,0.0,55,60,5,9.09,447,190,-257,-57.49,502,250,-252,-50.2,BAIA DA TRAICAO PB,-6.65659055,-34.994967358333334,14,1261
PB,BARAUNA,1698,1754,56,3.3,497,629,132,26.56,88,99,11,12.5,435,461,26,5.98,1322,1158,-164,-12.41,4040,4101,61,1.51,BARAUNA PB,-6.643394,-36.2531932,14,1263
PB,BARRA DE SANTANA,2,2,0,0.0,6,7,1,16.67,0,0,0,0.0,19,19,0,0.0,566,558,-8,-1.41,593,586,-7,-1.18,BARRA DE SANTANA PB,-7.5230865,-35.9988518,14,1264
PB,BARRA DE SANTA ROSA,1,0,-1,-100.0,16,28,12,75.0,21,45,24,114.29,100,91,-9,-9.0,547,501,-46,-8.41,685,665,-20,-2.92,BARRA DE SANTA ROSA PB,-6.7218007,-36.0564638,14,1265
PB,BARRA DE SAO MIGUEL,3,5,2,66.67,5,4,-1,-20.0,3,1,-2,-66.67,27,28,1,3.7,309,270,-39,-12.62,347,308,-39,-11.24,BARRA DE SAO MIGUEL PB,-7.7528088,-36.3170996,14,1266
PB,BELEM,1025,1154,129,12.59,13666,14500,834,6.1,20521,21597,1076,5.24,63094,64490,1396,2.21,298393,296973,-1420,-0.48,396699,398714,2015,0.51,BELEM PB,-6.6967586,-35.5369626,14,1268
PB,BELEM DO BREJO DO CRUZ,0,0,0,0.0,59,73,14,23.73,0,2,2,0.0,18,12,-6,-33.33,425,419,-6,-1.41,502,506,4,0.8,BELEM DO BREJO DO CRUZ PB,-6.1880727,-37.5332267,14,1269
PB,BERNARDINO BATISTA,0,0,0,0.0,0,0,0,0.0,39,121,82,210.26,12,12,0,0.0,308,248,-60,-19.48,359,381,22,6.13,BERNARDINO BATISTA PB,-6.4532173,-38.5495418,14,1270
PB,BOA VENTURA,6,6,0,0.0,0,0,0,0.0,0,0,0,0.0,12,10,-2,-16.67,318,169,-149,-46.86,336,185,-151,-44.94,BOA VENTURA PB,-7.4202462,-38.2156782,14,1271
PB,BOA VISTA,481,530,49,10.19,3069,3344,275,8.96,3448,4850,1402,40.66,17771,18253,482,2.71,64336,64017,-319,-0.5,89105,90994,1889,2.12,BOA VISTA PB,-7.2620711,-36.2415161,14,1272
PB,BOM JESUS,438,424,-14,-3.2,117,144,27,23.08,60,53,-7,-11.67,1206,1243,37,3.07,1703,1381,-322,-18.91,3524,3245,-279,-7.92,BOM JESUS PB,-6.69453115,-38.43565255115294,14,1273
PB,BOM SUCESSO,0,1,1,0.0,0,0,0,0.0,0,3,3,0.0,8,9,1,12.5,353,386,33,9.35,361,399,38,10.53,BOM SUCESSO PB,-6.4458948,-37.9297662,14,1274
PB,BONITO DE SANTA FE,1,1,0,0.0,7,5,-2,-28.57,3,3,0,0.0,20,22,2,10.0,602,376,-226,-37.54,633,407,-226,-35.7,BONITO DE SANTA FE PB,-7.3143332,-38.5146677,14,1275
PB,BOQUEIRAO,5,8,3,60.0,55,57,2,3.64,31,23,-8,-25.81,206,217,11,5.34,937,773,-164,-17.5,1234,1078,-156,-12.64,BOQUEIRAO PB,-7.487004,-36.130887,14,1276
PB,IGARACY,0,0,0,0.0,27,30,3,11.11,4,1,-3,-75.0,10,11,1,10.0,63,371,308,488.89,104,413,309,297.12,IGARACY PB,-7.1819802,-38.1487395,14,1277
PB,BORBOREMA,6,2,-4,-66.67,0,0,0,0.0,9,10,1,11.11,8,4,-4,-50.0,276,300,24,8.7,299,316,17,5.69,BORBOREMA PB,-6.8066718,-35.5990191,14,1278
PB,BREJO DO CRUZ,1,1,0,0.0,45,37,-8,-17.78,5,4,-1,-20.0,63,60,-3,-4.76,625,665,40,6.4,739,767,28,3.79,BREJO DO CRUZ PB,-6.330942,-37.488316626886096,14,1279
PB,BREJO DOS SANTOS,0,0,0,0.0,7,2,-5,-71.43,0,0,0,0.0,21,17,-4,-19.05,341,355,14,4.11,369,374,5,1.36,BREJO DOS SANTOS PB,-6.3769367,-37.8243125,14,1280
PB,CAAPORA,120,112,-8,-6.67,2100,2370,270,12.86,6,255,249,4150.0,253,308,55,21.74,1730,1333,-397,-22.95,4209,4378,169,4.02,CAAPORA PB,-7.510234,-34.9154114,14,1281
PB,CABACEIRAS,4,7,3,75.0,6,19,13,216.67,0,1,1,0.0,33,33,0,0.0,312,197,-115,-36.86,355,257,-98,-27.61,CABACEIRAS PB,-7.4899156,-36.2860501,14,1282
PB,CACHOEIRA DOS INDIOS,4,4,0,0.0,1,1,0,0.0,0,0,0,0.0,120,114,-6,-5.0,380,346,-34,-8.95,505,465,-40,-7.92,CACHOEIRA DOS INDIOS PB,-6.9259193,-38.6742159,14,1284
PB,CACIMBA DE AREIA,0,0,0,0.0,1,0,-1,-100.0,4,8,4,100.0,11,11,0,0.0,324,207,-117,-36.11,340,226,-114,-33.53,CACIMBA DE AREIA PB,-7.1288513,-37.1575194,14,1285
PB,CACIMBA DE DENTRO,1,3,2,200.0,10,13,3,30.0,2,2,0,0.0,81,75,-6,-7.41,655,733,78,11.91,749,826,77,10.28,CACIMBA DE DENTRO PB,-6.6425101,-35.7929304,14,1286
PB,CACIMBAS,0,0,0,0.0,0,0,0,0.0,4,6,2,50.0,13,12,-1,-7.69,434,385,-49,-11.29,451,403,-48,-10.64,CACIMBAS PB,-7.2125451,-37.0593398,14,1287
PB,CAJAZEIRAS,22,18,-4,-18.18,749,796,47,6.28,395,315,-80,-20.25,2924,2759,-165,-5.64,4075,3757,-318,-7.8,8165,7645,-520,-6.37,CAJAZEIRAS PB,-6.8897849,-38.5570389,14,1289
PB,CAJAZEIRINHAS,0,1,1,0.0,0,0,0,0.0,3,0,-3,-100.0,2,2,0,0.0,235,259,24,10.21,240,262,22,9.17,CAJAZEIRINHAS PB,-6.961442,-37.7993733,14,1290
PB,CALDAS BRANDAO,10,5,-5,-50.0,97,103,6,6.19,0,0,0,0.0,62,55,-7,-11.29,416,438,22,5.29,585,601,16,2.74,CALDAS BRANDAO PB,-7.1027959,-35.3254676,14,1291
PB,CAMALAU,2,2,0,0.0,4,5,1,25.0,0,0,0,0.0,43,38,-5,-11.63,375,373,-2,-0.53,424,418,-6,-1.42,CAMALAU PB,-7.885031,-36.824191,14,1292
PB,CAMPINA GRANDE,217,204,-13,-5.99,17299,19259,1960,11.33,4930,4238,-692,-14.04,19593,19355,-238,-1.21,57311,63283,5972,10.42,99350,106339,6989,7.03,CAMPINA GRANDE PB,-7.2246743,-35.8771292,14,1293
PB,CAPIM,25,2,-23,-92.0,0,0,0,0.0,0,0,0,0.0,35,35,0,0.0,465,367,-98,-21.08,525,404,-121,-23.05,CAPIM PB,-6.9174091,-35.1720326,14,1294
PB,CARAUBAS,156,113,-43,-27.56,124,137,13,10.48,319,316,-3,-0.94,321,312,-9,-2.8,1052,470,-582,-55.32,1972,1348,-624,-31.64,CARAUBAS PB,-7.7273231,-36.4923357,14,1295
PB,CARRAPATEIRA,0,0,0,0.0,0,0,0,0.0,0,0,0,0.0,1,1,0,0.0,238,238,0,0.0,239,239,0,0.0,CARRAPATEIRA PB,-7.0395225,-38.3432281,14,1296
PB,CASSERENGUE,2,0,-2,-100.0,30,24,-6,-20.0,0,0,0,0.0,18,25,7,38.89,372,293,-79,-21.24,422,342,-80,-18.96,CASSERENGUE PB,-6.779538,-35.817875,14,1297
PB,CATINGUEIRA,1,1,0,0.0,0,0,0,0.0,32,8,-24,-75.0,23,25,2,8.7,357,311,-46,-12.89,413,345,-68,-16.46,CATINGUEIRA PB,-7.120081,-37.60638,14,1298
PB,CATOLE DO ROCHA,4,4,0,0.0,781,868,87,11.14,15,22,7,46.67,624,593,-31,-4.97,1890,1932,42,2.22,3314,3419,105,3.17,CATOLE DO ROCHA PB,-6.340625,-37.746967,14,1299
PB,CATURITE,10,9,-1,-10.0,49,51,2,4.08,10,10,0,0.0,24,18,-6,-25.0,328,335,7,2.13,421,423,2,0.48,CATURITE PB,-7.4199652,-36.0207132,14,1300
PB,CONCEICAO,0,0,0,0.0,17,15,-2,-11.76,24,29,5,20.83,161,154,-7,-4.35,1013,789,-224,-22.11,1215,987,-228,-18.77,CONCEICAO PB,-7.5565059,-38.5053706,14,1301
PB,CONDADO,8,7,-1,-12.5,7,7,0,0.0,0,0,0,0.0,18,18,0,0.0,334,276,-58,-17.37,367,308,-59,-16.08,CONDADO PB,-6.9092101,-37.5966375,14,1302
PB,CONGO,0,0,0,0.0,42,45,3,7.14,0,0,0,0.0,30,32,2,6.67,310,190,-120,-38.71,382,267,-115,-30.1,CONGO PB,-7.80963435,-36.641233278035656,14,1304
PB,COREMAS,0,0,0,0.0,24,18,-6,-25.0,64,26,-38,-59.38,112,98,-14,-12.5,417,312,-105,-25.18,617,454,-163,-26.42,COREMAS PB,-7.0175897,-37.9465062,14,1305
PB,COXIXOLA,11,11,0,0.0,1,1,0,0.0,0,0,0,0.0,10,11,1,10.0,149,99,-50,-33.56,171,122,-49,-28.65,COXIXOLA PB,-7.6272915,-36.606013,14,1306
PB,CRUZ DO ESPIRITO SANTO,273,266,-7,-2.56,172,175,3,1.74,28,79,51,182.14,53,63,10,18.87,789,807,18,2.28,1315,1390,75,5.7,CRUZ DO ESPIRITO SANTO PB,-7.139022,-35.085721,14,1307
PB,CUBATI,0,0,0,0.0,6,6,0,0.0,0,0,0,0.0,31,30,-1,-3.23,437,477,40,9.15,474,513,39,8.23,CUBATI PB,-6.8647974,-36.3525993,14,1308
PB,CUITEGI,25,27,2,8.0,82,50,-32,-39.02,2,0,-2,-100.0,45,42,-3,-6.67,443,269,-174,-39.28,597,388,-209,-35.01,CUITEGI PB,-6.8962776,-35.5228851,14,1310
PB,CUITE DE MAMANGUAPE,133,117,-16,-12.03,0,0,0,0.0,0,2,2,0.0,14,18,4,28.57,351,257,-94,-26.78,498,394,-104,-20.88,CUITE DE MAMANGUAPE PB,-6.912922,-35.250219,14,1311
PB,CURRAL DE CIMA,28,24,-4,-14.29,1,1,0,0.0,0,0,0,0.0,7,7,0,0.0,364,351,-13,-3.57,400,383,-17,-4.25,CURRAL DE CIMA PB,-6.7174163,-35.266704,14,1312
PB,CURRAL VELHO,1,1,0,0.0,1,1,0,0.0,0,0,0,0.0,0,0,0,0.0,113,148,35,30.97,115,150,35,30.43,CURRAL VELHO PB,-7.5376473,-38.1979125,14,1313
PB,DAMIAO,0,0,0,0.0,0,0,0,0.0,0,0,0,0.0,11,12,1,9.09,332,299,-33,-9.94,343,311,-32,-9.33,DAMIAO PB,-6.64317595,-35.933835193092264,14,1314
PB,DESTERRO,1,1,0,0.0,1,1,0,0.0,1,5,4,400.0,41,33,-8,-19.51,392,381,-11,-2.81,436,421,-15,-3.44,DESTERRO PB,-7.2889695,-37.0880761,14,1315
PB,VISTA SERRANA,0,0,0,0.0,0,0,0,0.0,0,0,0,0.0,16,16,0,0.0,287,259,-28,-9.76,303,275,-28,-9.24,VISTA SERRANA PB,-6.7391662,-37.5685755,14,1316
PB,DIAMANTE,2,2,0,0.0,2,4,2,100.0,0,0,0,0.0,32,24,-8,-25.0,407,350,-57,-14.0,443,380,-63,-14.22,DIAMANTE PB,-7.4261827,-38.2646879,14,1317
PB,DONA INES,1,1,0,0.0,25,26,1,4.0,0,0,0,0.0,42,41,-1,-2.38,422,318,-104,-24.64,490,386,-104,-21.22,DONA INES PB,-6.6032239,-35.627146,14,1318
PB,EMAS,0,0,0,0.0,0,0,0,0.0,0,0,0,0.0,6,5,-1,-16.67,328,240,-88,-26.83,334,245,-89,-26.65,EMAS PB,-7.1071447,-37.7155578,14,1320
PB,ESPERANCA,10,52,42,420.0,249,245,-4,-1.61,17,17,0,0.0,1688,1776,88,5.21,1544,1382,-162,-10.49,3508,3472,-36,-1.03,ESPERANCA PB,-7.018517,-35.852193,14,1321
PB,FAGUNDES,6,6,0,0.0,8,8,0,0.0,2,8,6,300.0,69,86,17,24.64,495,405,-90,-18.18,580,513,-67,-11.55,FAGUNDES PB,-7.3577473,-35.7839735,14,1322
PB,FREI MARTINHO,0,0,0,0.0,2,4,2,100.0,2,2,0,0.0,16,19,3,18.75,240,220,-20,-8.33,260,245,-15,-5.77,FREI MARTINHO PB,-6.4033643,-36.4535139,14,1323
PB,GADO BRAVO,0,0,0,0.0,0,0,0,0.0,0,0,0,0.0,14,12,-2,-14.29,436,441,5,1.15,450,453,3,0.67,GADO BRAVO PB,-7.5830516,-35.7914371,14,1324
PB,GUARABIRA,653,644,-9,-1.38,3103,3017,-86,-2.77,119,104,-15,-12.61,2305,2107,-198,-8.59,3530,3263,-267,-7.56,9710,9135,-575,-5.92,GUARABIRA PB,-6.8513982,-35.4915582,14,1325
PB,GURINHEM,76,70,-6,-7.89,28,27,-1,-3.57,2,38,36,1800.0,82,85,3,3.66,788,115,-673,-85.41,976,335,-641,-65.68,GURINHEM PB,-7.1244757,-35.424854,14,1326
PB,GURJAO,0,0,0,0.0,22,26,4,18.18,0,4,4,0.0,16,12,-4,-25.0,294,310,16,5.44,332,352,20,6.02,GURJAO PB,-7.2470565,-36.4862714,14,1327
PB,IBIARA,0,0,0,0.0,3,7,4,133.33,0,0,0,0.0,27,26,-1,-3.7,332,197,-135,-40.66,362,230,-132,-36.46,IBIARA PB,-7.4997862,-38.4034987,14,1328
PB,IMACULADA,1,1,0,0.0,0,0,0,0.0,0,0,0,0.0,27,31,4,14.81,470,325,-145,-30.85,498,357,-141,-28.31,IMACULADA PB,-7.3871724,-37.5116814,14,1329
PB,INGA,41,37,-4,-9.76,285,295,10,3.51,0,1,1,0.0,150,141,-9,-6.0,1467,684,-783,-53.37,1943,1158,-785,-40.4,INGA PB,-7.2904513,-35.6109945,14,1330
PB,ITABAIANA,57,43,-14,-24.56,54,77,23,42.59,4,2,-2,-50.0,567,517,-50,-8.82,1061,1334,273,25.73,1743,1973,230,13.2,ITABAIANA PB,-7.331674,-35.331723,14,1331
PB,ITAPORANGA,4,5,1,25.0,778,850,72,9.25,17,17,0,0.0,481,449,-32,-6.65,1170,1110,-60,-5.13,2450,2431,-19,-0.78,ITAPORANGA PB,-7.3040747,-38.1505782,14,1332
PB,ITAPOROROCA,246,249,3,1.22,20,26,6,30.0,6,4,-2,-33.33,156,169,13,8.33,848,902,54,6.37,1276,1350,74,5.8,ITAPOROROCA PB,-6.8283007,-35.244782,14,1333
PB,ITATUBA,24,22,-2,-8.33,247,297,50,20.24,1,0,-1,-100.0,82,80,-2,-2.44,477,224,-253,-53.04,831,623,-208,-25.03,ITATUBA PB,-7.3758509,-35.626495,14,1334
PB,JACARAU,24,20,-4,-16.67,42,46,4,9.52,9,7,-2,-22.22,102,98,-4,-3.92,935,953,18,1.93,1112,1124,12,1.08,JACARAU PB,-6.6123046,-35.2919016,14,1335
PB,JERICO,1,1,0,0.0,18,11,-7,-38.89,0,0,0,0.0,49,41,-8,-16.33,494,337,-157,-31.78,562,390,-172,-30.6,JERICO PB,-6.5531817,-37.8078194,14,1336
PB,JOAO PESSOA,518,601,83,16.02,15429,14672,-757,-4.91,16871,22579,5708,33.83,39742,39169,-573,-1.44,196832,191505,-5327,-2.71,269392,268526,-866,-0.32,JOAO PESSOA PB,-7.1215981,-34.882028,14,1337
PB,JUAREZ TAVORA,2,2,0,0.0,10,9,-1,-10.0,0,0,0,0.0,36,51,15,41.67,391,457,66,16.88,439,519,80,18.22,JUAREZ TAVORA PB,-7.1726926,-35.590804,14,1338
PB,JUAZEIRINHO,1,1,0,0.0,67,74,7,10.45,5,6,1,20.0,197,202,5,2.54,1149,1167,18,1.57,1419,1450,31,2.18,JUAZEIRINHO PB,-7.0688282,-36.5803059,14,1339
PB,JUNCO DO SERIDO,0,0,0,0.0,145,145,0,0.0,2,10,8,400.0,72,75,3,4.17,393,232,-161,-40.97,612,462,-150,-24.51,JUNCO DO SERIDO PB,-6.991929,-36.7137661,14,1340
PB,JURU,0,0,0,0.0,1,1,0,0.0,0,0,0,0.0,17,13,-4,-23.53,467,336,-131,-28.05,485,350,-135,-27.84,JURU PB,-7.5375089,-37.8192275,14,1342
PB,LAGOA,0,0,0,0.0,11,2,-9,-81.82,0,0,0,0.0,15,16,1,6.67,359,227,-132,-36.77,385,245,-140,-36.36,LAGOA PB,-6.5899848,-37.9149013,14,1343
PB,LAGOA DE DENTRO,5,7,2,40.0,0,0,0,0.0,0,2,2,0.0,43,42,-1,-2.33,570,553,-17,-2.98,618,604,-14,-2.27,LAGOA DE DENTRO PB,-6.6806695000000005,-35.36381400452393,14,1344
PB,LASTRO,0,0,0,0.0,3,0,-3,-100.0,0,0,0,0.0,2,1,-1,-50.0,198,158,-40,-20.2,203,159,-44,-21.67,LASTRO PB,-6.5175135,-38.1787636,14,1346
PB,LIVRAMENTO,0,0,0,0.0,2,2,0,0.0,0,0,0,0.0,35,31,-4,-11.43,452,439,-13,-2.88,489,472,-17,-3.48,LIVRAMENTO PB,-7.3757441,-36.9449444,14,1347
PB,MALTA,1,3,2,200.0,71,59,-12,-16.9,0,3,3,0.0,13,15,2,15.38,333,224,-109,-32.73,418,304,-114,-27.27,MALTA PB,-6.9068159,-37.5217101,14,1351
PB,MANAIRA,0,0,0,0.0,0,0,0,0.0,2,13,11,550.0,19,21,2,10.53,517,508,-9,-1.74,538,542,4,0.74,MANAIRA PB,-7.7060905,-38.1531251,14,1353
PB,MARCACAO,19,14,-5,-26.32,1,1,0,0.0,0,0,0,0.0,16,18,2,12.5,469,359,-110,-23.45,505,392,-113,-22.38,MARCACAO PB,-6.7704107,-35.0121479,14,1354
PB,MARI,30,26,-4,-13.33,45,33,-12,-26.67,70,3,-67,-95.71,203,199,-4,-1.97,1129,1079,-50,-4.43,1477,1340,-137,-9.28,MARI PB,-7.0580611,-35.3184163,14,1355
PB,MARIZOPOLIS,0,0,0,0.0,0,0,0,0.0,0,0,0,0.0,52,47,-5,-9.62,399,232,-167,-41.85,451,279,-172,-38.14,MARIZOPOLIS PB,-6.8440704,-38.3473088,14,1356
PB,MATARACA,473,545,72,15.22,172,102,-70,-40.7,2,0,-2,-100.0,100,78,-22,-22.0,630,436,-194,-30.79,1377,1161,-216,-15.69,MATARACA PB,-6.59673,-35.05308,14,1358
PB,MATINHAS,1,1,0,0.0,0,0,0,0.0,0,0,0,0.0,8,9,1,12.5,318,299,-19,-5.97,327,309,-18,-5.5,MATINHAS PB,-7.1219554,-35.7713426,14,1359
PB,MATO GROSSO,0,0,0,0.0,0,2,2,0.0,0,0,0,0.0,6,6,0,0.0,218,145,-73,-33.49,224,153,-71,-31.7,MATO GROSSO PB,-6.5433859,-37.7146519,14,1360
PB,MATUREIA,0,1,1,0.0,0,0,0,0.0,0,0,0,0.0,27,28,1,3.7,292,287,-5,-1.71,319,316,-3,-0.94,MATUREIA PB,-7.264629,-37.3383363,14,1361
PB,MOGEIRO,43,51,8,18.6,471,463,-8,-1.7,2,6,4,200.0,70,78,8,11.43,591,463,-128,-21.66,1177,1061,-116,-9.86,MOGEIRO PB,-7.3019003,-35.4782749,14,1362
PB,MONTADAS,157,176,19,12.1,0,0,0,0.0,0,0,0,0.0,26,23,-3,-11.54,9,268,259,2877.78,192,467,275,143.23,MONTADAS PB,-7.088656,-35.9577367,14,1363
PB,MONTE HOREBE,0,0,0,0.0,0,0,0,0.0,0,0,0,0.0,7,6,-1,-14.29,197,214,17,8.63,204,220,16,7.84,MONTE HOREBE PB,-7.214284,-38.5857578,14,1364
PB,MONTEIRO,10,8,-2,-20.0,122,125,3,2.46,128,130,2,1.56,690,638,-52,-7.54,1819,1773,-46,-2.53,2769,2674,-95,-3.43,MONTEIRO PB,-7.8920179,-37.1232051,14,1365
PB,MULUNGU,29,28,-1,-3.45,0,2,2,0.0,2,11,9,450.0,56,61,5,8.93,784,875,91,11.61,871,977,106,12.17,MULUNGU PB,-7.0309389,-35.4646079,14,1366
PB,NATUBA,2,2,0,0.0,5,3,-2,-40.0,0,0,0,0.0,33,29,-4,-12.12,674,345,-329,-48.81,714,379,-335,-46.92,NATUBA PB,-7.6410756,-35.5542731,14,1367
PB,NAZAREZINHO,0,0,0,0.0,1,1,0,0.0,0,0,0,0.0,26,27,1,3.85,363,283,-80,-22.04,390,311,-79,-20.26,NAZAREZINHO PB,-6.9156749,-38.3251082,14,1368
PB,NOVA OLINDA,90,81,-9,-10.0,626,639,13,2.08,3,1,-2,-66.67,255,235,-20,-7.84,358,319,-39,-10.89,1332,1275,-57,-4.28,NOVA OLINDA PB,-7.4782417,-38.0404379,14,1370
PB,NOVA PALMEIRA,0,0,0,0.0,23,16,-7,-30.43,0,6,6,0.0,19,17,-2,-10.53,344,335,-9,-2.62,386,374,-12,-3.11,NOVA PALMEIRA PB,-6.6795042,-36.4187275,14,1371
PB,OLIVEDOS,0,0,0,0.0,2,1,-1,-50.0,0,5,5,0.0,14,15,1,7.14,218,181,-37,-16.97,234,202,-32,-13.68,OLIVEDOS PB,-6.991036,-36.2437286,14,1373
PB,OURO VELHO,2,2,0,0.0,0,0,0,0.0,0,0,0,0.0,15,18,3,20.0,289,283,-6,-2.08,306,303,-3,-0.98,OURO VELHO PB,-7.6209094,-37.1510175,14,1374
PB,PARARI,0,0,0,0.0,0,0,0,0.0,0,0,0,0.0,3,5,2,66.67,217,210,-7,-3.23,220,215,-5,-2.27,PARARI PB,-7.3182642,-36.6556211,14,1375
PB,PASSAGEM,1,2,1,100.0,1,1,0,0.0,0,1,1,0.0,17,14,-3,-17.65,201,133,-68,-33.83,220,151,-69,-31.36,PASSAGEM PB,-7.1364483,-37.0474285,14,1376
PB,PATOS,50,54,4,8.0,1629,1690,61,3.74,567,1401,834,147.09,4375,4312,-63,-1.44,9112,7048,-2064,-22.65,15733,14505,-1228,-7.81,PATOS PB,-7.0258285,-37.2766817,14,1377
PB,PAULISTA,4,5,1,25.0,48,49,1,2.08,0,0,0,0.0,47,46,-1,-2.13,601,436,-165,-27.45,700,536,-164,-23.43,PAULISTA PB,-6.5980362,-37.6215766,14,1378
PB,PEDRA BRANCA,0,0,0,0.0,61,36,-25,-40.98,1,1,0,0.0,358,335,-23,-6.42,2679,1431,-1248,-46.58,3099,1803,-1296,-41.82,PEDRA BRANCA PB,-7.4277554,-38.0697088,14,1379
PB,PEDRA LAVRADA,0,0,0,0.0,141,142,1,0.71,8,7,-1,-12.5,20,19,-1,-5.0,512,512,0,0.0,681,680,-1,-0.15,PEDRA LAVRADA PB,-6.7562744,-36.4673179,14,1380
PB,PIANCO,5,6,1,20.0,147,160,13,8.84,8,1,-7,-87.5,143,136,-7,-4.9,1438,782,-656,-45.62,1741,1085,-656,-37.68,PIANCO PB,-7.1987413,-37.9255755,14,1382
PB,PICUI,3,1,-2,-66.67,126,96,-30,-23.81,24,10,-14,-58.33,239,233,-6,-2.51,1006,957,-49,-4.87,1398,1297,-101,-7.22,PICUI PB,-6.5106721,-36.3492736,14,1383
PB,PILAR,1029,1204,175,17.01,18,25,7,38.89,22,13,-9,-40.91,56,59,3,5.36,583,645,62,10.63,1708,1946,238,13.93,PILAR PB,-7.264034,-35.252326,14,1384
PB,PILOES,0,0,0,0.0,1,1,0,0.0,0,0,0,0.0,33,29,-4,-12.12,197,177,-20,-10.15,231,207,-24,-10.39,PILOES PB,-6.868269,-35.612974,14,1385
PB,PIRPIRITUBA,12,11,-1,-8.33,54,51,-3,-5.56,0,2,2,0.0,60,57,-3,-5.0,508,421,-87,-17.13,634,542,-92,-14.51,PIRPIRITUBA PB,-6.7809356,-35.4967135,14,1387
PB,PITIMBU,20,27,7,35.0,306,312,6,1.96,44,74,30,68.18,58,59,1,1.72,1441,1444,3,0.21,1869,1916,47,2.51,PITIMBU PB,-7.4728063,-34.811233,14,1388
PB,POCINHOS,44,45,1,2.27,82,79,-3,-3.66,17,22,5,29.41,193,183,-10,-5.18,929,936,7,0.75,1265,1265,0,0.0,POCINHOS PB,-7.076073,-36.0604474,14,1389
PB,POCO DANTAS,0,0,0,0.0,3,7,4,133.33,5,5,0,0.0,7,5,-2,-28.57,373,392,19,5.09,388,409,21,5.41,POCO DANTAS PB,-6.4050165,-38.4964786,14,1390
PB,POCO DE JOSE DE MOURA,2,2,0,0.0,0,0,0,0.0,0,0,0,0.0,16,13,-3,-18.75,414,414,0,0.0,432,429,-3,-0.69,POCO DE JOSE DE MOURA PB,-6.5744099,-38.5114566,14,1391
PB,POMBAL,8,2,-6,-75.0,272,291,19,6.99,17,24,7,41.18,657,589,-68,-10.35,1653,1556,-97,-5.87,2607,2462,-145,-5.56,POMBAL PB,-6.7711315,-37.7988646,14,1392
PB,PRATA,3,2,-1,-33.33,6,6,0,0.0,0,9,9,0.0,21,22,1,4.76,352,216,-136,-38.64,382,255,-127,-33.25,PRATA PB,-7.6948841,-37.0830343,14,1393
PB,PRINCESA ISABEL,251,288,37,14.74,38,34,-4,-10.53,82,40,-42,-51.22,274,286,12,4.38,946,851,-95,-10.04,1591,1499,-92,-5.78,PRINCESA ISABEL PB,-7.736898,-37.9921335,14,1394
PB,REMIGIO,1,1,0,0.0,78,85,7,8.97,10,5,-5,-50.0,224,215,-9,-4.02,1004,793,-211,-21.02,1317,1099,-218,-16.55,REMIGIO PB,-6.9686741,-35.7932133,14,1398
PB,RIACHAO,377,390,13,3.45,59,57,-2,-3.39,17,23,6,35.29,198,203,5,2.53,853,722,-131,-15.36,1504,1395,-109,-7.25,RIACHAO PB,-6.5408387,-35.6608948,14,1400
PB,RIACHAO DO BACAMARTE,1,7,6,600.0,1,1,0,0.0,0,0,0,0.0,19,21,2,10.53,404,266,-138,-34.16,425,295,-130,-30.59,RIACHAO DO BACAMARTE PB,-7.253472,-35.669257,14,1401
PB,RIACHAO DO POCO,10,9,-1,-10.0,0,0,0,0.0,0,0,0,0.0,14,13,-1,-7.14,413,233,-180,-43.58,437,255,-182,-41.65,RIACHAO DO POCO PB,-7.1474817,-35.264755,14,1402
PB,RIACHO DE SANTO ANTONIO,0,0,0,0.0,0,4,4,0.0,0,0,0,0.0,2,3,1,50.0,218,135,-83,-38.07,220,142,-78,-35.45,RIACHO DE SANTO ANTONIO PB,-7.6914069,-36.1563143,14,1403
PB,RIACHO DOS CAVALOS,1,1,0,0.0,117,115,-2,-1.71,0,0,0,0.0,39,36,-3,-7.69,318,251,-67,-21.07,475,403,-72,-15.16,RIACHO DOS CAVALOS PB,-6.4355877,-37.6560108,14,1404
PB,SALGADINHO,0,0,0,0.0,45,25,-20,-44.44,0,0,0,0.0,3,2,-1,-33.33,225,218,-7,-3.11,273,245,-28,-10.26,SALGADINHO PB,-7.1024779,-36.8446805,14,1406
PB,SALGADO DE SAO FELIX,24,19,-5,-20.83,5,5,0,0.0,295,275,-20,-6.78,37,31,-6,-16.22,624,407,-217,-34.78,985,737,-248,-25.18,SALGADO DE SAO FELIX PB,-7.3565372,-35.4381278,14,1407
PB,SANTA CECILIA,0,0,0,0.0,8,15,7,87.5,0,0,0,0.0,23,21,-2,-8.7,393,382,-11,-2.8,424,418,-6,-1.42,SANTA CECILIA PB,-7.7441445,-35.8793295,14,1408
PB,SANTA CRUZ,50,60,10,20.0,419,351,-68,-16.23,193,184,-9,-4.66,943,949,6,0.64,1851,1518,-333,-17.99,3456,3062,-394,-11.4,SANTA CRUZ PB,-6.8293159,-38.1496275,14,1409
PB,SANTA HELENA,0,0,0,0.0,16,14,-2,-12.5,0,0,0,0.0,243,203,-40,-16.46,1329,1616,287,21.6,1588,1833,245,15.43,SANTA HELENA PB,-6.7198909,-38.6399212,14,1410
PB,SANTA INES,184,187,3,1.63,176,231,55,31.25,101,112,11,10.89,4397,4456,59,1.34,4924,4549,-375,-7.62,9782,9535,-247,-2.53,SANTA INES PB,-7.6269752,-38.5592415,14,1411
PB,SANTA LUZIA,389,382,-7,-1.8,17,16,-1,-5.88,0,0,0,0.0,525,505,-20,-3.81,2809,2607,-202,-7.19,3740,3510,-230,-6.15,SANTA LUZIA PB,-6.8677854,-36.9182757,14,1412
PB,SANTANA DE MANGUEIRA,0,0,0,0.0,0,0,0,0.0,0,0,0,0.0,3,3,0,0.0,386,325,-61,-15.8,389,328,-61,-15.68,SANTANA DE MANGUEIRA PB,-7.5516523,-38.3367458,14,1413
PB,SANTANA DOS GARROTES,0,0,0,0.0,3,3,0,0.0,0,1,1,0.0,4,9,5,125.0,432,286,-146,-33.8,439,299,-140,-31.89,SANTANA DOS GARROTES PB,-7.3856858,-37.987565,14,1414
PB,SANTA TERESINHA,156,199,43,27.56,31,1,-30,-96.77,4,3,-1,-25.0,5,4,-1,-20.0,311,272,-39,-12.54,507,479,-28,-5.52,SANTA TERESINHA PB,-7.0849073,-37.4433667,14,1417
PB,SANTO ANDRE,0,0,0,0.0,0,0,0,0.0,0,0,0,0.0,13,14,1,7.69,259,128,-131,-50.58,272,142,-130,-47.79,SANTO ANDRE PB,-7.2198586,-36.6319767,14,1418
PB,SAO BENTO,0,0,0,0.0,16,6,-10,-62.5,0,0,0,0.0,271,275,4,1.48,970,963,-7,-0.72,1257,1244,-13,-1.03,SAO BENTO PB,-6.4859187,-37.4469328,14,1419
PB,SAO BENTINHO,0,0,0,0.0,32,23,-9,-28.12,2,2,0,0.0,12,14,2,16.67,269,261,-8,-2.97,315,300,-15,-4.76,SAO BENTINHO PB,-6.8900937,-37.7259704,14,1420
PB,SAO DOMINGOS DO CARIRI,0,0,0,0.0,0,0,0,0.0,0,0,0,0.0,2,2,0,0.0,155,109,-46,-29.68,157,111,-46,-29.3,SAO DOMINGOS DO CARIRI PB,-7.6350228,-36.4317431,14,1421
PB,SAO DOMINGOS,2,3,1,50.0,27,38,11,40.74,0,0,0,0.0,3,4,1,33.33,248,225,-23,-9.27,280,270,-10,-3.57,SAO DOMINGOS PB,-6.8174316,-37.942643,14,1422
PB,SAO FRANCISCO,0,0,0,0.0,6,0,-6,-100.0,0,0,0,0.0,27,24,-3,-11.11,230,185,-45,-19.57,263,209,-54,-20.53,SAO FRANCISCO PB,-6.6193066,-38.0957979,14,1423
PB,SAO JOAO DO CARIRI,14,11,-3,-21.43,4,4,0,0.0,0,408,408,0.0,29,28,-1,-3.45,409,275,-134,-32.76,456,726,270,59.21,SAO JOAO DO CARIRI PB,-7.386747,-36.5288956,14,1424
PB,SAO JOAO DO TIGRE,0,0,0,0.0,0,0,0,0.0,0,0,0,0.0,9,1,-8,-88.89,271,260,-11,-4.06,280,261,-19,-6.79,SAO JOAO DO TIGRE PB,-8.078237,-36.849141,14,1425
PB,SAO JOSE DA LAGOA TAPADA,0,0,0,0.0,28,29,1,3.57,11,13,2,18.18,34,39,5,14.71,335,345,10,2.99,408,426,18,4.41,SAO JOSE DA LAGOA TAPADA PB,-6.9426858,-38.1639988,14,1426
PB,SAO JOSE DE CAIANA,0,0,0,0.0,5,5,0,0.0,0,0,0,0.0,6,7,1,16.67,277,280,3,1.08,288,292,4,1.39,SAO JOSE DE CAIANA PB,-7.2495911,-38.2999416,14,1427
PB,SAO JOSE DE ESPINHARAS,1,1,0,0.0,0,0,0,0.0,1,0,-1,-100.0,8,5,-3,-37.5,286,286,0,0.0,296,292,-4,-1.35,SAO JOSE DE ESPINHARAS PB,-6.8465204,-37.3250225,14,1428
PB,SAO JOSE DOS RAMOS,17,13,-4,-23.53,2,2,0,0.0,0,0,0,0.0,11,10,-1,-9.09,389,351,-38,-9.77,419,376,-43,-10.26,SAO JOSE DOS RAMOS PB,-7.2458875,-35.3731185,14,1429
PB,SAO JOSE DE PIRANHAS,0,0,0,0.0,30,30,0,0.0,73,247,174,238.36,183,184,1,0.55,681,675,-6,-0.88,967,1136,169,17.48,SAO JOSE DE PIRANHAS PB,-7.1198508,-38.4991347,14,1430
PB,SAO JOSE DE PRINCESA,0,0,0,0.0,0,0,0,0.0,2,0,-2,-100.0,6,6,0,0.0,116,153,37,31.9,124,159,35,28.23,SAO JOSE DE PRINCESA PB,-7.7412144,-38.0989448,14,1431
PB,SAO JOSE DO BONFIM,0,0,0,0.0,1,0,-1,-100.0,0,0,0,0.0,10,12,2,20.0,154,145,-9,-5.84,165,157,-8,-4.85,SAO JOSE DO BONFIM PB,-7.1616115,-37.3081198,14,1432
PB,SAO JOSE DO BREJO DO CRUZ,0,0,0,0.0,0,0,0,0.0,0,0,0,0.0,0,0,0,0.0,241,191,-50,-20.75,241,191,-50,-20.75,SAO JOSE DO BREJO DO CRUZ PB,-6.212327,-37.3544536,14,1433
PB,SAO JOSE DO SABUGI,0,0,0,0.0,25,24,-1,-4.0,0,1,1,0.0,62,63,1,1.61,295,254,-41,-13.9,382,342,-40,-10.47,SAO JOSE DO SABUGI PB,-6.7758264,-36.797916,14,1434
PB,SAO JOSE DOS CORDEIROS,0,0,0,0.0,0,0,0,0.0,0,13,13,0.0,6,3,-3,-50.0,258,253,-5,-1.94,264,269,5,1.89,SAO JOSE DOS CORDEIROS PB,-7.3917683,-36.8079501,14,1435
PB,SAO MAMEDE,3,5,2,66.67,17,19,2,11.76,4,2,-2,-50.0,59,56,-3,-5.08,393,288,-105,-26.72,476,370,-106,-22.27,SAO MAMEDE PB,-6.923862,-37.095436,14,1436
PB,SAO MIGUEL DE TAIPU,75,76,1,1.33,17,17,0,0.0,0,0,0,0.0,9,16,7,77.78,493,321,-172,-34.89,594,430,-164,-27.61,SAO MIGUEL DE TAIPU PB,-7.2504094,-35.2094114,14,1437
PB,SAO SEBASTIAO DE LAGOA DE ROCA,3,1,-2,-66.67,68,26,-42,-61.76,0,1,1,0.0,51,49,-2,-3.92,615,575,-40,-6.5,737,652,-85,-11.53,SAO SEBASTIAO DE LAGOA DE ROCA PB,-7.1051675,-35.867966,14,1438
PB,SAO SEBASTIAO DO UMBUZEIRO,0,0,0,0.0,0,0,0,0.0,0,0,0,0.0,7,6,-1,-14.29,162,155,-7,-4.32,169,161,-8,-4.73,SAO SEBASTIAO DO UMBUZEIRO PB,-8.1522871,-37.0090722,14,1439
PB,SAPE,352,512,160,45.45,174,176,2,1.15,43,43,0,0.0,1212,1160,-52,-4.29,2335,2310,-25,-1.07,4116,4201,85,2.07,SAPE PB,-7.093591,-35.227975,14,1440
PB,SERRA BRANCA,11,4,-7,-63.64,40,34,-6,-15.0,2,2,0,0.0,167,191,24,14.37,715,737,22,3.08,935,968,33,3.53,SERRA BRANCA PB,-7.4815274,-36.6634581,14,1442
PB,SERRA GRANDE,0,0,0,0.0,0,0,0,0.0,0,0,0,0.0,1,8,7,700.0,266,199,-67,-25.19,267,207,-60,-22.47,SERRA GRANDE PB,-7.2146596,-38.3719684,14,1444
PB,SERRA REDONDA,0,0,0,0.0,393,237,-156,-39.69,3,5,2,66.67,30,17,-13,-43.33,405,265,-140,-34.57,831,524,-307,-36.94,SERRA REDONDA PB,-7.1867108,-35.679795,14,1445
PB,SERRARIA,9,2,-7,-77.78,31,30,-1,-3.23,0,0,0,0.0,11,14,3,27.27,333,319,-14,-4.2,384,365,-19,-4.95,SERRARIA PB,-6.8193129,-35.6387473,14,1446
PB,SERTAOZINHO,164,150,-14,-8.54,0,0,0,0.0,1,1,0,0.0,25,19,-6,-24.0,311,245,-66,-21.22,501,415,-86,-17.17,SERTAOZINHO PB,-6.7523657,-35.4407316,14,1447
PB,SOBRADO,10,6,-4,-40.0,3,7,4,133.33,4,0,-4,-100.0,55,43,-12,-21.82,480,275,-205,-42.71,552,331,-221,-40.04,SOBRADO PB,-7.1442879,-35.2357401,14,1448
PB,SOLEDADE,13,14,1,7.69,161,147,-14,-8.7,6,12,6,100.0,220,204,-16,-7.27,1008,1038,30,2.98,1408,1415,7,0.5,SOLEDADE PB,-7.058292,-36.366791,14,1450
PB,SOSSEGO,0,0,0,0.0,0,0,0,0.0,0,0,0,0.0,19,21,2,10.53,329,3,-326,-99.09,348,24,-324,-93.1,SOSSEGO PB,-6.767694,-36.2455081,14,1451
PB,SOUSA,35,42,7,20.0,1905,1891,-14,-0.73,861,253,-608,-70.62,2874,2718,-156,-5.43,4908,5234,326,6.64,10583,10138,-445,-4.2,SOUSA PB,-6.7662029,-38.2319607,14,1452
PB,SUME,29,27,-2,-6.9,46,31,-15,-32.61,15,22,7,46.67,315,316,1,0.32,898,797,-101,-11.25,1303,1193,-110,-8.44,SUME PB,-7.671521,-36.8788755,14,1453
PB,TACIMA,5,1,-4,-80.0,0,3,3,0.0,0,0,0,0.0,43,40,-3,-6.98,492,273,-219,-44.51,540,317,-223,-41.3,TACIMA PB,-6.4895383,-35.6364852,14,1454
PB,TAPEROA,7,10,3,42.86,42,34,-8,-19.05,0,0,0,0.0,106,100,-6,-5.66,814,790,-24,-2.95,969,934,-35,-3.61,TAPEROA PB,-7.206294,-36.824499,14,1455
PB,TAVARES,5,3,-2,-40.0,6,8,2,33.33,7,5,-2,-28.57,72,68,-4,-5.56,551,672,121,21.96,641,756,115,17.94,TAVARES PB,-7.6363205,-37.8787089,14,1456
PB,TEIXEIRA,4,3,-1,-25.0,7,10,3,42.86,53,34,-19,-35.85,143,147,4,2.8,677,515,-162,-23.93,884,709,-175,-19.8,TEIXEIRA PB,-7.221036,-37.252477,14,1457
PB,TENORIO,0,0,0,0.0,29,21,-8,-27.59,0,0,0,0.0,14,18,4,28.57,253,201,-52,-20.55,296,240,-56,-18.92,TENORIO PB,-6.9408374,-36.6277956,14,1458
PB,TRIUNFO,0,0,0,0.0,14,12,-2,-14.29,0,0,0,0.0,56,60,4,7.14,431,294,-137,-31.79,501,366,-135,-26.95,TRIUNFO PB,-6.5790424,-38.5969865,14,1459
PB,UIRAUNA,0,1,1,0.0,74,59,-15,-20.27,8,6,-2,-25.0,305,263,-42,-13.77,643,573,-70,-10.89,1030,902,-128,-12.43,UIRAUNA PB,-6.521424,-38.4120654,14,1460
PB,UMBUZEIRO,0,0,0,0.0,12,13,1,8.33,5,4,-1,-20.0,39,46,7,17.95,608,608,0,0.0,664,671,7,1.05,UMBUZEIRO PB,-7.696494,-35.6666231,14,1461
PB,VARZEA,6,7,1,16.67,3,3,0,0.0,0,0,0,0.0,39,39,0,0.0,310,322,12,3.87,358,371,13,3.63,VARZEA PB,-6.7710581,-36.9912098,14,1462
PB,VIEIROPOLIS,0,0,0,0.0,27,40,13,48.15,0,0,0,0.0,5,8,3,60.0,244,204,-40,-16.39,276,252,-24,-8.7,VIEIROPOLIS PB,-6.5433639,-38.277819,14,1463
PB,ZABELE,0,0,0,0.0,0,0,0,0.0,0,0,0,0.0,5,4,-1,-20.0,169,132,-37,-21.89,174,136,-38,-21.84,ZABELE PB,-8.075514,-37.0985126,14,1464
PE,AFOGADOS DA INGAZEIRA,3,3,0,0.0,270,279,9,3.33,34,45,11,32.35,1068,1066,-2,-0.19,1768,1658,-110,-6.22,3143,3051,-92,-2.93,AFOGADOS DA INGAZEIRA PE,-7.7481283,-37.6346614,15,1466
PE,AFRANIO,13,15,2,15.38,206,207,1,0.49,7,921,914,13057.14,219,233,14,6.39,1468,1084,-384,-26.16,1913,2460,547,28.59,AFRANIO PE,-8.5198919,-41.0070197,15,1467
PE,AGRESTINA,222,219,-3,-1.35,254,172,-82,-32.28,14,10,-4,-28.57,378,329,-49,-12.96,930,853,-77,-8.28,1798,1583,-215,-11.96,AGRESTINA PE,-8.4558021,-35.9442663,15,1468
PE,AGUA PRETA,491,473,-18,-3.67,96,101,5,5.21,2,0,-2,-100.0,158,142,-16,-10.13,1285,986,-299,-23.27,2032,1702,-330,-16.24,AGUA PRETA PE,-8.7079109,-35.5198586,15,1469
PE,AGUAS BELAS,1,0,-1,-100.0,78,95,17,21.79,2,2,0,0.0,516,511,-5,-0.97,1272,1063,-209,-16.43,1869,1671,-198,-10.59,AGUAS BELAS PE,-9.1113156,-37.1225218,15,1470
PE,ALAGOINHA,34,31,-3,-8.82,20,18,-2,-10.0,2,2,0,0.0,83,84,1,1.2,703,725,22,3.13,842,860,18,2.14,ALAGOINHA PE,-8.50355635,-36.77702243002451,15,1471
PE,ALIANCA,2218,1525,-693,-31.24,89,100,11,12.36,48,60,12,25.0,399,362,-37,-9.27,1105,985,-120,-10.86,3859,3032,-827,-21.43,ALIANCA PE,-7.6026425,-35.2263514,15,1472
PE,ALTINHO,34,30,-4,-11.76,165,155,-10,-6.06,1,1,0,0.0,164,168,4,2.44,846,699,-147,-17.38,1210,1053,-157,-12.98,ALTINHO PE,-8.4904095,-36.0607494,15,1473
PE,AMARAJI,272,335,63,23.16,342,39,-303,-88.6,0,2,2,0.0,170,165,-5,-2.94,1242,635,-607,-48.87,2026,1176,-850,-41.95,AMARAJI PE,-8.373925,-35.4536527,15,1474
PE,ANGELIM,78,92,14,17.95,100,100,0,0.0,0,0,0,0.0,84,75,-9,-10.71,538,257,-281,-52.23,800,524,-276,-34.5,ANGELIM PE,-8.8902038,-36.2872987,15,1475
PE,ARARIPINA,52,40,-12,-23.08,1293,1237,-56,-4.33,49,73,24,48.98,1495,1541,46,3.08,3921,3365,-556,-14.18,6810,6256,-554,-8.14,ARARIPINA PE,-7.5768582,-40.5038509,15,1477
PE,ARCOVERDE,22,8,-14,-63.64,687,667,-20,-2.91,98,90,-8,-8.16,2793,2919,126,4.51,4780,4818,38,0.79,8380,8502,122,1.46,ARCOVERDE PE,-8.415192,-37.057748,15,1478
PE,BARRA DE GUABIRABA,812,773,-39,-4.8,142,149,7,4.93,10,11,1,10.0,92,95,3,3.26,739,686,-53,-7.17,1795,1714,-81,-4.51,BARRA DE GUABIRABA PE,-8.4173522,-35.6626669,15,1479
PE,BARREIROS,509,477,-32,-6.29,193,202,9,4.66,22,23,1,4.55,1280,1308,28,2.19,2139,1388,-751,-35.11,4143,3398,-745,-17.98,BARREIROS PE,-8.8159644,-35.1831905,15,1480
PE,BELEM DE MARIA,10,0,-10,-100.0,5,5,0,0.0,0,0,0,0.0,13,31,18,138.46,353,134,-219,-62.04,381,170,-211,-55.38,BELEM DE MARIA PE,-8.6242497,-35.8388934,15,1481
PE,BELO JARDIM,153,179,26,16.99,5222,5514,292,5.59,293,199,-94,-32.08,1850,1769,-81,-4.38,3106,2914,-192,-6.18,10624,10575,-49,-0.46,BELO JARDIM PE,-8.3338293,-36.4176419,15,1483
PE,BETANIA,3,4,1,33.33,6,7,1,16.67,0,7,7,0.0,35,41,6,17.14,522,426,-96,-18.39,566,485,-81,-14.31,BETANIA PE,-8.2742779,-38.0351767,15,1484
PE,BEZERROS,283,324,41,14.49,1184,1270,86,7.26,46,60,14,30.43,1194,1198,4,0.34,9295,8292,-1003,-10.79,12002,11144,-858,-7.15,BEZERROS PE,-8.2372132,-35.7558262,15,1485
PE,BODOCO,10,8,-2,-20.0,32,29,-3,-9.38,4,0,-4,-100.0,191,163,-28,-14.66,1274,1100,-174,-13.66,1511,1300,-211,-13.96,BODOCO PE,-7.777592,-39.933797,15,1486
PE,BOM CONSELHO,57,33,-24,-42.11,403,471,68,16.87,11,16,5,45.45,552,581,29,5.25,1789,1742,-47,-2.63,2812,2843,31,1.1,BOM CONSELHO PE,-9.169191,-36.685683,15,1487
PE,BOM JARDIM,189,157,-32,-16.93,0,1,1,0.0,13,14,1,7.69,162,155,-7,-4.32,1402,1511,109,7.77,1766,1838,72,4.08,BOM JARDIM PE,-7.7961599,-35.5871025,15,1488
PE,BONITO,45,72,27,60.0,1119,1311,192,17.16,0,0,0,0.0,27,25,-2,-7.41,732,611,-121,-16.53,1923,2019,96,4.99,BONITO PE,-8.4769649,-35.7913297,15,1489
PE,BREJAO,91,94,3,3.3,0,0,0,0.0,5,10,5,100.0,99,114,15,15.15,463,356,-107,-23.11,658,574,-84,-12.77,BREJAO PE,-9.029146,-36.566034,15,1490
PE,BREJINHO,32,26,-6,-18.75,104,80,-24,-23.08,19,11,-8,-42.11,164,197,33,20.12,532,489,-43,-8.08,851,803,-48,-5.64,BREJINHO PE,-7.3491144,-37.2871181,15,1491
PE,BREJO DA MADRE DE DEUS,8,4,-4,-50.0,267,274,7,2.62,49,28,-21,-42.86,398,405,7,1.76,1498,1420,-78,-5.21,2220,2131,-89,-4.01,BREJO DA MADRE DE DEUS PE,-8.1409718,-36.3712527,15,1492
PE,BUENOS AIRES,52,77,25,48.08,118,115,-3,-2.54,31,25,-6,-19.35,88,78,-10,-11.36,508,446,-62,-12.2,797,741,-56,-7.03,BUENOS AIRES PE,-7.7218931,-35.326587,15,1493
PE,BUIQUE,61,46,-15,-24.59,58,43,-15,-25.86,6,4,-2,-33.33,446,471,25,5.61,2543,1970,-573,-22.53,3114,2534,-580,-18.63,BUIQUE PE,-8.6239732,-37.157296,15,1494
PE,CABROBO,48,61,13,27.08,98,98,0,0.0,9,13,4,44.44,745,755,10,1.34,1648,1676,28,1.7,2548,2603,55,2.16,CABROBO PE,-8.5083701,-39.3106961,15,1496
PE,CACHOEIRINHA,50,33,-17,-34.0,0,0,0,0.0,0,0,0,0.0,5,3,-2,-40.0,201,136,-65,-32.34,256,172,-84,-32.81,CACHOEIRINHA PE,-8.4906364,-36.2338963,15,1497
PE,CALCADO,2,0,-2,-100.0,10,10,0,0.0,0,1,1,0.0,30,33,3,10.0,429,555,126,29.37,471,599,128,27.18,CALCADO PE,-8.7413446,-36.3351787,15,1499
PE,CALUMBI,0,0,0,0.0,0,0,0,0.0,0,0,0,0.0,30,24,-6,-20.0,312,253,-59,-18.91,342,277,-65,-19.01,CALUMBI PE,-7.9396706,-38.1525186,15,1500
PE,CAMOCIM DE SAO FELIX,46,50,4,8.7,40,36,-4,-10.0,3,3,0,0.0,249,226,-23,-9.24,105,735,630,600.0,443,1050,607,137.02,CAMOCIM DE SAO FELIX PE,-8.3616757,-35.7638903,15,1502
PE,CANHOTINHO,90,74,-16,-17.78,98,103,5,5.1,2,10,8,400.0,215,223,8,3.72,896,681,-215,-24.0,1301,1091,-210,-16.14,CANHOTINHO PE,-8.876519,-36.197935,15,1504
PE,CARNAIBA,0,0,0,0.0,67,77,10,14.93,12,16,4,33.33,124,100,-24,-19.35,820,671,-149,-18.17,1023,864,-159,-15.54,CARNAIBA PE,-7.805964,-37.7947314,15,1506
PE,CARNAUBEIRA DA PENHA,1,1,0,0.0,0,0,0,0.0,0,0,0,0.0,12,17,5,41.67,366,294,-72,-19.67,379,312,-67,-17.68,CARNAUBEIRA DA PENHA PE,-8.3192809,-38.7435891,15,1507
PE,CARPINA,251,283,32,12.75,2310,2310,0,0.0,180,249,69,38.33,3416,3419,3,0.09,4626,5028,402,8.69,10783,11289,506,4.69,CARPINA PE,-7.8459105,-35.2538861,15,1508
PE,CARUARU,327,345,18,5.5,13260,12741,-519,-3.91,2320,2200,-120,-5.17,21195,21063,-132,-0.62,37357,33135,-4222,-11.3,74459,69484,-4975,-6.68,CARUARU PE,-8.2829702,-35.9722852,15,1509
PE,CASINHAS,0,0,0,0.0,7,5,-2,-28.57,0,1,1,0.0,19,18,-1,-5.26,866,748,-118,-13.63,892,772,-120,-13.45,CASINHAS PE,-7.744698,-35.7250923,15,1510
PE,CATENDE,29,59,30,103.45,78,108,30,38.46,2,1,-1,-50.0,365,338,-27,-7.4,1457,1362,-95,-6.52,1931,1868,-63,-3.26,CATENDE PE,-8.6900588,-35.748470825,15,1511
PE,CEDRO,6,8,2,33.33,24,20,-4,-16.67,11,3,-8,-72.73,205,232,27,13.17,1095,946,-149,-13.61,1341,1209,-132,-9.84,CEDRO PE,-7.7186318,-39.2363385,15,1512
PE,CHA DE ALEGRIA,14,12,-2,-14.29,15,39,24,160.0,1,1,0,0.0,58,63,5,8.62,489,509,20,4.09,577,624,47,8.15,CHA DE ALEGRIA PE,-7.9959409,-35.2134636,15,1513
PE,CHA GRANDE,64,69,5,7.81,85,85,0,0.0,14,23,9,64.29,250,257,7,2.8,1065,1067,2,0.19,1478,1501,23,1.56,CHA GRANDE PE,-8.238271,-35.457148,15,1514
PE,CONDADO,8,7,-1,-12.5,7,7,0,0.0,0,0,0,0.0,18,18,0,0.0,334,276,-58,-17.37,367,308,-59,-16.08,CONDADO PE,-7.587868,-35.09994,15,1515
PE,CORRENTES,122,116,-6,-4.92,0,1,1,0.0,3,1,-2,-66.67,80,82,2,2.5,778,524,-254,-32.65,983,724,-259,-26.35,CORRENTES PE,-9.1295585,-36.3287438,15,1516
PE,CORTES,133,127,-6,-4.51,641,602,-39,-6.08,0,0,0,0.0,94,75,-19,-20.21,933,1083,150,16.08,1801,1887,86,4.78,CORTES PE,-8.4724921,-35.5431197,15,1517
PE,CUMARU,1,1,0,0.0,3,5,2,66.67,0,0,0,0.0,59,63,4,6.78,623,475,-148,-23.76,686,544,-142,-20.7,CUMARU PE,-8.0065285,-35.6991651,15,1518
PE,CUPIRA,0,0,0,0.0,387,418,31,8.01,7,7,0,0.0,402,383,-19,-4.73,1423,877,-546,-38.37,2219,1685,-534,-24.06,CUPIRA PE,-8.610275099999999,-35.95254218377778,15,1519
PE,CUSTODIA,7,8,1,14.29,737,821,84,11.4,72,96,24,33.33,463,445,-18,-3.89,1111,1143,32,2.88,2390,2513,123,5.15,CUSTODIA PE,-8.0860251,-37.6400307,15,1520
PE,DORMENTES,1,1,0,0.0,189,183,-6,-3.17,234,268,34,14.53,514,572,58,11.28,990,1011,21,2.12,1928,2035,107,5.55,DORMENTES PE,-8.441163,-40.766168,15,1521
PE,ESCADA,595,506,-89,-14.96,901,832,-69,-7.66,1326,2095,769,57.99,1416,1377,-39,-2.75,2274,2142,-132,-5.8,6512,6952,440,6.76,ESCADA PE,-8.3623847,-35.2366232,15,1522
PE,EXU,1,1,0,0.0,20,18,-2,-10.0,18,11,-7,-38.89,268,268,0,0.0,1681,1680,-1,-0.06,1988,1978,-10,-0.5,EXU PE,-7.515434,-39.722015,15,1523
PE,FEIRA NOVA,65,71,6,9.23,321,281,-40,-12.46,92,96,4,4.35,201,197,-4,-1.99,853,749,-104,-12.19,1532,1394,-138,-9.01,FEIRA NOVA PE,-7.9481471,-35.3871681,15,1524
PE,FERNANDO DE NORONHA,9,8,-1,-11.11,22,15,-7,-31.82,5,7,2,40.0,244,187,-57,-23.36,1468,1184,-284,-19.35,1748,1401,-347,-19.85,FERNANDO DE NORONHA PE,-3.8545643,-32.37861623300567,15,1525
PE,FERREIROS,165,203,38,23.03,64,77,13,20.31,6,3,-3,-50.0,150,194,44,29.33,742,668,-74,-9.97,1127,1145,18,1.6,FERREIROS PE,-7.449667,-35.2426004,15,1526
PE,FLORES,0,0,0,0.0,28,146,118,421.43,57,43,-14,-24.56,112,108,-4,-3.57,1013,473,-540,-53.31,1210,770,-440,-36.36,FLORES PE,-7.862025,-37.9742806,15,1527
PE,FLORESTA,7,9,2,28.57,175,171,-4,-2.29,41,41,0,0.0,1283,1340,57,4.44,1804,1644,-160,-8.87,3310,3205,-105,-3.17,FLORESTA PE,-8.5969798,-38.5742878,15,1528
PE,FREI MIGUELINHO,6,6,0,0.0,40,35,-5,-12.5,0,0,0,0.0,63,63,0,0.0,627,475,-152,-24.24,736,579,-157,-21.33,FREI MIGUELINHO PE,-7.9433019,-35.920939,15,1529
PE,GAMELEIRA,303,296,-7,-2.31,26,48,22,84.62,11,1,-10,-90.91,191,125,-66,-34.55,1230,1082,-148,-12.03,1761,1552,-209,-11.87,GAMELEIRA PE,-8.579803,-35.384573,15,1530
PE,GARANHUNS,266,237,-29,-10.9,1961,2007,46,2.35,718,574,-144,-20.06,6545,6485,-60,-0.92,10164,10708,544,5.35,19654,20011,357,1.82,GARANHUNS PE,-8.8905889,-36.4930896,15,1531
PE,GLORIA DO GOITA,67,59,-8,-11.94,1096,1117,21,1.92,16,12,-4,-25.0,251,230,-21,-8.37,754,782,28,3.71,2184,2200,16,0.73,GLORIA DO GOITA PE,-7.999959,-35.2866116,15,1532
PE,GOIANA,579,438,-141,-24.35,13801,13955,154,1.12,169,156,-13,-7.69,2100,2177,77,3.67,6101,5007,-1094,-17.93,22750,21733,-1017,-4.47,GOIANA PE,-7.560603,-34.99591,15,1533
PE,GRANITO,0,0,0,0.0,1,0,-1,-100.0,28,16,-12,-42.86,19,20,1,5.26,371,357,-14,-3.77,419,393,-26,-6.21,GRANITO PE,-7.7148722,-39.6160362,15,1534
PE,GRAVATA,265,252,-13,-4.91,1291,1331,40,3.1,88,131,43,48.86,2415,2424,9,0.37,5386,5326,-60,-1.11,9445,9464,19,0.2,GRAVATA PE,-8.1993049,-35.5631137,15,1535
PE,IATI,1,2,1,100.0,33,23,-10,-30.3,8,0,-8,-100.0,136,136,0,0.0,516,462,-54,-10.47,694,623,-71,-10.23,IATI PE,-9.0426669,-36.8466803,15,1536
PE,IBIMIRIM,13,11,-2,-15.38,5,5,0,0.0,0,0,0,0.0,219,210,-9,-4.11,832,674,-158,-18.99,1069,900,-169,-15.81,IBIMIRIM PE,-8.5379259,-37.6941375,15,1537
PE,IBIRAJUBA,0,0,0,0.0,3,2,-1,-33.33,0,0,0,0.0,20,18,-2,-10.0,376,316,-60,-15.96,399,336,-63,-15.79,IBIRAJUBA PE,-8.5795521,-36.178045,15,1538
PE,INAJA,317,224,-93,-29.34,104,109,5,4.81,0,0,0,0.0,123,134,11,8.94,718,645,-73,-10.17,1262,1112,-150,-11.89,INAJA PE,-8.9011209,-37.8244194,15,1541
PE,INGAZEIRA,0,0,0,0.0,0,0,0,0.0,1,0,-1,-100.0,13,13,0,0.0,331,326,-5,-1.51,345,339,-6,-1.74,INGAZEIRA PE,-7.6773108,-37.4598895,15,1542
PE,IPUBI,0,0,0,0.0,500,473,-27,-5.4,13,7,-6,-46.15,197,214,17,8.63,1366,1376,10,0.73,2076,2070,-6,-0.29,IPUBI PE,-7.6535334,-40.1494078,15,1544
PE,ITACURUBA,14,13,-1,-7.14,0,0,0,0.0,0,0,0,0.0,23,22,-1,-4.35,349,267,-82,-23.5,386,302,-84,-21.76,ITACURUBA PE,-8.7267879,-38.6868835,15,1545
PE,ITAIBA,0,1,1,0.0,11,9,-2,-18.18,1,3,2,200.0,124,139,15,12.1,816,752,-64,-7.84,952,904,-48,-5.04,ITAIBA PE,-8.94675,-37.421188,15,1546
PE,ITAPETIM,36,32,-4,-11.11,21,43,22,104.76,0,0,0,0.0,119,117,-2,-1.68,534,333,-201,-37.64,710,525,-185,-26.06,ITAPETIM PE,-7.377426,-37.1888025,15,1549
PE,ITAQUITINGA,75,33,-42,-56.0,29,28,-1,-3.45,27,27,0,0.0,81,91,10,12.35,583,511,-72,-12.35,795,690,-105,-13.21,ITAQUITINGA PE,-7.6642569,-35.1023615,15,1551
PE,JAQUEIRA,67,77,10,14.93,11,11,0,0.0,4,3,-1,-25.0,39,43,4,10.26,204,351,147,72.06,325,485,160,49.23,JAQUEIRA PE,-8.7276422,-35.7948925,15,1553
PE,JATAUBA,6,5,-1,-16.67,25,13,-12,-48.0,8,21,13,162.5,144,123,-21,-14.58,750,648,-102,-13.6,933,810,-123,-13.18,JATAUBA PE,-7.9860545,-36.4980118,15,1554
PE,JATOBA,1,1,0,0.0,0,0,0,0.0,0,1,1,0.0,1,2,1,100.0,376,354,-22,-5.85,378,358,-20,-5.29,JATOBA PE,-9.1832353,-38.2672047,15,1555
PE,JOAO ALFREDO,12,8,-4,-33.33,279,287,8,2.87,14,16,2,14.29,361,356,-5,-1.39,701,711,10,1.43,1367,1378,11,0.8,JOAO ALFREDO PE,-7.8608755,-35.591575,15,1556
PE,JOAQUIM NABUCO,93,96,3,3.23,465,525,60,12.9,7,13,6,85.71,35,61,26,74.29,799,468,-331,-41.43,1399,1163,-236,-16.87,JOAQUIM NABUCO PE,-8.6233192,-35.5264107,15,1557
PE,JUCATI,26,29,3,11.54,1,1,0,0.0,4,3,-1,-25.0,44,41,-3,-6.82,412,268,-144,-34.95,487,342,-145,-29.77,JUCATI PE,-8.7065829,-36.4870496,15,1558
PE,JUPI,1,1,0,0.0,107,95,-12,-11.21,117,99,-18,-15.38,159,145,-14,-8.81,564,446,-118,-20.92,948,786,-162,-17.09,JUPI PE,-8.7114677,-36.417448,15,1559
PE,JUREMA,0,0,0,0.0,0,0,0,0.0,20,0,-20,-100.0,13,8,-5,-38.46,240,107,-133,-55.42,273,115,-158,-57.88,JUREMA PE,-8.7189103,-36.137365,15,1560
PE,LAGOA DO CARRO,158,169,11,6.96,253,156,-97,-38.34,8,4,-4,-50.0,180,198,18,10.0,801,816,15,1.87,1400,1343,-57,-4.07,LAGOA DO CARRO PE,-7.843834,-35.310783,15,1561
PE,LAGOA DO OURO,0,0,0,0.0,4,6,2,50.0,0,0,0,0.0,65,63,-2,-3.08,710,403,-307,-43.24,779,472,-307,-39.41,LAGOA DO OURO PE,-9.1247761,-36.4592567,15,1563
PE,LAGOA DOS GATOS,22,15,-7,-31.82,10,13,3,30.0,5,2,-3,-60.0,57,66,9,15.79,442,430,-12,-2.71,536,526,-10,-1.87,LAGOA DOS GATOS PE,-8.6537614,-35.9045124,15,1564
PE,LAGOA GRANDE,1316,1057,-259,-19.68,223,256,33,14.8,5,7,2,40.0,371,366,-5,-1.35,1055,723,-332,-31.47,2970,2409,-561,-18.89,LAGOA GRANDE PE,-8.9930649,-40.2716452,15,1565
PE,LAJEDO,170,124,-46,-27.06,421,490,69,16.39,26,11,-15,-57.69,1106,1051,-55,-4.97,1543,1585,42,2.72,3266,3261,-5,-0.15,LAJEDO PE,-8.657914,-36.329336,15,1566
PE,LIMOEIRO,236,171,-65,-27.54,838,791,-47,-5.61,96,80,-16,-16.67,2009,1880,-129,-6.42,4263,2780,-1483,-34.79,7442,5702,-1740,-23.38,LIMOEIRO PE,-7.872599,-35.440154,15,1567
PE,MACAPARANA,217,252,35,16.13,53,76,23,43.4,11,11,0,0.0,583,596,13,2.23,1309,1018,-291,-22.23,2173,1953,-220,-10.12,MACAPARANA PE,-7.54122565,-35.449102477927944,15,1568
PE,MACHADOS,462,49,-413,-89.39,167,204,37,22.16,0,2,2,0.0,105,121,16,15.24,704,337,-367,-52.13,1438,713,-725,-50.42,MACHADOS PE,-7.6876999,-35.5126635,15,1569
PE,MANARI,0,0,0,0.0,4,3,-1,-25.0,0,0,0,0.0,66,68,2,3.03,597,605,8,1.34,667,676,9,1.35,MANARI PE,-8.9616166,-37.624648,15,1570
PE,MARAIAL,55,128,73,132.73,9,4,-5,-55.56,0,0,0,0.0,29,28,-1,-3.45,576,335,-241,-41.84,669,495,-174,-26.01,MARAIAL PE,-8.7823791,-35.8113151,15,1571
PE,MIRANDIBA,0,0,0,0.0,0,0,0,0.0,40,11,-29,-72.5,157,149,-8,-5.1,505,421,-84,-16.63,702,581,-121,-17.24,MIRANDIBA PE,-8.1202103,-38.728459,15,1572
PE,NAZARE DA MATA,286,280,-6,-2.1,1551,1540,-11,-0.71,663,44,-619,-93.36,775,865,90,11.61,2260,2384,124,5.49,5535,5113,-422,-7.62,NAZARE DA MATA PE,-7.7452689,-35.2286396,15,1574
PE,OROBO,333,348,15,4.5,17,31,14,82.35,20,16,-4,-20.0,189,206,17,8.99,1347,913,-434,-32.22,1906,1514,-392,-20.57,OROBO PE,-7.74562,-35.6019195,15,1576
PE,OROCO,17,17,0,0.0,0,0,0,0.0,0,0,0,0.0,123,113,-10,-8.13,577,558,-19,-3.29,717,688,-29,-4.04,OROCO PE,-8.6147294,-39.6036682,15,1577
PE,OURICURI,5,6,1,20.0,373,353,-20,-5.36,223,135,-88,-39.46,1049,1059,10,0.95,2302,2449,147,6.39,3952,4002,50,1.27,OURICURI PE,-7.884432,-40.0833221,15,1578
PE,PALMARES,142,150,8,5.63,358,385,27,7.54,150,98,-52,-34.67,2281,2330,49,2.15,3632,3378,-254,-6.99,6563,6341,-222,-3.38,PALMARES PE,-8.684226,-35.589032,15,1579
PE,PALMEIRINA,0,0,0,0.0,4,4,0,0.0,0,0,0,0.0,45,44,-1,-2.22,304,313,9,2.96,353,361,8,2.27,PALMEIRINA PE,-9.0030969,-36.3254036,15,1580
PE,PANELAS,1,1,0,0.0,17,28,11,64.71,0,0,0,0.0,149,145,-4,-2.68,684,744,60,8.77,851,918,67,7.87,PANELAS PE,-8.661211,-36.012539,15,1581
PE,PARANATAMA,1,2,1,100.0,29,29,0,0.0,0,0,0,0.0,111,63,-48,-43.24,534,405,-129,-24.16,675,499,-176,-26.07,PARANATAMA PE,-8.9198099,-36.6573512,15,1582
PE,PARNAMIRIM,226,310,84,37.17,5158,4483,-675,-13.09,2508,2784,276,11.0,12894,13089,195,1.51,21105,21530,425,2.01,41891,42196,305,0.73,PARNAMIRIM PE,-8.0913471,-39.5778505,15,1583
PE,PASSIRA,52,45,-7,-13.46,103,91,-12,-11.65,0,0,0,0.0,240,240,0,0.0,933,882,-51,-5.47,1328,1258,-70,-5.27,PASSIRA PE,-7.976317,-35.5817327,15,1584
PE,PEDRA,24,24,0,0.0,140,151,11,7.86,0,0,0,0.0,81,83,2,2.47,611,534,-77,-12.6,856,792,-64,-7.48,PEDRA PE,-8.4995589,-36.944377,15,1587
PE,PESQUEIRA,135,116,-19,-14.07,652,708,56,8.59,18,49,31,172.22,1359,1299,-60,-4.42,3278,2823,-455,-13.88,5442,4995,-447,-8.21,PESQUEIRA PE,-8.3574471,-36.6968238,15,1588
PE,PETROLANDIA,233,215,-18,-7.73,164,171,7,4.27,6,8,2,33.33,969,1016,47,4.85,3232,2367,-865,-26.76,4604,3777,-827,-17.96,PETROLANDIA PE,-8.9701861,-38.2213655,15,1589
PE,POCAO,12,19,7,58.33,156,79,-77,-49.36,0,0,0,0.0,181,188,7,3.87,450,374,-76,-16.89,799,660,-139,-17.4,POCAO PE,-8.186709,-36.7023901,15,1591
PE,POMBOS,197,316,119,60.41,479,562,83,17.33,55,51,-4,-7.27,612,603,-9,-1.47,1606,1380,-226,-14.07,2949,2912,-37,-1.25,POMBOS PE,-8.1398585,-35.396437,15,1592
PE,PRIMAVERA,3,3,0,0.0,172,175,3,1.74,32,14,-18,-56.25,56,61,5,8.93,442,336,-106,-23.98,705,589,-116,-16.45,PRIMAVERA PE,-8.3308449,-35.3523034,15,1593
PE,QUIPAPA,24,25,1,4.17,56,44,-12,-21.43,1,2,1,100.0,131,124,-7,-5.34,971,934,-37,-3.81,1183,1129,-54,-4.56,QUIPAPA PE,-8.8269434,-36.011622,15,1594
PE,QUIXABA,2,2,0,0.0,8,0,-8,-100.0,1,1,0,0.0,0,7,7,0.0,273,238,-35,-12.82,284,248,-36,-12.68,QUIXABA PE,-7.7185273,-37.8484398,15,1595
PE,RECIFE,2196,1975,-221,-10.06,35700,34880,-820,-2.3,31161,31477,316,1.01,99988,96332,-3656,-3.66,470922,471558,636,0.14,639967,636222,-3745,-0.59,RECIFE PE,-8.0650409,-34.8805879,15,1596
PE,RIACHO DAS ALMAS,220,239,19,8.64,231,201,-30,-12.99,6,1,-5,-83.33,148,133,-15,-10.14,780,418,-362,-46.41,1385,992,-393,-28.38,RIACHO DAS ALMAS PE,-8.1356327,-35.8566421,15,1597
PE,RIBEIRAO,838,623,-215,-25.66,469,643,174,37.1,17,10,-7,-41.18,505,463,-42,-8.32,1635,1470,-165,-10.09,3464,3209,-255,-7.36,RIBEIRAO PE,-8.5066761,-35.3747339,15,1598
PE,RIO FORMOSO,267,241,-26,-9.74,9259,5387,-3872,-41.82,1,1,0,0.0,192,194,2,1.04,1336,803,-533,-39.9,11055,6626,-4429,-40.06,RIO FORMOSO PE,-8.6606291,-35.1550736,15,1599
PE,SAIRE,53,81,28,52.83,37,30,-7,-18.92,1,1,0,0.0,140,94,-46,-32.86,759,691,-68,-8.96,990,897,-93,-9.39,SAIRE PE,-8.3277815,-35.7094611,15,1600
PE,SALGADINHO,0,0,0,0.0,45,25,-20,-44.44,0,0,0,0.0,3,2,-1,-33.33,225,218,-7,-3.11,273,245,-28,-10.26,SALGADINHO PE,-7.9403047,-35.6343745,15,1601
PE,SALGUEIRO,19,15,-4,-21.05,444,417,-27,-6.08,901,739,-162,-17.98,2264,2226,-38,-1.68,3701,2981,-720,-19.45,7329,6378,-951,-12.98,SALGUEIRO PE,-8.073734,-39.12469,15,1602
PE,SALOA,0,0,0,0.0,2,1,-1,-50.0,3,93,90,3000.0,89,98,9,10.11,475,651,176,37.05,569,843,274,48.15,SALOA PE,-8.974964,-36.6892298,15,1603
PE,SANHARO,39,39,0,0.0,65,79,14,21.54,19,16,-3,-15.79,277,301,24,8.66,751,690,-61,-8.12,1151,1125,-26,-2.26,SANHARO PE,-8.3628776,-36.5573186,15,1604
PE,SANTA CRUZ,50,60,10,20.0,419,351,-68,-16.23,193,184,-9,-4.66,943,949,6,0.64,1851,1518,-333,-17.99,3456,3062,-394,-11.4,SANTA CRUZ PE,-8.2392548,-40.3316611,15,1605
PE,SANTA CRUZ DA BAIXA VERDE,31,28,-3,-9.68,36,28,-8,-22.22,0,0,0,0.0,73,70,-3,-4.11,483,372,-111,-22.98,623,498,-125,-20.06,SANTA CRUZ DA BAIXA VERDE PE,-7.8185452,-38.1523506,15,1606
PE,SANTA CRUZ DO CAPIBARIBE,6,4,-2,-33.33,4806,4452,-354,-7.37,300,150,-150,-50.0,3835,3984,149,3.89,5368,4730,-638,-11.89,14315,13320,-995,-6.95,SANTA CRUZ DO CAPIBARIBE PE,-7.948019,-36.206092,15,1607
PE,SANTA FILOMENA,289,355,66,22.84,14,19,5,35.71,0,0,0,0.0,34,30,-4,-11.76,17,169,152,894.12,354,573,219,61.86,SANTA FILOMENA PE,-8.1605806,-40.613247,15,1608
PE,SANTA MARIA DA BOA VISTA,199,220,21,10.55,32,40,8,25.0,0,0,0,0.0,402,391,-11,-2.74,2124,1659,-465,-21.89,2757,2310,-447,-16.21,SANTA MARIA DA BOA VISTA PE,-8.8001615,-39.8271099,15,1609
PE,SANTA MARIA DO CAMBUCA,0,0,0,0.0,86,80,-6,-6.98,5,6,1,20.0,63,67,4,6.35,518,597,79,15.25,672,750,78,11.61,SANTA MARIA DO CAMBUCA PE,-7.8328155,-35.882795,15,1610
PE,SANTA TEREZINHA,1,1,0,0.0,4,3,-1,-25.0,24,16,-8,-33.33,56,75,19,33.93,735,455,-280,-38.1,820,550,-270,-32.93,SANTA TEREZINHA PE,-7.37696,-37.47875,15,1611
PE,SAO BENEDITO DO SUL,12,19,7,58.33,20,20,0,0.0,0,0,0,0.0,33,37,4,12.12,699,775,76,10.87,764,851,87,11.39,SAO BENEDITO DO SUL PE,-8.8107294,-35.9334035,15,1612
PE,SAO BENTO DO UNA,2328,2654,326,14.0,402,423,21,5.22,20,17,-3,-15.0,700,672,-28,-4.0,1238,1184,-54,-4.36,4688,4950,262,5.59,SAO BENTO DO UNA PE,-8.5207092,-36.4445546,15,1613
PE,SAO CAITANO,43,38,-5,-11.63,1037,1045,8,0.77,19,24,5,26.32,462,487,25,5.41,1166,1047,-119,-10.21,2727,2641,-86,-3.15,SAO CAITANO PE,-8.3304491,-36.135359,15,1614
PE,SAO JOAO,15,10,-5,-33.33,17,15,-2,-11.76,8,12,4,50.0,253,292,39,15.42,1102,832,-270,-24.5,1395,1161,-234,-16.77,SAO JOAO PE,-8.875762,-36.36532,15,1615
PE,SAO JOAQUIM DO MONTE,20,22,2,10.0,13,4,-9,-69.23,0,0,0,0.0,128,127,-1,-0.78,848,840,-8,-0.94,1009,993,-16,-1.59,SAO JOAQUIM DO MONTE PE,-8.4323653,-35.8076179,15,1616
PE,SAO JOSE DO BELMONTE,10,9,-1,-10.0,70,78,8,11.43,67,104,37,55.22,345,335,-10,-2.9,1621,2096,475,29.3,2113,2622,509,24.09,SAO JOSE DO BELMONTE PE,-7.8641261,-38.7599545,15,1618
PE,SAO JOSE DO EGITO,223,226,3,1.35,109,78,-31,-28.44,585,153,-432,-73.85,666,599,-67,-10.06,1362,1365,3,0.22,2945,2421,-524,-17.79,SAO JOSE DO EGITO PE,-7.469447,-37.273974,15,1619
PE,SERRA TALHADA,21,23,2,9.52,968,986,18,1.86,318,213,-105,-33.02,3951,3981,30,0.76,6058,6533,475,7.84,11316,11736,420,3.71,SERRA TALHADA PE,-7.9867805,-38.2920294,15,1622
PE,SERRITA,14,18,4,28.57,21,27,6,28.57,0,0,0,0.0,59,53,-6,-10.17,889,533,-356,-40.04,983,631,-352,-35.81,SERRITA PE,-7.9476953,-39.2957383,15,1623
PE,SERTANIA,18,23,5,27.78,125,106,-19,-15.2,2609,2056,-553,-21.2,369,355,-14,-3.79,1455,1345,-110,-7.56,4576,3885,-691,-15.1,SERTANIA PE,-8.068467,-37.268393,15,1624
PE,SIRINHAEM,236,214,-22,-9.32,6011,5961,-50,-0.83,21,10,-11,-52.38,635,624,-11,-1.73,1738,957,-781,-44.94,8641,7766,-875,-10.13,SIRINHAEM PE,-8.591935,-35.1155161,15,1625
PE,MOREILANDIA,0,0,0,0.0,0,0,0,0.0,0,0,0,0.0,38,42,4,10.53,608,530,-78,-12.83,646,572,-74,-11.46,MOREILANDIA PE,-7.6298629,-39.5535521,15,1626
PE,SOLIDAO,0,0,0,0.0,0,0,0,0.0,0,0,0,0.0,8,8,0,0.0,360,239,-121,-33.61,368,247,-121,-32.88,SOLIDAO PE,-7.6008705,-37.6514396,15,1627
PE,SURUBIM,16,26,10,62.5,1085,999,-86,-7.93,51,48,-3,-5.88,1854,1876,22,1.19,2829,2651,-178,-6.29,5835,5600,-235,-4.03,SURUBIM PE,-7.8424353,-35.7539722,15,1628
PE,TABIRA,7,4,-3,-42.86,344,366,22,6.4,21,3,-18,-85.71,484,465,-19,-3.93,1199,716,-483,-40.28,2055,1554,-501,-24.38,TABIRA PE,-7.583661,-37.537735,15,1629
PE,TACAIMBO,84,19,-65,-77.38,270,263,-7,-2.59,1,2,1,100.0,119,85,-34,-28.57,498,422,-76,-15.26,972,791,-181,-18.62,TACAIMBO PE,-8.308673,-36.300035,15,1630
PE,TACARATU,17,17,0,0.0,51,77,26,50.98,0,0,0,0.0,71,83,12,16.9,733,1036,303,41.34,872,1213,341,39.11,TACARATU PE,-9.1051762,-38.1499125,15,1631
PE,TAMANDARE,194,394,200,103.09,44,19,-25,-56.82,53,56,3,5.66,521,537,16,3.07,1783,1443,-340,-19.07,2595,2449,-146,-5.63,TAMANDARE PE,-8.7500009,-35.1045787,15,1632
PE,TAQUARITINGA DO NORTE,11,19,8,72.73,980,834,-146,-14.9,59,2,-57,-96.61,263,260,-3,-1.14,1177,936,-241,-20.48,2490,2051,-439,-17.63,TAQUARITINGA DO NORTE PE,-7.9027766,-36.0442227,15,1633
PE,TEREZINHA,0,0,0,0.0,0,0,0,0.0,8,7,-1,-12.5,27,26,-1,-3.7,343,355,12,3.5,378,388,10,2.65,TEREZINHA PE,-9.0560369,-36.623375,15,1634
PE,TERRA NOVA,0,0,0,0.0,1,0,-1,-100.0,0,0,0,0.0,40,40,0,0.0,479,346,-133,-27.77,520,386,-134,-25.77,TERRA NOVA PE,-8.2249522,-39.3844637,15,1635
PE,TIMBAUBA,379,523,144,37.99,644,828,184,28.57,201,419,218,108.46,1858,1731,-127,-6.84,2452,2386,-66,-2.69,5534,5887,353,6.38,TIMBAUBA PE,-7.5118822,-35.316076,15,1636
PE,TORITAMA,0,4,4,0.0,2091,1989,-102,-4.88,64,28,-36,-56.25,1242,1243,1,0.08,1898,1825,-73,-3.85,5295,5089,-206,-3.89,TORITAMA PE,-8.0083743,-36.058776,15,1637
PE,TRACUNHAEM,277,237,-40,-14.44,5,3,-2,-40.0,8,14,6,75.0,68,80,12,17.65,657,323,-334,-50.84,1015,657,-358,-35.27,TRACUNHAEM PE,-7.8027253,-35.238498,15,1638
PE,TRINDADE,1,0,-1,-100.0,805,844,39,4.84,5,5,0,0.0,457,454,-3,-0.66,920,943,23,2.5,2188,2246,58,2.65,TRINDADE PE,-7.759,-40.26472,15,1639
PE,TRIUNFO,0,0,0,0.0,14,12,-2,-14.29,0,0,0,0.0,56,60,4,7.14,431,294,-137,-31.79,501,366,-135,-26.95,TRIUNFO PE,-7.8362959,-38.1042617,15,1640
PE,TUPANATINGA,0,0,0,0.0,2,1,-1,-50.0,0,0,0,0.0,116,111,-5,-4.31,1210,659,-551,-45.54,1328,771,-557,-41.94,TUPANATINGA PE,-8.7542378,-37.3398733,15,1641
PE,TUPARETAMA,1,1,0,0.0,47,54,7,14.89,0,0,0,0.0,103,109,6,5.83,264,237,-27,-10.23,415,401,-14,-3.37,TUPARETAMA PE,-7.6010116,-37.3114417,15,1642
PE,VENTUROSA,5,5,0,0.0,36,30,-6,-16.67,1,1,0,0.0,145,145,0,0.0,787,547,-240,-30.5,974,728,-246,-25.26,VENTUROSA PE,-8.5765199,-36.876569,15,1643
PE,VERDEJANTE,2,3,1,50.0,26,26,0,0.0,6,0,-6,-100.0,45,43,-2,-4.44,415,286,-129,-31.08,494,358,-136,-27.53,VERDEJANTE PE,-7.9285675,-38.9685473,15,1644
PE,VERTENTE DO LERIO,1,2,1,100.0,152,163,11,7.24,3,2,-1,-33.33,15,12,-3,-20.0,454,443,-11,-2.42,625,622,-3,-0.48,VERTENTE DO LERIO PE,-7.7733359,-35.8498482,15,1645
PE,VERTENTES,9,7,-2,-22.22,135,130,-5,-3.7,0,0,0,0.0,177,160,-17,-9.6,730,786,56,7.67,1051,1083,32,3.04,VERTENTES PE,-7.906103,-35.9894975,15,1646
PE,VICENCIA,563,507,-56,-9.95,1709,785,-924,-54.07,11,31,20,181.82,397,389,-8,-2.02,1098,1325,227,20.67,3778,3037,-741,-19.61,VICENCIA PE,-7.6574422,-35.3218464,15,1647
PE,VITORIA DE SANTO ANTAO,290,264,-26,-8.97,9092,9178,86,0.95,135,312,177,131.11,5879,5726,-153,-2.6,8295,7603,-692,-8.34,23691,23083,-608,-2.57,VITORIA DE SANTO ANTAO PE,-8.1209019,-35.2944858,15,1648
PE,XEXEU,373,354,-19,-5.09,17,15,-2,-11.76,0,7,7,0.0,111,105,-6,-5.41,699,457,-242,-34.62,1200,938,-262,-21.83,XEXEU PE,-8.8036743,-35.6244442,15,1649
AL,AGUA BRANCA,4,5,1,25.0,87,105,18,20.69,30,18,-12,-40.0,702,770,68,9.69,633,460,-173,-27.33,1456,1358,-98,-6.73,AGUA BRANCA AL,-9.2613606,-37.9361053,1,1650
AL,ANADIA,29,111,82,282.76,77,84,7,9.09,0,2,2,0.0,121,94,-27,-22.31,988,1051,63,6.38,1215,1342,127,10.45,ANADIA AL,-9.6830208,-36.3052699,1,1651
AL,ARAPIRACA,583,576,-7,-1.2,4062,3758,-304,-7.48,628,867,239,38.06,15089,15010,-79,-0.52,16441,16728,287,1.75,36803,36939,136,0.37,ARAPIRACA AL,-9.754866,-36.661471,1,1652
AL,BARRA DE SAO MIGUEL,3,5,2,66.67,5,4,-1,-20.0,3,1,-2,-66.67,27,28,1,3.7,309,270,-39,-12.62,347,308,-39,-11.24,BARRA DE SAO MIGUEL AL,-9.8261357,-35.8837777,1,1655
AL,BATALHA,15,11,-4,-26.67,26,25,-1,-3.85,35,22,-13,-37.14,215,204,-11,-5.12,881,771,-110,-12.49,1172,1033,-139,-11.86,BATALHA AL,-9.6733809,-37.1265481,1,1656
AL,BELO MONTE,0,0,0,0.0,57,67,10,17.54,0,0,0,0.0,3,3,0,0.0,282,294,12,4.26,342,364,22,6.43,BELO MONTE AL,-9.8269944,-37.2787165,1,1658
AL,BOCA DA MATA,43,43,0,0.0,639,635,-4,-0.63,59,48,-11,-18.64,133,117,-16,-12.03,1286,1171,-115,-8.94,2160,2014,-146,-6.76,BOCA DA MATA AL,-9.6452054,-36.2116658,1,1659
AL,BRANQUINHA,19,13,-6,-31.58,1,2,1,100.0,0,0,0,0.0,23,14,-9,-39.13,514,453,-61,-11.87,557,482,-75,-13.46,BRANQUINHA AL,-9.2478057,-36.0152009,1,1660
AL,CACIMBINHAS,9,9,0,0.0,18,22,4,22.22,0,0,0,0.0,25,22,-3,-12.0,852,789,-63,-7.39,904,842,-62,-6.86,CACIMBINHAS AL,-9.401212,-36.991082,1,1661
AL,CAJUEIRO,30,27,-3,-10.0,173,164,-9,-5.2,0,0,0,0.0,123,113,-10,-8.13,978,1386,408,41.72,1304,1690,386,29.6,CAJUEIRO AL,-9.399589,-36.1524309,1,1662
AL,CAMPESTRE,36,34,-2,-5.56,1,1,0,0.0,0,0,0,0.0,56,44,-12,-21.43,511,507,-4,-0.78,604,586,-18,-2.98,CAMPESTRE AL,-8.8481634,-35.5660033,1,1663
AL,CAMPO GRANDE,2,2,0,0.0,0,0,0,0.0,0,0,0,0.0,40,34,-6,-15.0,518,500,-18,-3.47,560,536,-24,-4.29,CAMPO GRANDE AL,-9.9725,-36.74791447368421,1,1665
AL,CANAPI,2,3,1,50.0,1,1,0,0.0,0,0,0,0.0,43,55,12,27.91,548,509,-39,-7.12,594,568,-26,-4.38,CANAPI AL,-9.1173572,-37.6011704,1,1666
AL,CAPELA,159,143,-16,-10.06,45,31,-14,-31.11,0,0,0,0.0,184,170,-14,-7.61,1272,831,-441,-34.67,1660,1175,-485,-29.22,CAPELA AL,-9.415041,-36.082583,1,1667
AL,CARNEIROS,2,2,0,0.0,1,3,2,200.0,0,0,0,0.0,23,17,-6,-26.09,407,432,25,6.14,433,454,21,4.85,CARNEIROS AL,-9.4832948,-37.3757121,1,1668
AL,CHA PRETA,42,40,-2,-4.76,3,2,-1,-33.33,0,0,0,0.0,21,13,-8,-38.1,395,364,-31,-7.85,461,419,-42,-9.11,CHA PRETA AL,-9.255605,-36.298334,1,1669
AL,COITE DO NOIA,1,3,2,200.0,18,17,-1,-5.56,1,0,-1,-100.0,83,74,-9,-10.84,417,378,-39,-9.35,520,472,-48,-9.23,COITE DO NOIA AL,-9.633484,-36.584493,1,1670
AL,COLONIA LEOPOLDINA,253,291,38,15.02,278,270,-8,-2.88,0,0,0,0.0,184,198,14,7.61,1678,1324,-354,-21.1,2393,2083,-310,-12.95,COLONIA LEOPOLDINA AL,-8.9144649,-35.7220255,1,1671
AL,CORURIPE,611,527,-84,-13.75,6815,6646,-169,-2.48,47,75,28,59.57,608,697,89,14.64,3209,2563,-646,-20.13,11290,10508,-782,-6.93,CORURIPE AL,-10.1249963,-36.1760623,1,1673
AL,CRAIBAS,2,2,0,0.0,307,580,273,88.93,129,514,385,298.45,95,102,7,7.37,1447,798,-649,-44.85,1980,1996,16,0.81,CRAIBAS AL,-9.6168038,-36.7684669,1,1674
AL,DELMIRO GOUVEIA,18,25,7,38.89,151,96,-55,-36.42,146,105,-41,-28.08,1202,1194,-8,-0.67,3528,2120,-1408,-39.91,5045,3540,-1505,-29.83,DELMIRO GOUVEIA AL,-9.3841161,-37.997756,1,1675
AL,DOIS RIACHOS,8,7,-1,-12.5,3,3,0,0.0,70,4,-66,-94.29,19,19,0,0.0,458,475,17,3.71,558,508,-50,-8.96,DOIS RIACHOS AL,-9.384645,-37.096502,1,1676
AL,ESTRELA DE ALAGOAS,0,0,0,0.0,3,4,1,33.33,0,0,0,0.0,49,43,-6,-12.24,10,721,711,7110.0,62,768,706,1138.71,ESTRELA DE ALAGOAS AL,-9.3888972,-36.7616833,1,1677
AL,FEIRA GRANDE,54,45,-9,-16.67,15,21,6,40.0,17,15,-2,-11.76,51,43,-8,-15.69,740,695,-45,-6.08,877,819,-58,-6.61,FEIRA GRANDE AL,-9.8944239,-36.6793255,1,1678
AL,FELIZ DESERTO,5,4,-1,-20.0,103,106,3,2.91,6,2,-4,-66.67,32,34,2,6.25,287,238,-49,-17.07,433,384,-49,-11.32,FELIZ DESERTO AL,-10.292494,-36.3028583,1,1679
AL,FLEXEIRAS,163,153,-10,-6.13,2,5,3,150.0,13,10,-3,-23.08,63,65,2,3.17,906,936,30,3.31,1147,1169,22,1.92,FLEXEIRAS AL,-9.2788679,-35.7235246,1,1680
AL,GIRAU DO PONCIANO,21,10,-11,-52.38,33,31,-2,-6.06,44,14,-30,-68.18,216,251,35,16.2,687,798,111,16.16,1001,1104,103,10.29,GIRAU DO PONCIANO AL,-9.884041,-36.831592,1,1681
AL,IBATEGUARA,70,64,-6,-8.57,1,1,0,0.0,0,0,0,0.0,81,94,13,16.05,557,562,5,0.9,709,721,12,1.69,IBATEGUARA AL,-8.9737196,-35.9279963,1,1682
AL,IGACI,2,2,0,0.0,36,15,-21,-58.33,0,0,0,0.0,64,65,1,1.56,1088,1114,26,2.39,1190,1196,6,0.5,IGACI AL,-9.537678,-36.637191,1,1683
AL,IGREJA NOVA,40,34,-6,-15.0,2526,2199,-327,-12.95,0,0,0,0.0,79,99,20,25.32,947,957,10,1.06,3592,3289,-303,-8.44,IGREJA NOVA AL,-10.1267244,-36.658151,1,1684
AL,INHAPI,0,0,0,0.0,0,0,0,0.0,3,2,-1,-33.33,69,81,12,17.39,619,582,-37,-5.98,691,665,-26,-3.76,INHAPI AL,-9.222095,-37.7480654,1,1685
AL,JACARE DOS HOMENS,6,5,-1,-16.67,0,0,0,0.0,0,0,0,0.0,19,23,4,21.05,203,200,-3,-1.48,228,228,0,0.0,JACARE DOS HOMENS AL,-9.6348723,-37.2055752,1,1686
AL,JACUIPE,172,145,-27,-15.7,1,1,0,0.0,0,0,0,0.0,30,33,3,10.0,212,391,179,84.43,415,570,155,37.35,JACUIPE AL,-8.83951,-35.459074,1,1687
AL,JAPARATINGA,8,7,-1,-12.5,31,28,-3,-9.68,0,0,0,0.0,53,40,-13,-24.53,965,990,25,2.59,1057,1065,8,0.76,JAPARATINGA AL,-9.087464,-35.263403,1,1688
AL,JARAMATAIA,3,3,0,0.0,5,5,0,0.0,1,0,-1,-100.0,11,8,-3,-27.27,518,15,-503,-97.1,538,31,-507,-94.24,JARAMATAIA AL,-9.6597307,-37.0015482,1,1689
AL,JEQUIA DA PRAIA,87,217,130,149.43,21,4,-17,-80.95,2,0,-2,-100.0,31,27,-4,-12.9,62,477,415,669.35,203,725,522,257.14,JEQUIA DA PRAIA AL,-10.0092595,-36.0232787,1,1690
AL,JOAQUIM GOMES,61,54,-7,-11.48,0,8,8,0.0,12,9,-3,-25.0,102,115,13,12.75,1445,822,-623,-43.11,1620,1008,-612,-37.78,JOAQUIM GOMES AL,-9.1372894,-35.7518862,1,1691
AL,JUNDIA,1,1,0,0.0,3,3,0,0.0,14,2,-12,-85.71,2,2,0,0.0,283,147,-136,-48.06,303,155,-148,-48.84,JUNDIA AL,-8.944022,-35.5546827,1,1692
AL,JUNQUEIRO,384,189,-195,-50.78,21,30,9,42.86,89,133,44,49.44,270,273,3,1.11,1842,1155,-687,-37.3,2606,1780,-826,-31.7,JUNQUEIRO AL,-9.9201549,-36.474737,1,1693
AL,LAGOA DA CANOA,2,4,2,100.0,36,29,-7,-19.44,2,3,1,50.0,291,456,165,56.7,579,622,43,7.43,910,1114,204,22.42,LAGOA DA CANOA AL,-9.8294012,-36.7395617,1,1694
AL,LIMOEIRO DE ANADIA,119,233,114,95.8,358,387,29,8.1,3,1,-2,-66.67,289,279,-10,-3.46,1109,1094,-15,-1.35,1878,1994,116,6.18,LIMOEIRO DE ANADIA AL,-9.7389667,-36.5015847,1,1695
AL,MACEIO,500,642,142,28.4,16207,15067,-1140,-7.03,17040,17090,50,0.29,47297,47008,-289,-0.61,170032,166717,-3315,-1.95,251076,246524,-4552,-1.81,MACEIO AL,-9.6476843,-35.7339264,1,1696
AL,MAJOR ISIDORO,19,29,10,52.63,27,24,-3,-11.11,0,0,0,0.0,193,182,-11,-5.7,753,799,46,6.11,992,1034,42,4.23,MAJOR ISIDORO AL,-9.4945,-37.036265625,1,1697
AL,MARAVILHA,2,0,-2,-100.0,1,1,0,0.0,0,0,0,0.0,30,31,1,3.33,280,280,0,0.0,313,312,-1,-0.32,MARAVILHA AL,-9.230449,-37.352419,1,1699
AL,MARIBONDO,35,36,1,2.86,25,16,-9,-36.0,2,2,0,0.0,254,192,-62,-24.41,710,641,-69,-9.72,1026,887,-139,-13.55,MARIBONDO AL,-9.5808649,-36.3040574,1,1701
AL,MAR VERMELHO,5,11,6,120.0,1,1,0,0.0,0,2,2,0.0,5,5,0,0.0,304,308,4,1.32,315,327,12,3.81,MAR VERMELHO AL,-9.447393,-36.388076,1,1702
AL,MATA GRANDE,0,0,0,0.0,4,4,0,0.0,0,0,0,0.0,106,122,16,15.09,701,682,-19,-2.71,811,808,-3,-0.37,MATA GRANDE AL,-9.118243,-37.732298,1,1703
AL,MATRIZ DE CAMARAGIBE,320,196,-124,-38.75,2078,2153,75,3.61,2,6,4,200.0,199,189,-10,-5.03,1047,1048,1,0.1,3646,3592,-54,-1.48,MATRIZ DE CAMARAGIBE AL,-9.154373,-35.524302,1,1704
AL,MINADOR DO NEGRAO,0,0,0,0.0,0,0,0,0.0,0,0,0,0.0,7,4,-3,-42.86,370,346,-24,-6.49,377,350,-27,-7.16,MINADOR DO NEGRAO AL,-9.312358,-36.869553,1,1706
AL,MONTEIROPOLIS,21,22,1,4.76,2,18,16,800.0,0,0,0,0.0,26,24,-2,-7.69,442,385,-57,-12.9,491,449,-42,-8.55,MONTEIROPOLIS AL,-9.602565,-37.2461716,1,1707
AL,MURICI,423,442,19,4.49,119,126,7,5.88,27,26,-1,-3.7,234,211,-23,-9.83,2104,2066,-38,-1.81,2907,2871,-36,-1.24,MURICI AL,-9.306823,-35.942798,1,1708
AL,NOVO LINO,83,110,27,32.53,0,0,0,0.0,1,0,-1,-100.0,37,39,2,5.41,843,827,-16,-1.9,964,976,12,1.24,NOVO LINO AL,-8.941905,-35.664001,1,1709
AL,OLIVENCA,0,0,0,0.0,1,0,-1,-100.0,2,0,-2,-100.0,41,43,2,4.88,647,687,40,6.18,691,730,39,5.64,OLIVENCA AL,-9.5190555,-37.1893316,1,1713
AL,OURO BRANCO,0,0,0,0.0,142,65,-77,-54.23,0,2,2,0.0,54,51,-3,-5.56,276,268,-8,-2.9,472,386,-86,-18.22,OURO BRANCO AL,-9.1622698,-37.3582893,1,1714
AL,PALMEIRA DOS INDIOS,10,8,-2,-20.0,618,597,-21,-3.4,24,42,18,75.0,1955,1873,-82,-4.19,5215,3795,-1420,-27.23,7822,6315,-1507,-19.27,PALMEIRA DOS INDIOS AL,-9.4076249,-36.6323616,1,1716
AL,PAO DE ACUCAR,2,2,0,0.0,36,32,-4,-11.11,1,0,-1,-100.0,103,96,-7,-6.8,1463,1032,-431,-29.46,1605,1162,-443,-27.6,PAO DE ACUCAR AL,-9.7496551,-37.4329891,1,1717
AL,PARICONHA,0,0,0,0.0,0,0,0,0.0,0,0,0,0.0,37,39,2,5.41,636,900,264,41.51,673,939,266,39.52,PARICONHA AL,-9.2540147,-38.0039241,1,1718
AL,PASSO DE CAMARAGIBE,24,31,7,29.17,53,37,-16,-30.19,0,4,4,0.0,91,90,-1,-1.1,924,1051,127,13.74,1092,1213,121,11.08,PASSO DE CAMARAGIBE AL,-9.2367833,-35.4901015,1,1720
AL,PAULO JACINTO,13,11,-2,-15.38,3,3,0,0.0,0,0,0,0.0,38,36,-2,-5.26,471,340,-131,-27.81,525,390,-135,-25.71,PAULO JACINTO AL,-9.367918,-36.367241,1,1721
AL,PENEDO,78,113,35,44.87,666,777,111,16.67,115,103,-12,-10.43,1370,1287,-83,-6.06,4007,4346,339,8.46,6236,6626,390,6.25,PENEDO AL,-10.2872341,-36.5819262,1,1722
AL,PIACABUCU,8,11,3,37.5,7,3,-4,-57.14,0,0,0,0.0,98,190,92,93.88,617,594,-23,-3.73,730,798,68,9.32,PIACABUCU AL,-10.4066897,-36.433654,1,1723
AL,PILAR,1029,1204,175,17.01,18,25,7,38.89,22,13,-9,-40.91,56,59,3,5.36,583,645,62,10.63,1708,1946,238,13.93,PILAR AL,-9.6016711,-35.9511275,1,1724
AL,PINDOBA,24,26,2,8.33,0,0,0,0.0,0,0,0,0.0,2,1,-1,-50.0,344,363,19,5.52,370,390,20,5.41,PINDOBA AL,-9.473822,-36.291829,1,1725
AL,PIRANHAS,85,89,4,4.71,36,77,41,113.89,6,1,-5,-83.33,214,220,6,2.8,2189,2366,177,8.09,2530,2753,223,8.81,PIRANHAS AL,-9.6115579,-37.7616366,1,1726
AL,POCO DAS TRINCHEIRAS,0,1,1,0.0,0,0,0,0.0,0,0,0,0.0,40,20,-20,-50.0,687,681,-6,-0.87,727,702,-25,-3.44,POCO DAS TRINCHEIRAS AL,-9.3063206,-37.2855185,1,1727
AL,PORTO CALVO,197,150,-47,-23.86,1583,1469,-114,-7.2,88,63,-25,-28.41,417,378,-39,-9.35,1489,1099,-390,-26.19,3774,3159,-615,-16.3,PORTO CALVO AL,-9.051948,-35.398653,1,1728
AL,PORTO DE PEDRAS,125,96,-29,-23.2,13,11,-2,-15.38,2,2,0,0.0,38,41,3,7.89,763,829,66,8.65,941,979,38,4.04,PORTO DE PEDRAS AL,-9.160065,-35.304914,1,1729
AL,PORTO REAL DO COLEGIO,9,12,3,33.33,1,1,0,0.0,3,3,0,0.0,103,91,-12,-11.65,646,612,-34,-5.26,762,719,-43,-5.64,PORTO REAL DO COLEGIO AL,-10.186833,-36.8357056,1,1730
AL,QUEBRANGULO,28,19,-9,-32.14,8,5,-3,-37.5,0,0,0,0.0,62,57,-5,-8.06,532,505,-27,-5.08,630,586,-44,-6.98,QUEBRANGULO AL,-9.3217611,-36.4735837,1,1731
AL,ROTEIRO,0,4,4,0.0,24,31,7,29.17,0,0,0,0.0,33,30,-3,-9.09,786,742,-44,-5.6,843,807,-36,-4.27,ROTEIRO AL,-9.8334935,-35.9777132,1,1733
AL,SANTANA DO IPANEMA,3,5,2,66.67,254,145,-109,-42.91,60,65,5,8.33,1393,1453,60,4.31,2528,2669,141,5.58,4238,4337,99,2.34,SANTANA DO IPANEMA AL,-9.369989,-37.248018,1,1735
AL,SANTANA DO MUNDAU,53,31,-22,-41.51,4,17,13,325.0,0,0,0,0.0,37,30,-7,-18.92,744,768,24,3.23,838,846,8,0.95,SANTANA DO MUNDAU AL,-9.171413,-36.217608,1,1736
AL,SAO BRAS,25,22,-3,-12.0,0,0,0,0.0,0,0,0,0.0,10,10,0,0.0,364,349,-15,-4.12,399,381,-18,-4.51,SAO BRAS AL,-10.1258829,-36.898249,1,1737
AL,SAO JOSE DA LAJE,29,36,7,24.14,5057,5000,-57,-1.13,0,0,0,0.0,126,132,6,4.76,1029,1022,-7,-0.68,6241,6190,-51,-0.82,SAO JOSE DA LAJE AL,-9.0093044,-36.056732,1,1738
AL,SAO JOSE DA TAPERA,0,6,6,0.0,20,19,-1,-5.0,89,163,74,83.15,216,232,16,7.41,1574,1566,-8,-0.51,1899,1986,87,4.58,SAO JOSE DA TAPERA AL,-9.5584287,-37.3818893,1,1739
AL,SAO LUIS DO QUITUNDE,55,58,3,5.45,5145,5223,78,1.52,64,37,-27,-42.19,360,338,-22,-6.11,1818,2178,360,19.8,7442,7834,392,5.27,SAO LUIS DO QUITUNDE AL,-9.3181755,-35.5605097,1,1740
AL,SAO MIGUEL DOS CAMPOS,1553,1775,222,14.29,5130,4612,-518,-10.1,614,671,57,9.28,1119,1143,24,2.14,3134,3115,-19,-0.61,11550,11316,-234,-2.03,SAO MIGUEL DOS CAMPOS AL,-9.7831115,-36.0967804,1,1741
AL,SAO MIGUEL DOS MILAGRES,19,10,-9,-47.37,4,5,1,25.0,12,5,-7,-58.33,93,195,102,109.68,1071,925,-146,-13.63,1199,1140,-59,-4.92,SAO MIGUEL DOS MILAGRES AL,-9.267217,-35.376312,1,1742
AL,SENADOR RUI PALMEIRA,1,1,0,0.0,2,3,1,50.0,0,0,0,0.0,45,63,18,40.0,592,628,36,6.08,640,695,55,8.59,SENADOR RUI PALMEIRA AL,-9.469865,-37.457606,1,1745
AL,TAQUARANA,9,21,12,133.33,16,18,2,12.5,3,3,0,0.0,170,179,9,5.29,746,886,140,18.77,944,1107,163,17.27,TAQUARANA AL,-9.64529,-36.492844,1,1747
AL,TEOTONIO VILELA,110,192,82,74.55,741,781,40,5.4,146,44,-102,-69.86,567,585,18,3.17,3381,3361,-20,-0.59,4945,4963,18,0.36,TEOTONIO VILELA AL,-9.9062736,-36.3571341,1,1748
AL,TRAIPU,1,6,5,500.0,0,0,0,0.0,0,0,0,0.0,40,33,-7,-17.5,1581,632,-949,-60.03,1622,671,-951,-58.63,TRAIPU AL,-9.967583,-37.0015357,1,1749
AL,UNIAO DOS PALMARES,266,290,24,9.02,470,485,15,3.19,63,75,12,19.05,1099,1049,-50,-4.55,2720,2673,-47,-1.73,4618,4572,-46,-1.0,UNIAO DOS PALMARES AL,-9.1576807,-36.0342251,1,1750
AL,VICOSA,0,4,4,0.0,1,1,0,0.0,0,0,0,0.0,2,2,0,0.0,153,106,-47,-30.72,156,113,-43,-27.56,VICOSA AL,-9.3728032,-36.2432636,1,1751
SE,AMPARO DE SAO FRANCISCO,2,3,1,50.0,4,4,0,0.0,0,0,0,0.0,21,9,-12,-57.14,333,293,-40,-12.01,360,309,-51,-14.17,AMPARO DE SAO FRANCISCO SE,-10.2002447,-36.93251519749188,24,1752
SE,AQUIDABA,78,64,-14,-17.95,58,75,17,29.31,6,5,-1,-16.67,271,268,-3,-1.11,1131,851,-280,-24.76,1544,1263,-281,-18.2,AQUIDABA SE,-10.2837579,-37.0188687,24,1753
SE,ARACAJU,606,705,99,16.34,11974,12253,279,2.33,13112,14497,1385,10.56,34284,33498,-786,-2.29,125146,147350,22204,17.74,185122,208303,23181,12.52,ARACAJU SE,-10.9162061,-37.0774655,24,1754
SE,ARAUA,151,122,-29,-19.21,15,16,1,6.67,7,6,-1,-14.29,39,40,1,2.56,496,414,-82,-16.53,708,598,-110,-15.54,ARAUA SE,-11.2628389,-37.619978,24,1755
SE,AREIA BRANCA,12,11,-1,-8.33,1295,1343,48,3.71,246,153,-93,-37.8,555,540,-15,-2.7,2295,881,-1414,-61.61,4403,2928,-1475,-33.5,AREIA BRANCA SE,-10.7591455,-37.3148072,24,1756
SE,BOQUIM,187,144,-43,-22.99,140,124,-16,-11.43,15,6,-9,-60.0,499,484,-15,-3.01,1093,890,-203,-18.57,1934,1648,-286,-14.79,BOQUIM SE,-11.1450175,-37.6204228,24,1758
SE,BREJO GRANDE,34,28,-6,-17.65,8,9,1,12.5,0,0,0,0.0,19,22,3,15.79,182,119,-63,-34.62,243,178,-65,-26.75,BREJO GRANDE SE,-10.4287358,-36.4667918,24,1759
SE,CAMPO DO BRITO,71,50,-21,-29.58,229,265,36,15.72,169,241,72,42.6,281,279,-2,-0.71,878,607,-271,-30.87,1628,1442,-186,-11.43,CAMPO DO BRITO SE,-10.7496246,-37.4942276,24,1760
SE,CANHOBA,15,16,1,6.67,5,5,0,0.0,0,0,0,0.0,5,5,0,0.0,284,216,-68,-23.94,309,242,-67,-21.68,CANHOBA SE,-10.1373681,-36.9710796,24,1761
SE,CANINDE DE SAO FRANCISCO,48,47,-1,-2.08,110,107,-3,-2.73,34,38,4,11.76,379,414,35,9.23,1820,1674,-146,-8.02,2391,2280,-111,-4.64,CANINDE DE SAO FRANCISCO SE,-9.6597475,-37.7904456,24,1762
SE,CAPELA,159,143,-16,-10.06,45,31,-14,-31.11,0,0,0,0.0,184,170,-14,-7.61,1272,831,-441,-34.67,1660,1175,-485,-29.22,CAPELA SE,-10.50494,-37.0552566,24,1763
SE,CARIRA,107,104,-3,-2.8,39,27,-12,-30.77,3,117,114,3800.0,252,246,-6,-2.38,854,1039,185,21.66,1255,1533,278,22.15,CARIRA SE,-10.358303,-37.701473,24,1764
SE,CEDRO DE SAO JOAO,17,9,-8,-47.06,23,23,0,0.0,1,1,0,0.0,48,46,-2,-4.17,377,433,56,14.85,466,512,46,9.87,CEDRO DE SAO JOAO SE,-10.2506778,-36.8816067,24,1766
SE,CRISTINAPOLIS,247,253,6,2.43,17,17,0,0.0,0,0,0,0.0,158,152,-6,-3.8,1155,662,-493,-42.68,1577,1084,-493,-31.26,CRISTINAPOLIS SE,-11.4757019,-37.7555212,24,1767
SE,CUMBE,26,24,-2,-7.69,6,5,-1,-16.67,24,24,0,0.0,17,17,0,0.0,312,156,-156,-50.0,385,226,-159,-41.3,CUMBE SE,-10.3552462,-37.1828788,24,1768
SE,ESTANCIA,289,270,-19,-6.57,3098,3478,380,12.27,143,183,40,27.97,2068,2083,15,0.73,4098,3729,-369,-9.0,9696,9743,47,0.48,ESTANCIA SE,-11.2682255,-37.4378341,24,1770
SE,FEIRA NOVA,65,71,6,9.23,321,281,-40,-12.46,92,96,4,4.35,201,197,-4,-1.99,853,749,-104,-12.19,1532,1394,-138,-9.01,FEIRA NOVA SE,-10.2629878,-37.3131265,24,1771
SE,FREI PAULO,111,99,-12,-10.81,1066,1275,209,19.61,31,54,23,74.19,198,168,-30,-15.15,611,475,-136,-22.26,2017,2071,54,2.68,FREI PAULO SE,-10.549956,-37.5356071,24,1772
SE,GARARU,6,8,2,33.33,15,10,-5,-33.33,0,0,0,0.0,17,13,-4,-23.53,589,389,-200,-33.96,627,420,-207,-33.01,GARARU SE,-9.9688996,-37.0827962,24,1773
SE,GRACHO CARDOSO,23,26,3,13.04,6,4,-2,-33.33,2,2,0,0.0,22,23,1,4.55,298,395,97,32.55,351,450,99,28.21,GRACHO CARDOSO SE,-10.23888165,-37.20549285444669,24,1775
SE,ILHA DAS FLORES,0,0,0,0.0,9,9,0,0.0,1,2,1,100.0,49,48,-1,-2.04,332,169,-163,-49.1,391,228,-163,-41.69,ILHA DAS FLORES SE,-10.4365954,-36.5370011,24,1776
SE,INDIAROBA,81,69,-12,-14.81,17,13,-4,-23.53,0,0,0,0.0,73,65,-8,-10.96,743,685,-58,-7.81,914,832,-82,-8.97,INDIAROBA SE,-11.5250972,-37.5075262,24,1777
SE,ITABAIANA,57,43,-14,-24.56,54,77,23,42.59,4,2,-2,-50.0,567,517,-50,-8.82,1061,1334,273,25.73,1743,1973,230,13.2,ITABAIANA SE,-10.6856197,-37.4270517,24,1778
SE,ITABAIANINHA,85,71,-14,-16.47,873,879,6,0.69,64,60,-4,-6.25,555,527,-28,-5.05,1545,1390,-155,-10.03,3122,2927,-195,-6.25,ITABAIANINHA SE,-11.2760142,-37.78666,24,1779
SE,ITABI,18,15,-3,-16.67,18,16,-2,-11.11,0,0,0,0.0,19,18,-1,-5.26,353,297,-56,-15.86,408,346,-62,-15.2,ITABI SE,-10.1263407,-37.1017566,24,1780
SE,JAPARATUBA,103,94,-9,-8.74,535,518,-17,-3.18,19,19,0,0.0,155,164,9,5.81,884,1015,131,14.82,1696,1810,114,6.72,JAPARATUBA SE,-10.5934888,-36.941514,24,1782
SE,JAPOATA,554,332,-222,-40.07,24,22,-2,-8.33,9,10,1,11.11,118,110,-8,-6.78,820,482,-338,-41.22,1525,956,-569,-37.31,JAPOATA SE,-10.3467864,-36.799878,24,1783
SE,LAGARTO,478,463,-15,-3.14,1421,3587,2166,152.43,261,321,60,22.99,2765,2664,-101,-3.65,6154,5127,-1027,-16.69,11079,12162,1083,9.78,LAGARTO SE,-10.9141791,-37.6715308,24,1784
SE,MACAMBIRA,18,20,2,11.11,128,126,-2,-1.56,0,0,0,0.0,45,41,-4,-8.89,385,234,-151,-39.22,576,421,-155,-26.91,MACAMBIRA SE,-10.6657963,-37.5396488,24,1786
SE,MALHADA DOS BOIS,5,4,-1,-20.0,8,1,-7,-87.5,6,0,-6,-100.0,66,58,-8,-12.12,444,394,-50,-11.26,529,457,-72,-13.61,MALHADA DOS BOIS SE,-10.3450779,-36.9206659,24,1787
SE,MALHADOR,5,4,-1,-20.0,9,10,1,11.11,0,0,0,0.0,54,63,9,16.67,515,522,7,1.36,583,599,16,2.74,MALHADOR SE,-10.6588623,-37.3085558,24,1788
SE,MOITA BONITA,6,6,0,0.0,16,15,-1,-6.25,4,2,-2,-50.0,192,176,-16,-8.33,435,363,-72,-16.55,653,562,-91,-13.94,MOITA BONITA SE,-10.5793237,-37.3423877,24,1790
SE,MONTE ALEGRE DE SERGIPE,17,15,-2,-11.76,7,7,0,0.0,0,0,0,0.0,125,140,15,12.0,442,66,-376,-85.07,591,228,-363,-61.42,MONTE ALEGRE DE SERGIPE SE,-10.0657473,-37.62356148016381,24,1791
SE,MURIBECA,26,26,0,0.0,51,41,-10,-19.61,80,86,6,7.5,47,46,-1,-2.13,387,313,-74,-19.12,591,512,-79,-13.37,MURIBECA SE,-10.4227085,-36.9567299,24,1792
SE,NOSSA SENHORA APARECIDA,23,16,-7,-30.43,346,240,-106,-30.64,1,6,5,500.0,53,43,-10,-18.87,352,309,-43,-12.22,775,614,-161,-20.77,NOSSA SENHORA APARECIDA SE,-10.3968947,-37.4539699,24,1794
SE,NOSSA SENHORA DA GLORIA,161,126,-35,-21.74,987,1132,145,14.69,199,40,-159,-79.9,1562,1478,-84,-5.38,2348,2255,-93,-3.96,5257,5031,-226,-4.3,NOSSA SENHORA DA GLORIA SE,-10.2188811,-37.4199759,24,1795
SE,NOSSA SENHORA DAS DORES,92,108,16,17.39,1094,1078,-16,-1.46,47,42,-5,-10.64,491,523,32,6.52,1387,1158,-229,-16.51,3111,2909,-202,-6.49,NOSSA SENHORA DAS DORES SE,-10.4927502,-37.1931675,24,1796
SE,NOSSA SENHORA DE LOURDES,9,9,0,0.0,19,15,-4,-21.05,10,2,-8,-80.0,63,57,-6,-9.52,274,255,-19,-6.93,375,338,-37,-9.87,NOSSA SENHORA DE LOURDES SE,-10.0786746,-37.0572176,24,1797
SE,PACATUBA,35,37,2,5.71,2340,2414,74,3.16,441,125,-316,-71.66,855,806,-49,-5.73,3570,2714,-856,-23.98,7241,6096,-1145,-15.81,PACATUBA SE,-10.4506594,-36.6473212,24,1799
SE,PEDRA MOLE,9,14,5,55.56,4,3,-1,-25.0,0,0,0,0.0,4,6,2,50.0,224,119,-105,-46.88,241,142,-99,-41.08,PEDRA MOLE SE,-10.6181053,-37.6865098,24,1800
SE,PEDRINHAS,14,12,-2,-14.29,5,4,-1,-20.0,0,0,0,0.0,59,62,3,5.08,303,320,17,5.61,381,398,17,4.46,PEDRINHAS SE,-11.192952,-37.6757812,24,1801
SE,PINHAO,30,26,-4,-13.33,3,3,0,0.0,1,0,-1,-100.0,44,42,-2,-4.55,376,286,-90,-23.94,454,357,-97,-21.37,PINHAO SE,-10.5682989,-37.7236405,24,1802
SE,PIRAMBU,14,13,-1,-7.14,35,37,2,5.71,8,10,2,25.0,36,40,4,11.11,450,327,-123,-27.33,543,427,-116,-21.36,PIRAMBU SE,-10.7408558,-36.8591248,24,1803
SE,POCO REDONDO,10,14,4,40.0,8,8,0,0.0,40,20,-20,-50.0,169,156,-13,-7.69,1118,1089,-29,-2.59,1345,1287,-58,-4.31,POCO REDONDO SE,-9.8083322,-37.6827949,24,1804
SE,POCO VERDE,14,11,-3,-21.43,595,595,0,0.0,19,11,-8,-42.11,242,259,17,7.02,820,782,-38,-4.63,1690,1658,-32,-1.89,POCO VERDE SE,-10.7119994,-38.1749204,24,1805
SE,PORTO DA FOLHA,28,17,-11,-39.29,50,44,-6,-12.0,8,6,-2,-25.0,162,150,-12,-7.41,1011,964,-47,-4.65,1259,1181,-78,-6.2,PORTO DA FOLHA SE,-9.9152762,-37.2791369,24,1806
SE,PROPRIA,62,49,-13,-20.97,547,499,-48,-8.78,251,260,9,3.59,1307,1277,-30,-2.3,1810,2041,231,12.76,3977,4126,149,3.75,PROPRIA SE,-10.212427,-36.8372254,24,1807
SE,RIACHAO DO DANTAS,119,135,16,13.45,1,7,6,600.0,12,0,-12,-100.0,35,33,-2,-5.71,592,534,-58,-9.8,759,709,-50,-6.59,RIACHAO DO DANTAS SE,-11.0704439,-37.726446,24,1808
SE,RIBEIROPOLIS,52,56,4,7.69,286,304,18,6.29,158,85,-73,-46.2,273,259,-14,-5.13,1160,1060,-100,-8.62,1929,1764,-165,-8.55,RIBEIROPOLIS SE,-10.5405577,-37.4368783,24,1810
SE,SALGADO,119,107,-12,-10.08,329,322,-7,-2.13,21,26,5,23.81,141,146,5,3.55,912,804,-108,-11.84,1522,1405,-117,-7.69,SALGADO SE,-11.0282445,-37.4782803,24,1812
SE,SANTA LUZIA DO ITANHY,98,103,5,5.1,1,5,4,400.0,0,5,5,0.0,28,31,3,10.71,666,518,-148,-22.22,793,662,-131,-16.52,SANTA LUZIA DO ITANHY SE,-11.3517434,-37.4478339,24,1813
SE,SANTANA DO SAO FRANCISCO,27,0,-27,-100.0,7,4,-3,-42.86,2,10,8,400.0,20,27,7,35.0,285,238,-47,-16.49,341,279,-62,-18.18,SANTANA DO SAO FRANCISCO SE,-10.2926609,-36.6074667,24,1814
SE,SANTA ROSA DE LIMA,39,40,1,2.56,3,3,0,0.0,0,0,0,0.0,1,1,0,0.0,330,268,-62,-18.79,373,312,-61,-16.35,SANTA ROSA DE LIMA SE,-10.6474939,-37.1926373,24,1815
SE,SANTO AMARO DAS BROTAS,61,47,-14,-22.95,13,26,13,100.0,14,2,-12,-85.71,39,35,-4,-10.26,566,385,-181,-31.98,693,495,-198,-28.57,SANTO AMARO DAS BROTAS SE,-10.7866999,-37.054711,24,1816
SE,SAO DOMINGOS,2,3,1,50.0,27,38,11,40.74,0,0,0,0.0,3,4,1,33.33,248,225,-23,-9.27,280,270,-10,-3.57,SAO DOMINGOS SE,-10.7903753,-37.5667586,24,1818
SE,SAO MIGUEL DO ALEIXO,27,15,-12,-44.44,4,3,-1,-25.0,10,14,4,40.0,11,12,1,9.09,337,378,41,12.17,389,422,33,8.48,SAO MIGUEL DO ALEIXO SE,-10.3892164,-37.3826157,24,1820
SE,SIMAO DIAS,141,125,-16,-11.35,1587,1523,-64,-4.03,9,57,48,533.33,552,581,29,5.25,1825,1848,23,1.26,4114,4134,20,0.49,SIMAO DIAS SE,-10.7388301,-37.809016,24,1821
SE,TOBIAS BARRETO,23,25,2,8.7,886,893,7,0.79,25,22,-3,-12.0,1289,1241,-48,-3.72,2043,1932,-111,-5.43,4266,4113,-153,-3.59,TOBIAS BARRETO SE,-11.1878721,-38.0030397,24,1824
SE,TOMAR DO GERU,99,80,-19,-19.19,56,53,-3,-5.36,2,1,-1,-50.0,62,67,5,8.06,566,547,-19,-3.36,785,748,-37,-4.71,TOMAR DO GERU SE,-11.3752475,-37.8413399,24,1825
SE,UMBAUBA,234,168,-66,-28.21,186,193,7,3.76,77,49,-28,-36.36,445,517,72,16.18,1179,1275,96,8.14,2121,2202,81,3.82,UMBAUBA SE,-11.3826792,-37.6565562,24,1826
BA,ABAIRA,5,19,14,280.0,18,8,-10,-55.56,0,44,44,0.0,92,108,16,17.39,310,47,-263,-84.84,425,226,-199,-46.82,ABAIRA BA,-13.2503296,-41.6640342,4,1827
BA,ABARE,256,305,49,19.14,24,26,2,8.33,0,0,0,0.0,60,94,34,56.67,902,684,-218,-24.17,1242,1109,-133,-10.71,ABARE BA,-8.7239913,-39.1139689,4,1828
BA,ACAJUTIBA,46,46,0,0.0,10,11,1,10.0,0,0,0,0.0,71,76,5,7.04,681,562,-119,-17.47,808,695,-113,-13.99,ACAJUTIBA BA,-11.6609659,-38.0186381,4,1829
BA,ADUSTINA,5,10,5,100.0,9,14,5,55.56,0,0,0,0.0,74,106,32,43.24,725,604,-121,-16.69,813,734,-79,-9.72,ADUSTINA BA,-10.5358875,-38.114479,4,1830
BA,AGUA FRIA,9,193,184,2044.44,2,18,16,800.0,9,5,-4,-44.44,143,138,-5,-3.5,752,717,-35,-4.65,915,1071,156,17.05,AGUA FRIA BA,-11.8784691,-38.7663706,4,1831
BA,ERICO CARDOSO,26,24,-2,-7.69,7,14,7,100.0,1,4,3,300.0,54,51,-3,-5.56,439,200,-239,-54.44,527,293,-234,-44.4,ERICO CARDOSO BA,-13.419162,-42.1381486,4,1832
BA,AIQUARA,58,68,10,17.24,0,3,3,0.0,0,0,0,0.0,46,38,-8,-17.39,329,247,-82,-24.92,433,356,-77,-17.78,AIQUARA BA,-14.126918,-39.8887574,4,1833
BA,ALAGOINHAS,2762,2427,-335,-12.13,5062,4817,-245,-4.84,663,1048,385,58.07,6879,6340,-539,-7.84,12665,12484,-181,-1.43,28031,27116,-915,-3.26,ALAGOINHAS BA,-12.133526,-38.420772,4,1834
BA,ALCOBACA,287,244,-43,-14.98,192,170,-22,-11.46,0,1,1,0.0,251,212,-39,-15.54,1190,1070,-120,-10.08,1920,1697,-223,-11.61,ALCOBACA BA,-17.5215875,-39.1965474,4,1835
BA,ALMADINA,74,72,-2,-2.7,5,4,-1,-20.0,0,0,0,0.0,24,29,5,20.83,306,309,3,0.98,409,414,5,1.22,ALMADINA BA,-14.7025806,-39.6383321,4,1836
BA,AMARGOSA,109,107,-2,-1.83,814,919,105,12.9,92,68,-24,-26.09,903,914,11,1.22,2008,2010,2,0.1,3926,4018,92,2.34,AMARGOSA BA,-13.0302189,-39.6040692,4,1837
BA,AMELIA RODRIGUES,63,59,-4,-6.35,554,697,143,25.81,20,13,-7,-35.0,395,415,20,5.06,1695,1466,-229,-13.51,2727,2650,-77,-2.82,AMELIA RODRIGUES BA,-12.4015388,-38.7516971,4,1838
BA,AMERICA DOURADA,14,14,0,0.0,0,2,2,0.0,0,0,0,0.0,51,52,1,1.96,516,448,-68,-13.18,581,516,-65,-11.19,AMERICA DOURADA BA,-11.4515262,-41.4357517,4,1839
BA,ANAGE,66,70,4,6.06,65,48,-17,-26.15,21,18,-3,-14.29,257,218,-39,-15.18,958,877,-81,-8.46,1367,1231,-136,-9.95,ANAGE BA,-14.6134669,-41.1376308,4,1840
BA,ANDARAI,46,55,9,19.57,14,8,-6,-42.86,0,0,0,0.0,54,68,14,25.93,1142,763,-379,-33.19,1256,894,-362,-28.82,ANDARAI BA,-12.8059674,-41.3322919,4,1841
BA,ANDORINHA,12,11,-1,-8.33,1043,1014,-29,-2.78,0,13,13,0.0,100,93,-7,-7.0,794,634,-160,-20.15,1949,1765,-184,-9.44,ANDORINHA BA,-10.3445708,-39.8334411,4,1842
BA,ANGICAL,68,73,5,7.35,1,32,31,3100.0,1,1,0,0.0,71,77,6,8.45,881,750,-131,-14.87,1022,933,-89,-8.71,ANGICAL BA,-12.005623,-44.7000236,4,1843
BA,ANGUERA,11,8,-3,-27.27,3,4,1,33.33,2,4,2,100.0,78,86,8,10.26,856,238,-618,-72.2,950,340,-610,-64.21,ANGUERA BA,-12.1509425,-39.2452469,4,1844
BA,ANTAS,2,2,0,0.0,17,14,-3,-17.65,0,6,6,0.0,99,115,16,16.16,709,624,-85,-11.99,827,761,-66,-7.98,ANTAS BA,-10.4114649,-38.3308815,4,1845
BA,ANTONIO CARDOSO,90,106,16,17.78,5,5,0,0.0,0,0,0,0.0,62,81,19,30.65,495,399,-96,-19.39,652,591,-61,-9.36,ANTONIO CARDOSO BA,-12.4363122,-39.1200307,4,1846
BA,ANTONIO GONCALVES,2,8,6,300.0,0,0,0,0.0,0,0,0,0.0,63,64,1,1.59,508,442,-66,-12.99,573,514,-59,-10.3,ANTONIO GONCALVES BA,-10.5715409,-40.2748824,4,1847
BA,APORA,38,33,-5,-13.16,8,14,6,75.0,63,6,-57,-90.48,49,58,9,18.37,881,739,-142,-16.12,1039,850,-189,-18.19,APORA BA,-11.6599747,-38.0794757,4,1848
BA,APUAREMA,7,7,0,0.0,0,0,0,0.0,0,0,0,0.0,37,41,4,10.81,322,290,-32,-9.94,366,338,-28,-7.65,APUAREMA BA,-13.8517897,-39.7457126,4,1849
BA,ARACATU,19,18,-1,-5.26,21,20,-1,-4.76,2,1,-1,-50.0,138,150,12,8.7,758,686,-72,-9.5,938,875,-63,-6.72,ARACATU BA,-14.4274236,-41.4604105,4,1850
BA,ARACI,12,11,-1,-8.33,8,6,-2,-25.0,136,158,22,16.18,349,345,-4,-1.15,2280,2102,-178,-7.81,2785,2622,-163,-5.85,ARACI BA,-11.3356065,-38.9573261,4,1852
BA,ARAMARI,16,18,2,12.5,92,68,-24,-26.09,25,22,-3,-12.0,80,75,-5,-6.25,331,280,-51,-15.41,544,463,-81,-14.89,ARAMARI BA,-12.0907897,-38.4985065,4,1853
BA,ARATACA,228,217,-11,-4.82,15,42,27,180.0,0,0,0,0.0,58,61,3,5.17,646,647,1,0.15,947,967,20,2.11,ARATACA BA,-15.2617424,-39.4122943,4,1854
BA,ARATUIPE,50,44,-6,-12.0,3,3,0,0.0,0,1,1,0.0,52,46,-6,-11.54,427,278,-149,-34.89,532,372,-160,-30.08,ARATUIPE BA,-13.077137,-39.0010786,4,1855
BA,BAIANOPOLIS,190,181,-9,-4.74,1,1,0,0.0,0,1,1,0.0,117,110,-7,-5.98,550,393,-157,-28.55,858,686,-172,-20.05,BAIANOPOLIS BA,-12.3067564,-44.5383591,4,1857
BA,BAIXA GRANDE,50,48,-2,-4.0,8,7,-1,-12.5,22,16,-6,-27.27,166,171,5,3.01,826,600,-226,-27.36,1072,842,-230,-21.46,BAIXA GRANDE BA,-11.9630941,-40.1657537,4,1858
BA,BANZAE,0,0,0,0.0,1,1,0,0.0,0,0,0,0.0,60,55,-5,-8.33,615,523,-92,-14.96,676,579,-97,-14.35,BANZAE BA,-10.5827616,-38.6122305,4,1859
BA,BARRA,48,50,2,4.17,40,43,3,7.5,1,368,367,36700.0,414,397,-17,-4.11,1976,1984,8,0.4,2479,2842,363,14.64,BARRA BA,-11.0892702,-43.1420453,4,1860
BA,BARRA DA ESTIVA,102,105,3,2.94,53,75,22,41.51,5,9,4,80.0,622,572,-50,-8.04,890,841,-49,-5.51,1672,1602,-70,-4.19,BARRA DA ESTIVA BA,-13.6269662,-41.3278287,4,1861
BA,BARRA DO CHOCA,701,667,-34,-4.85,66,72,6,9.09,254,166,-88,-34.65,378,406,28,7.41,1259,968,-291,-23.11,2658,2279,-379,-14.26,BARRA DO CHOCA BA,-14.8638173,-40.5761637,4,1862
BA,BARRA DO MENDES,0,3,3,0.0,2,5,3,150.0,0,0,0,0.0,104,101,-3,-2.88,530,490,-40,-7.55,636,599,-37,-5.82,BARRA DO MENDES BA,-11.8053298,-42.057037,4,1863
BA,BARRA DO ROCHA,112,98,-14,-12.5,3,3,0,0.0,39,4,-35,-89.74,26,26,0,0.0,412,242,-170,-41.26,592,373,-219,-36.99,BARRA DO ROCHA BA,-14.2090974,-39.6004395,4,1864
BA,BARREIRAS,3560,3823,263,7.39,2442,2438,-4,-0.16,2738,2154,-584,-21.33,8367,8410,43,0.51,13933,14945,1012,7.26,31040,31770,730,2.35,BARREIRAS BA,-12.1440031,-44.9967406,4,1865
BA,BARRO ALTO,0,0,0,0.0,0,0,0,0.0,0,0,0,0.0,69,66,-3,-4.35,583,608,25,4.29,652,674,22,3.37,BARRO ALTO BA,-11.7618025,-41.9094904,4,1866
BA,BARROCAS,1,1,0,0.0,721,734,13,1.8,386,316,-70,-18.13,84,72,-12,-14.29,645,586,-59,-9.15,1837,1709,-128,-6.97,BARROCAS BA,-11.5338665,-39.0802106,4,1867
BA,BARRO PRETO,116,124,8,6.9,2,2,0,0.0,0,0,0,0.0,29,35,6,20.69,481,372,-109,-22.66,628,533,-95,-15.13,BARRO PRETO BA,-14.8068289,-39.4727588,4,1868
BA,BELMONTE,323,391,68,21.05,172,167,-5,-2.91,2,5,3,150.0,191,184,-7,-3.66,908,861,-47,-5.18,1596,1608,12,0.75,BELMONTE BA,-15.8630837,-38.8792845,4,1869
BA,BELO CAMPO,21,21,0,0.0,60,67,7,11.67,0,0,0,0.0,163,167,4,2.45,695,635,-60,-8.63,939,890,-49,-5.22,BELO CAMPO BA,-15.0338286,-41.2585109,4,1870
BA,BIRITINGA,81,119,38,46.91,0,0,0,0.0,1,2,1,100.0,85,90,5,5.88,790,747,-43,-5.44,957,958,1,0.1,BIRITINGA BA,-11.6227908,-38.8066738,4,1871
BA,BOA NOVA,30,50,20,66.67,13,9,-4,-30.77,0,0,0,0.0,116,118,2,1.72,663,641,-22,-3.32,822,818,-4,-0.49,BOA NOVA BA,-14.365907,-40.2063056,4,1872
BA,BOA VISTA DO TUPIM,80,88,8,10.0,105,83,-22,-20.95,1,1,0,0.0,102,101,-1,-0.98,783,603,-180,-22.99,1071,876,-195,-18.21,BOA VISTA DO TUPIM BA,-12.6605988,-40.6083594,4,1873
BA,BOM JESUS DA LAPA,698,749,51,7.31,354,376,22,6.21,176,118,-58,-32.95,2410,2322,-88,-3.65,4164,4418,254,6.1,7802,7983,181,2.32,BOM JESUS DA LAPA BA,-13.250571,-43.410754,4,1874
BA,BOM JESUS DA SERRA,0,0,0,0.0,0,0,0,0.0,0,0,0,0.0,34,35,1,2.94,416,386,-30,-7.21,450,421,-29,-6.44,BOM JESUS DA SERRA BA,-14.37483,-40.5057687,4,1875
BA,BONINAL,0,0,0,0.0,1,11,10,1000.0,1,0,-1,-100.0,129,150,21,16.28,508,419,-89,-17.52,639,580,-59,-9.23,BONINAL BA,-12.7095183,-41.8299984,4,1876
BA,BONITO,45,72,27,60.0,1119,1311,192,17.16,0,0,0,0.0,27,25,-2,-7.41,732,611,-121,-16.53,1923,2019,96,4.99,BONITO BA,-11.9665473,-41.2649896,4,1877
BA,BOQUIRA,2,1,-1,-50.0,40,37,-3,-7.5,5,5,0,0.0,216,201,-15,-6.94,1114,1301,187,16.79,1377,1545,168,12.2,BOQUIRA BA,-12.8184859,-42.7270883,4,1878
BA,BOTUPORA,1,2,1,100.0,12,10,-2,-16.67,0,0,0,0.0,58,52,-6,-10.34,293,44,-249,-84.98,364,108,-256,-70.33,BOTUPORA BA,-13.3744752,-42.5198469,4,1879
BA,BREJOLANDIA,75,59,-16,-21.33,1,1,0,0.0,1,2,1,100.0,40,36,-4,-10.0,451,591,140,31.04,568,689,121,21.3,BREJOLANDIA BA,-12.4843845,-43.9611861,4,1881
BA,BROTAS DE MACAUBAS,0,0,0,0.0,14,9,-5,-35.71,5,0,-5,-100.0,63,61,-2,-3.17,409,417,8,1.96,491,487,-4,-0.81,BROTAS DE MACAUBAS BA,-12.0019007,-42.6257506,4,1882
BA,BRUMADO,87,82,-5,-5.75,2412,2313,-99,-4.1,4177,3672,-505,-12.09,3113,3025,-88,-2.83,4756,4732,-24,-0.5,14545,13824,-721,-4.96,BRUMADO BA,-14.2950215,-41.65923973294132,4,1883
BA,BUERAREMA,143,140,-3,-2.1,12,20,8,66.67,1,1,0,0.0,327,283,-44,-13.46,893,107,-786,-88.02,1376,551,-825,-59.96,BUERAREMA BA,-14.9571177,-39.3008035,4,1884
BA,BURITIRAMA,1,1,0,0.0,1,1,0,0.0,0,0,0,0.0,68,57,-11,-16.18,899,806,-93,-10.34,969,865,-104,-10.73,BURITIRAMA BA,-10.7148421,-43.6362327,4,1885
BA,CAATIBA,140,132,-8,-5.71,79,75,-4,-5.06,0,0,0,0.0,19,24,5,26.32,514,509,-5,-0.97,752,740,-12,-1.6,CAATIBA BA,-14.9782759,-40.4092325,4,1886
BA,CABACEIRAS DO PARAGUACU,54,38,-16,-29.63,56,74,18,32.14,4,4,0,0.0,153,161,8,5.23,837,597,-240,-28.67,1104,874,-230,-20.83,CABACEIRAS DO PARAGUACU BA,-12.5377868,-39.1901339,4,1887
BA,CACULE,16,13,-3,-18.75,561,511,-50,-8.91,17,17,0,0.0,1104,1147,43,3.89,1360,1358,-2,-0.15,3058,3046,-12,-0.39,CACULE BA,-14.4990734,-42.2233006,4,1889
BA,CAEM,8,7,-1,-12.5,28,25,-3,-10.71,18,6,-12,-66.67,31,29,-2,-6.45,404,365,-39,-9.65,489,432,-57,-11.66,CAEM BA,-11.0909658,-40.4322187,4,1890
BA,CAETANOS,21,23,2,9.52,23,22,-1,-4.35,9,13,4,44.44,42,41,-1,-2.38,577,619,42,7.28,672,718,46,6.85,CAETANOS BA,-14.3387456,-40.9085971,4,1891
BA,CAETITE,65,62,-3,-4.62,1243,1269,26,2.09,64,172,108,168.75,1326,1195,-131,-9.88,3071,2389,-682,-22.21,5769,5087,-682,-11.82,CAETITE BA,-14.0691776,-42.4852428,4,1892
BA,CAFARNAUM,0,0,0,0.0,1,4,3,300.0,0,0,0,0.0,193,179,-14,-7.25,630,846,216,34.29,824,1029,205,24.88,CAFARNAUM BA,-11.691399,-41.468823,4,1893
BA,CAIRU,78,39,-39,-50.0,8,4,-4,-50.0,23,8,-15,-65.22,381,295,-86,-22.57,2861,2179,-682,-23.84,3351,2525,-826,-24.65,CAIRU BA,-13.4860505,-39.0455744,4,1894
BA,CALDEIRAO GRANDE,5,6,1,20.0,1,0,-1,-100.0,64,5,-59,-92.19,45,42,-3,-6.67,613,460,-153,-24.96,728,513,-215,-29.53,CALDEIRAO GRANDE BA,-11.0208483,-40.3041387,4,1895
BA,CAMACAN,212,191,-21,-9.91,377,395,18,4.77,9,5,-4,-44.44,601,550,-51,-8.49,1461,1557,96,6.57,2660,2698,38,1.43,CAMACAN BA,-15.4166631,-39.4930088,4,1896
BA,CAMAMU,141,125,-16,-11.35,233,206,-27,-11.59,10,12,2,20.0,584,555,-29,-4.97,1441,1083,-358,-24.84,2409,1981,-428,-17.77,CAMAMU BA,-13.9438142,-39.1060917,4,1898
BA,CAMPO ALEGRE DE LOURDES,0,9,9,0.0,225,239,14,6.22,18,10,-8,-44.44,176,186,10,5.68,881,808,-73,-8.29,1300,1252,-48,-3.69,CAMPO ALEGRE DE LOURDES BA,-9.5160326,-43.0101338,4,1899
BA,CAMPO FORMOSO,12,12,0,0.0,528,671,143,27.08,191,412,221,115.71,958,948,-10,-1.04,2861,2710,-151,-5.28,4550,4753,203,4.46,CAMPO FORMOSO BA,-10.51055,-40.320031,4,1900
BA,CANAPOLIS,3,4,1,33.33,1,0,-1,-100.0,24,18,-6,-25.0,58,55,-3,-5.17,677,605,-72,-10.64,763,682,-81,-10.62,CANAPOLIS BA,-13.072454,-44.200949,4,1901
BA,CANARANA,3,4,1,33.33,15,19,4,26.67,3,7,4,133.33,272,257,-15,-5.51,938,678,-260,-27.72,1231,965,-266,-21.61,CANARANA BA,-11.6870151,-41.7683675,4,1902
BA,CANAVIEIRAS,359,336,-23,-6.41,22,27,5,22.73,19,17,-2,-10.53,598,571,-27,-4.52,1616,1283,-333,-20.61,2614,2234,-380,-14.54,CANAVIEIRAS BA,-15.6790128,-38.9449622,4,1903
BA,CANDEAL,21,15,-6,-28.57,0,6,6,0.0,6,6,0,0.0,29,28,-1,-3.45,456,17,-439,-96.27,512,72,-440,-85.94,CANDEAL BA,-11.8053441,-39.1206515,4,1904
BA,CANDIBA,20,20,0,0.0,115,111,-4,-3.48,1,1,0,0.0,118,114,-4,-3.39,385,50,-335,-87.01,639,296,-343,-53.68,CANDIBA BA,-14.4125032,-42.8714102,4,1906
BA,CANDIDO SALES,72,91,19,26.39,13,16,3,23.08,0,0,0,0.0,191,245,54,28.27,1097,1056,-41,-3.74,1373,1408,35,2.55,CANDIDO SALES BA,-15.5037649,-41.2391141,4,1907
BA,CANSANCAO,18,21,3,16.67,66,68,2,3.03,2,2,0,0.0,357,343,-14,-3.92,1481,1194,-287,-19.38,1924,1628,-296,-15.38,CANSANCAO BA,-10.6671448,-39.498199,4,1908
BA,CANUDOS,7,3,-4,-57.14,4,14,10,250.0,2,3,1,50.0,104,107,3,2.88,650,647,-3,-0.46,767,774,7,0.91,CANUDOS BA,-9.8948692,-39.0266244,4,1909
BA,CAPELA DO ALTO ALEGRE,7,9,2,28.57,33,47,14,42.42,0,2,2,0.0,85,78,-7,-8.24,608,558,-50,-8.22,733,694,-39,-5.32,CAPELA DO ALTO ALEGRE BA,-11.6703944,-39.8362745,4,1910
BA,CAPIM GROSSO,3,3,0,0.0,230,205,-25,-10.87,25,27,2,8.0,1263,1278,15,1.19,2110,2437,327,15.5,3631,3950,319,8.79,CAPIM GROSSO BA,-11.3793228,-40.0112095,4,1911
BA,CARAIBAS,91,115,24,26.37,13,11,-2,-15.38,11,6,-5,-45.45,57,55,-2,-3.51,521,599,78,14.97,693,786,93,13.42,CARAIBAS BA,-14.72496,-41.2566163,4,1912
BA,CARAVELAS,610,704,94,15.41,22,35,13,59.09,1,1,0,0.0,226,205,-21,-9.29,1304,1290,-14,-1.07,2163,2235,72,3.33,CARAVELAS BA,-17.7296514,-39.2660082,4,1913
BA,CARDEAL DA SILVA,12,13,1,8.33,46,51,5,10.87,0,0,0,0.0,48,44,-4,-8.33,437,269,-168,-38.44,543,377,-166,-30.57,CARDEAL DA SILVA BA,-11.9428154,-37.9494462,4,1914
BA,CARINHANHA,135,104,-31,-22.96,49,49,0,0.0,2,2,0,0.0,150,148,-2,-1.33,953,866,-87,-9.13,1289,1169,-120,-9.31,CARINHANHA BA,-14.298524,-43.772349,4,1915
BA,CASA NOVA,5123,5532,409,7.98,315,339,24,7.62,2,3,1,50.0,752,770,18,2.39,3199,3494,295,9.22,9391,10138,747,7.95,CASA NOVA BA,-9.1736775,-40.9734475,4,1916
BA,CASTRO ALVES,141,136,-5,-3.55,593,686,93,15.68,67,73,6,8.96,366,402,36,9.84,2070,1783,-287,-13.86,3237,3080,-157,-4.85,CASTRO ALVES BA,-12.7616941,-39.4281088,4,1917
BA,CATOLANDIA,9,8,-1,-11.11,0,0,0,0.0,4,3,-1,-25.0,98,83,-15,-15.31,259,242,-17,-6.56,370,336,-34,-9.19,CATOLANDIA BA,-12.315088,-44.8616434,4,1918
BA,CATU,98,75,-23,-23.47,2059,1800,-259,-12.58,165,156,-9,-5.45,1145,1036,-109,-9.52,4186,3619,-567,-13.55,7653,6686,-967,-12.64,CATU BA,-12.351274,-38.379108,4,1919
BA,CATURAMA,0,0,0,0.0,16,21,5,31.25,0,0,0,0.0,19,22,3,15.79,24,197,173,720.83,59,240,181,306.78,CATURAMA BA,-13.3309299,-42.2927623,4,1920
BA,CENTRAL,5,4,-1,-20.0,1,1,0,0.0,26,0,-26,-100.0,79,73,-6,-7.59,847,740,-107,-12.63,958,818,-140,-14.61,CENTRAL BA,-11.1338739,-42.1095822,4,1921
BA,CHORROCHO,0,0,0,0.0,17,13,-4,-23.53,18,18,0,0.0,40,41,1,2.5,323,307,-16,-4.95,398,379,-19,-4.77,CHORROCHO BA,-8.9774059,-39.0993132,4,1922
BA,CICERO DANTAS,11,10,-1,-9.09,14,14,0,0.0,8,8,0,0.0,513,494,-19,-3.7,1609,1486,-123,-7.64,2155,2012,-143,-6.64,CICERO DANTAS BA,-10.5932265,-38.3834411,4,1923
BA,CIPO,11,11,0,0.0,5,1,-4,-80.0,0,0,0,0.0,123,174,51,41.46,713,585,-128,-17.95,852,771,-81,-9.51,CIPO BA,-11.0990534,-38.5153006,4,1924
BA,COARACI,104,123,19,18.27,15,14,-1,-6.67,4,2,-2,-50.0,261,268,7,2.68,1459,1367,-92,-6.31,1843,1774,-69,-3.74,COARACI BA,-14.6407979,-39.5496765,4,1925
BA,COCOS,1168,1191,23,1.97,15,12,-3,-20.0,26,25,-1,-3.85,180,164,-16,-8.89,1086,1047,-39,-3.59,2475,2439,-36,-1.45,COCOS BA,-14.1811222,-44.5382117,4,1926
BA,CONCEICAO DA FEIRA,1001,1097,96,9.59,438,605,167,38.13,6,10,4,66.67,359,349,-10,-2.79,955,817,-138,-14.45,2759,2878,119,4.31,CONCEICAO DA FEIRA BA,-12.5013001,-39.0002166,4,1927
BA,CONCEICAO DO COITE,43,41,-2,-4.65,1571,1775,204,12.99,99,132,33,33.33,1435,1388,-47,-3.28,2674,2349,-325,-12.15,5822,5685,-137,-2.35,CONCEICAO DO COITE BA,-11.5629384,-39.2839543,4,1929
BA,CONCEICAO DO JACUIPE,118,131,13,11.02,2850,3381,531,18.63,646,533,-113,-17.49,1372,1450,78,5.69,2319,2093,-226,-9.75,7305,7588,283,3.87,CONCEICAO DO JACUIPE BA,-12.326831,-38.768433,4,1930
BA,CONDE,183,170,-13,-7.1,1014,1232,218,21.5,63,58,-5,-7.94,1637,1794,157,9.59,2791,1731,-1060,-37.98,5688,4985,-703,-12.36,CONDE BA,-11.8129758,-37.6138705,4,1931
BA,CONDEUBA,13,18,5,38.46,533,455,-78,-14.63,21,23,2,9.52,166,180,14,8.43,964,874,-90,-9.34,1697,1550,-147,-8.66,CONDEUBA BA,-14.902227,-41.971829,4,1932
BA,CONTENDAS DO SINCORA,7,10,3,42.86,0,0,0,0.0,0,0,0,0.0,38,37,-1,-2.63,247,255,8,3.24,292,302,10,3.42,CONTENDAS DO SINCORA BA,-13.7612283,-41.0421315,4,1933
BA,CORACAO DE MARIA,64,71,7,10.94,294,399,105,35.71,9,20,11,122.22,390,373,-17,-4.36,1084,1079,-5,-0.46,1841,1942,101,5.49,CORACAO DE MARIA BA,-12.2484345,-38.7499274,4,1934
BA,CORDEIROS,3,3,0,0.0,56,54,-2,-3.57,0,0,0,0.0,55,58,3,5.45,460,448,-12,-2.61,574,563,-11,-1.92,CORDEIROS BA,-15.0397219,-41.9314228,4,1935
BA,CORIBE,66,71,5,7.58,13,1,-12,-92.31,0,0,0,0.0,120,99,-21,-17.5,675,598,-77,-11.41,874,769,-105,-12.01,CORIBE BA,-13.828471,-44.45727,4,1936
BA,CORONEL JOAO SA,7,9,2,28.57,0,0,0,0.0,0,3,3,0.0,85,89,4,4.71,980,937,-43,-4.39,1072,1038,-34,-3.17,CORONEL JOAO SA BA,-10.2856387,-37.9259435,4,1937
BA,CORRENTINA,1992,2554,562,28.21,91,90,-1,-1.1,33,35,2,6.06,784,811,27,3.44,2262,2269,7,0.31,5162,5759,597,11.57,CORRENTINA BA,-13.344157,-44.6345066,4,1938
BA,COTEGIPE,173,192,19,10.98,0,0,0,0.0,34,2,-32,-94.12,73,70,-3,-4.11,865,802,-63,-7.28,1145,1066,-79,-6.9,COTEGIPE BA,-12.0315387,-44.260401,4,1939
BA,CRAVOLANDIA,8,7,-1,-12.5,0,0,0,0.0,1,1,0,0.0,33,30,-3,-9.09,341,313,-28,-8.21,383,351,-32,-8.36,CRAVOLANDIA BA,-13.3576247,-39.8153954,4,1940
BA,CRISOPOLIS,83,92,9,10.84,21,16,-5,-23.81,4,12,8,200.0,148,150,2,1.35,875,804,-71,-8.11,1131,1074,-57,-5.04,CRISOPOLIS BA,-11.5105813,-38.1506278,4,1941
BA,CRISTOPOLIS,16,13,-3,-18.75,0,0,0,0.0,0,0,0,0.0,93,93,0,0.0,659,531,-128,-19.42,768,637,-131,-17.06,CRISTOPOLIS BA,-12.2349301,-44.4160811,4,1942
BA,CRUZ DAS ALMAS,152,195,43,28.29,1318,1259,-59,-4.48,253,297,44,17.39,3519,3375,-144,-4.09,5911,5191,-720,-12.18,11153,10317,-836,-7.5,CRUZ DAS ALMAS BA,-12.6722649,-39.1053665,4,1943
BA,CURACA,284,312,28,9.86,33,30,-3,-9.09,5,3,-2,-40.0,285,291,6,2.11,1559,1264,-295,-18.92,2166,1900,-266,-12.28,CURACA BA,-8.9925655,-39.9053169,4,1944
BA,DARIO MEIRA,89,87,-2,-2.25,0,0,0,0.0,0,0,0,0.0,107,105,-2,-1.87,688,685,-3,-0.44,884,877,-7,-0.79,DARIO MEIRA BA,-14.4332181,-39.9028712,4,1945
BA,DOM BASILIO,50,45,-5,-10.0,19,24,5,26.32,0,0,0,0.0,145,146,1,0.69,643,567,-76,-11.82,857,782,-75,-8.75,DOM BASILIO BA,-13.7589818,-41.7715676,4,1947
BA,DOM MACEDO COSTA,10,11,1,10.0,2,5,3,150.0,0,3,3,0.0,28,24,-4,-14.29,231,224,-7,-3.03,271,267,-4,-1.48,DOM MACEDO COSTA BA,-12.907806,-39.1905875,4,1948
BA,ELISIO MEDRADO,17,22,5,29.41,31,32,1,3.23,0,0,0,0.0,50,48,-2,-4.0,291,304,13,4.47,389,406,17,4.37,ELISIO MEDRADO BA,-12.9469824,-39.520431,4,1949
BA,ENCRUZILHADA,342,342,0,0.0,9,1,-8,-88.89,0,2,2,0.0,123,106,-17,-13.82,1027,835,-192,-18.7,1501,1286,-215,-14.32,ENCRUZILHADA BA,-15.5322113,-40.9072488,4,1950
BA,ENTRE RIOS,666,730,64,9.61,217,226,9,4.15,104,88,-16,-15.38,779,760,-19,-2.44,2519,2173,-346,-13.74,4285,3977,-308,-7.19,ENTRE RIOS BA,-11.9423743,-38.0836985,4,1951
BA,ESPLANADA,241,248,7,2.9,667,651,-16,-2.4,296,264,-32,-10.81,591,611,20,3.38,2200,1842,-358,-16.27,3995,3616,-379,-9.49,ESPLANADA BA,-11.800614,-37.9453,4,1952
BA,EUCLIDES DA CUNHA,16,19,3,18.75,191,209,18,9.42,30,29,-1,-3.33,1080,1084,4,0.37,2360,2207,-153,-6.48,3677,3548,-129,-3.51,EUCLIDES DA CUNHA BA,-10.5060835,-39.0129875,4,1953
BA,EUNAPOLIS,3382,2869,-513,-15.17,2449,2548,99,4.04,443,764,321,72.46,6252,5884,-368,-5.89,9802,8993,-809,-8.25,22328,21058,-1270,-5.69,EUNAPOLIS BA,-16.3722412,-39.575704,4,1954
BA,FATIMA,48,57,9,18.75,8,6,-2,-25.0,32,10,-22,-68.75,71,69,-2,-2.82,211,202,-9,-4.27,370,344,-26,-7.03,FATIMA BA,-10.5944103,-38.2118405,4,1955
BA,FEIRA DA MATA,17,15,-2,-11.76,0,0,0,0.0,1,0,-1,-100.0,42,43,1,2.38,283,349,66,23.32,343,407,64,18.66,FEIRA DA MATA BA,-14.2117024,-44.2822314,4,1956
BA,FEIRA DE SANTANA,695,628,-67,-9.64,19100,19552,452,2.37,8272,8547,275,3.32,36665,35592,-1073,-2.93,53040,52177,-863,-1.63,117772,116496,-1276,-1.08,FEIRA DE SANTANA BA,-12.2578934,-38.9598047,4,1957
BA,FILADELFIA,104,104,0,0.0,44,22,-22,-50.0,0,0,0,0.0,50,46,-4,-8.0,435,392,-43,-9.89,633,564,-69,-10.9,FILADELFIA BA,-10.7418885,-40.1304175,4,1958
BA,FIRMINO ALVES,71,58,-13,-18.31,415,343,-72,-17.35,0,0,0,0.0,23,33,10,43.48,380,249,-131,-34.47,889,683,-206,-23.17,FIRMINO ALVES BA,-14.9871017,-39.9242157,4,1959
BA,FLORESTA AZUL,117,126,9,7.69,4,3,-1,-25.0,2,7,5,250.0,77,74,-3,-3.9,439,472,33,7.52,639,682,43,6.73,FLORESTA AZUL BA,-14.8602238,-39.6561384,4,1960
BA,FORMOSA DO RIO PRETO,1885,2363,478,25.36,116,111,-5,-4.31,33,54,21,63.64,428,424,-4,-0.93,1505,1362,-143,-9.5,3967,4314,347,8.75,FORMOSA DO RIO PRETO BA,-11.0414544,-45.1903983,4,1961
BA,GANDU,285,271,-14,-4.91,154,165,11,7.14,53,35,-18,-33.96,1075,1022,-53,-4.93,1550,1735,185,11.94,3117,3228,111,3.56,GANDU BA,-13.7448138,-39.4844732,4,1962
BA,GAVIAO,0,1,1,0.0,0,0,0,0.0,1,1,0,0.0,10,12,2,20.0,362,324,-38,-10.5,373,338,-35,-9.38,GAVIAO BA,-11.4714303,-39.7826316,4,1963
BA,GENTIO DO OURO,0,0,0,0.0,9,8,-1,-11.11,0,5,5,0.0,35,36,1,2.86,625,470,-155,-24.8,669,519,-150,-22.42,GENTIO DO OURO BA,-11.4302137,-42.5063185,4,1964
BA,GLORIA,179,200,21,11.73,31,31,0,0.0,11,13,2,18.18,55,55,0,0.0,648,634,-14,-2.16,924,933,9,0.97,GLORIA BA,-9.3429057,-38.2552548,4,1965
BA,GONGOGI,164,172,8,4.88,19,16,-3,-15.79,0,0,0,0.0,68,72,4,5.88,431,699,268,62.18,682,959,277,40.62,GONGOGI BA,-14.3240248,-39.4665106,4,1966
BA,GUAJERU,1,1,0,0.0,24,22,-2,-8.33,0,0,0,0.0,44,49,5,11.36,529,402,-127,-24.01,598,474,-124,-20.74,GUAJERU BA,-14.5464079,-41.9379047,4,1968
BA,GUANAMBI,169,147,-22,-13.02,1251,1264,13,1.04,643,676,33,5.13,3999,3965,-34,-0.85,5143,5069,-74,-1.44,11205,11121,-84,-0.75,GUANAMBI BA,-14.223066,-42.779943,4,1969
BA,GUARATINGA,442,423,-19,-4.3,40,23,-17,-42.5,0,0,0,0.0,123,131,8,6.5,1058,1095,37,3.5,1663,1672,9,0.54,GUARATINGA BA,-16.5802498,-39.7808088,4,1970
BA,HELIOPOLIS,2,4,2,100.0,7,5,-2,-28.57,8,4,-4,-50.0,103,97,-6,-5.83,610,511,-99,-16.23,730,621,-109,-14.93,HELIOPOLIS BA,-10.6753416,-38.2815308,4,1971
BA,IACU,195,421,226,115.9,62,126,64,103.23,52,11,-41,-78.85,272,235,-37,-13.6,1490,694,-796,-53.42,2071,1487,-584,-28.2,IACU BA,-12.7672074,-40.2106427,4,1972
BA,IBIASSUCE,2,2,0,0.0,168,150,-18,-10.71,2,2,0,0.0,112,106,-6,-5.36,503,477,-26,-5.17,787,737,-50,-6.35,IBIASSUCE BA,-14.2713813,-42.2576112,4,1973
BA,IBICARAI,117,147,30,25.64,157,205,48,30.57,36,29,-7,-19.44,361,326,-35,-9.7,1300,917,-383,-29.46,1971,1624,-347,-17.61,IBICARAI BA,-14.8625311,-39.5890865,4,1974
BA,IBICOARA,920,1199,279,30.33,44,40,-4,-9.09,6,5,-1,-16.67,210,201,-9,-4.29,1116,877,-239,-21.42,2296,2322,26,1.13,IBICOARA BA,-13.413079,-41.285121,4,1975
BA,IBICUI,292,283,-9,-3.08,347,130,-217,-62.54,2,3,1,50.0,153,150,-3,-1.96,745,714,-31,-4.16,1539,1280,-259,-16.83,IBICUI BA,-14.84496,-39.987915,4,1976
BA,IBIPEBA,132,143,11,8.33,0,0,0,0.0,0,1,1,0.0,92,88,-4,-4.35,555,557,2,0.36,779,789,10,1.28,IBIPEBA BA,-11.6425335,-42.0083068,4,1977
BA,IBIPITANGA,0,6,6,0.0,9,9,0,0.0,3,2,-1,-33.33,94,103,9,9.57,679,679,0,0.0,785,799,14,1.78,IBIPITANGA BA,-12.880435,-42.485568,4,1978
BA,IBIQUERA,31,34,3,9.68,0,0,0,0.0,0,0,0,0.0,8,12,4,50.0,197,191,-6,-3.05,236,237,1,0.42,IBIQUERA BA,-12.6489164,-40.9323004,4,1979
BA,IBIRAPITANGA,175,149,-26,-14.86,2,1,-1,-50.0,1,2,1,100.0,112,83,-29,-25.89,994,652,-342,-34.41,1284,887,-397,-30.92,IBIRAPITANGA BA,-14.1615686,-39.369522,4,1980
BA,IBIRAPUA,379,389,10,2.64,963,1067,104,10.8,81,76,-5,-6.17,175,153,-22,-12.57,440,460,20,4.55,2038,2145,107,5.25,IBIRAPUA BA,-17.6873491,-40.109661,4,1981
BA,IBIRATAIA,267,267,0,0.0,244,211,-33,-13.52,1,7,6,600.0,299,278,-21,-7.02,1061,976,-85,-8.01,1872,1739,-133,-7.1,IBIRATAIA BA,-14.0689024,-39.6394008,4,1982
BA,IBITIARA,0,0,0,0.0,5,4,-1,-20.0,0,0,0,0.0,48,45,-3,-6.25,434,378,-56,-12.9,487,427,-60,-12.32,IBITIARA BA,-12.6493766,-42.2172476,4,1983
BA,IBITITA,5,6,1,20.0,20,19,-1,-5.0,0,0,0,0.0,58,52,-6,-10.34,665,529,-136,-20.45,748,606,-142,-18.98,IBITITA BA,-11.5461033,-41.9781838,4,1984
BA,IBOTIRAMA,16,16,0,0.0,225,230,5,2.22,194,315,121,62.37,764,777,13,1.7,1439,539,-900,-62.54,2638,1877,-761,-28.85,IBOTIRAMA BA,-12.1829519,-43.2181138,4,1985
BA,ICHU,7,8,1,14.29,18,22,4,22.22,0,0,0,0.0,17,19,2,11.76,301,338,37,12.29,343,387,44,12.83,ICHU BA,-11.7495556,-39.1905275,4,1986
BA,IGAPORA,21,23,2,9.52,87,97,10,11.49,2,6,4,200.0,125,123,-2,-1.6,764,501,-263,-34.42,999,750,-249,-24.92,IGAPORA BA,-13.7725318,-42.7168442,4,1987
BA,IGRAPIUNA,513,527,14,2.73,166,73,-93,-56.02,2,2,0,0.0,42,47,5,11.9,706,547,-159,-22.52,1429,1196,-233,-16.31,IGRAPIUNA BA,-13.8227115,-39.1419857,4,1988
BA,IGUAI,110,112,2,1.82,187,57,-130,-69.52,1,1,0,0.0,264,258,-6,-2.27,1071,920,-151,-14.1,1633,1348,-285,-17.45,IGUAI BA,-14.752754,-40.089417,4,1989
BA,ILHEUS,1331,1342,11,0.83,3376,3431,55,1.63,954,927,-27,-2.83,6483,6196,-287,-4.43,14644,17509,2865,19.56,26788,29405,2617,9.77,ILHEUS BA,-14.792599,-39.0453843,4,1990
BA,INHAMBUPE,592,629,37,6.25,146,220,74,50.68,10,6,-4,-40.0,383,422,39,10.18,1459,1421,-38,-2.6,2590,2698,108,4.17,INHAMBUPE BA,-11.7921718,-38.3596957,4,1991
BA,IPECAETA,15,21,6,40.0,3,13,10,333.33,0,0,0,0.0,34,32,-2,-5.88,1016,798,-218,-21.46,1068,864,-204,-19.1,IPECAETA BA,-12.3158261,-39.306421,4,1992
BA,IPIAU,148,179,31,20.95,516,723,207,40.12,64,89,25,39.06,1705,1533,-172,-10.09,1947,2209,262,13.46,4380,4733,353,8.06,IPIAU BA,-14.1318211,-39.7373177,4,1993
BA,IPIRA,150,149,-1,-0.67,2168,2098,-70,-3.23,86,56,-30,-34.88,901,928,27,3.0,2509,2407,-102,-4.07,5814,5638,-176,-3.03,IPIRA BA,-12.1578337,-39.7416605,4,1994
BA,IPUPIARA,0,0,0,0.0,29,27,-2,-6.9,29,82,53,182.76,298,312,14,4.7,473,528,55,11.63,829,949,120,14.48,IPUPIARA BA,-11.82207,-42.6111388,4,1995
BA,IRAJUBA,5,3,-2,-40.0,0,0,0,0.0,3,3,0,0.0,45,34,-11,-24.44,366,312,-54,-14.75,419,352,-67,-15.99,IRAJUBA BA,-13.2525307,-40.0842042,4,1996
BA,IRAMAIA,46,42,-4,-8.7,0,0,0,0.0,0,0,0,0.0,50,56,6,12.0,472,379,-93,-19.7,568,477,-91,-16.02,IRAMAIA BA,-13.2937451,-40.9576036,4,1997
BA,IRAQUARA,26,20,-6,-23.08,304,277,-27,-8.88,9,14,5,55.56,201,194,-7,-3.48,805,722,-83,-10.31,1345,1227,-118,-8.77,IRAQUARA BA,-12.2439075,-41.6169181,4,1998
BA,IRARA,57,35,-22,-38.6,48,32,-16,-33.33,27,6,-21,-77.78,449,443,-6,-1.34,1063,1284,221,20.79,1644,1800,156,9.49,IRARA BA,-12.0420271,-38.7635638,4,1999
BA,IRECE,40,40,0,0.0,697,727,30,4.3,169,414,245,144.97,4591,4369,-222,-4.84,6389,6320,-69,-1.08,11886,11870,-16,-0.13,IRECE BA,-11.3034965,-41.8557929,4,2000
BA,ITABELA,858,850,-8,-0.93,327,361,34,10.4,54,17,-37,-68.52,697,732,35,5.02,1563,1160,-403,-25.78,3499,3120,-379,-10.83,ITABELA BA,-16.5743392,-39.561961,4,2001
BA,ITABERABA,301,306,5,1.66,2113,2612,499,23.62,100,65,-35,-35.0,2254,2172,-82,-3.64,3776,2812,-964,-25.53,8544,7967,-577,-6.75,ITABERABA BA,-12.524182,-40.305897,4,2002
BA,ITABUNA,877,662,-215,-24.52,4985,4685,-300,-6.02,1295,1663,368,28.42,9940,9643,-297,-2.99,24881,21608,-3273,-13.15,41978,38261,-3717,-8.85,ITABUNA BA,-14.7935179,-39.274318,4,2003
BA,ITACARE,417,411,-6,-1.44,12,18,6,50.0,33,23,-10,-30.3,530,509,-21,-3.96,2566,2565,-1,-0.04,3558,3526,-32,-0.9,ITACARE BA,-14.2781298,-38.9951418,4,2004
BA,ITAETE,84,90,6,7.14,0,0,0,0.0,0,0,0,0.0,77,86,9,11.69,687,329,-358,-52.11,848,505,-343,-40.45,ITAETE BA,-12.9794728,-40.9661685,4,2005
BA,ITAGI,48,39,-9,-18.75,10,10,0,0.0,2,10,8,400.0,97,94,-3,-3.09,565,528,-37,-6.55,722,681,-41,-5.68,ITAGI BA,-14.1627902,-40.0069366,4,2006
BA,ITAGIBA,478,445,-33,-6.9,348,401,53,15.23,6,901,895,14916.67,98,100,2,2.04,824,641,-183,-22.21,1754,2488,734,41.85,ITAGIBA BA,-14.2891521,-39.8452592,4,2007
BA,ITAGIMIRIM,217,239,22,10.14,26,39,13,50.0,138,19,-119,-86.23,70,68,-2,-2.86,536,400,-136,-25.37,987,765,-222,-22.49,ITAGIMIRIM BA,-16.0852591,-39.614789,4,2008
BA,ITAGUACU DA BAHIA,12,12,0,0.0,23,14,-9,-39.13,0,0,0,0.0,24,26,2,8.33,31,393,362,1167.74,90,445,355,394.44,ITAGUACU DA BAHIA BA,-11.0116542,-42.3984029,4,2009
BA,ITAJU DO COLONIA,169,156,-13,-7.69,9,9,0,0.0,0,0,0,0.0,32,38,6,18.75,561,562,1,0.18,771,765,-6,-0.78,ITAJU DO COLONIA BA,-15.1415094,-39.7230045,4,2010
BA,ITAJUIPE,210,222,12,5.71,340,419,79,23.24,1,0,-1,-100.0,255,217,-38,-14.9,792,165,-627,-79.17,1598,1023,-575,-35.98,ITAJUIPE BA,-14.6744381,-39.3759427,4,2011
BA,ITAMARAJU,2154,1448,-706,-32.78,473,449,-24,-5.07,1316,133,-1183,-89.89,1927,1954,27,1.4,3078,3150,72,2.34,8948,7134,-1814,-20.27,ITAMARAJU BA,-17.0363103,-39.527994,4,2012
BA,ITAMARI,23,26,3,13.04,24,24,0,0.0,0,0,0,0.0,23,19,-4,-17.39,388,372,-16,-4.12,458,441,-17,-3.71,ITAMARI BA,-13.778192,-39.682959,4,2013
BA,ITAMBE,858,712,-146,-17.02,289,262,-27,-9.34,8,8,0,0.0,1039,1007,-32,-3.08,1679,1722,43,2.56,3873,3711,-162,-4.18,ITAMBE BA,-15.2435245,-40.6269506,4,2014
BA,ITANAGRA,58,54,-4,-6.9,51,42,-9,-17.65,3,2,-1,-33.33,31,38,7,22.58,522,233,-289,-55.36,665,369,-296,-44.51,ITANAGRA BA,-12.2589718,-38.0388625,4,2015
BA,ITANHEM,118,186,68,57.63,69,81,12,17.39,2,3,1,50.0,213,229,16,7.51,898,945,47,5.23,1300,1444,144,11.08,ITANHEM BA,-17.1665806,-40.3291027,4,2016
BA,ITAPE,282,251,-31,-10.99,29,50,21,72.41,3,4,1,33.33,129,110,-19,-14.73,464,433,-31,-6.68,907,848,-59,-6.5,ITAPE BA,-14.8970856,-39.4246637,4,2018
BA,ITAPEBI,212,197,-15,-7.08,22,30,8,36.36,0,0,0,0.0,90,50,-40,-44.44,758,615,-143,-18.87,1082,892,-190,-17.56,ITAPEBI BA,-15.9691891,-39.5320541,4,2019
BA,ITAPETINGA,580,639,59,10.17,5871,5826,-45,-0.77,401,483,82,20.45,1952,1889,-63,-3.23,4577,4568,-9,-0.2,13381,13405,24,0.18,ITAPETINGA BA,-15.2454478,-40.2460053,4,2020
BA,ITAPICURU,37,38,1,2.7,342,369,27,7.89,1,2,1,100.0,178,180,2,1.12,1123,1271,148,13.18,1681,1860,179,10.65,ITAPICURU BA,-11.3094471,-38.2184391,4,2021
BA,ITAPITANGA,173,163,-10,-5.78,2,0,-2,-100.0,7,1,-6,-85.71,56,56,0,0.0,644,568,-76,-11.8,882,788,-94,-10.66,ITAPITANGA BA,-14.4213865,-39.5664662,4,2022
BA,ITAQUARA,57,48,-9,-15.79,37,0,-37,-100.0,0,0,0,0.0,35,69,34,97.14,351,20,-331,-94.3,480,137,-343,-71.46,ITAQUARA BA,-13.4464331,-39.9384891,4,2023
BA,ITARANTIM,378,371,-7,-1.85,1022,548,-474,-46.38,0,0,0,0.0,153,143,-10,-6.54,1029,948,-81,-7.87,2582,2010,-572,-22.15,ITARANTIM BA,-15.6520917,-40.0599067,4,2024
BA,ITATIM,20,33,13,65.0,355,292,-63,-17.75,45,30,-15,-33.33,585,567,-18,-3.08,660,601,-59,-8.94,1665,1523,-142,-8.53,ITATIM BA,-12.7073174,-39.6974476,4,2025
BA,ITIRUCU,31,29,-2,-6.45,15,16,1,6.67,1,1,0,0.0,125,121,-4,-3.2,674,583,-91,-13.5,846,750,-96,-11.35,ITIRUCU BA,-13.5338389,-40.1502444,4,2026
BA,ITIUBA,23,18,-5,-21.74,31,28,-3,-9.68,3,9,6,200.0,253,235,-18,-7.11,1550,1228,-322,-20.77,1860,1518,-342,-18.39,ITIUBA BA,-10.6917496,-39.8532886,4,2027
BA,ITORORO,152,152,0,0.0,594,751,157,26.43,7,1,-6,-85.71,308,277,-31,-10.06,1229,1008,-221,-17.98,2290,2189,-101,-4.41,ITORORO BA,-15.1179764,-40.0680738,4,2028
BA,ITUACU,10,22,12,120.0,112,100,-12,-10.71,36,30,-6,-16.67,176,187,11,6.25,935,845,-90,-9.63,1269,1184,-85,-6.7,ITUACU BA,-13.815529,-41.2981722,4,2029
BA,ITUBERA,273,263,-10,-3.66,216,200,-16,-7.41,7,5,-2,-28.57,612,592,-20,-3.27,1196,1012,-184,-15.38,2304,2072,-232,-10.07,ITUBERA BA,-13.7360764,-39.1481058,4,2030
BA,JABORANDI,1737,2174,437,25.16,104,104,0,0.0,0,8,8,0.0,56,88,32,57.14,552,400,-152,-27.54,2449,2774,325,13.27,JABORANDI BA,-13.6203918,-44.4693394,4,2032
BA,JACARACI,1,1,0,0.0,3,3,0,0.0,3,3,0,0.0,149,141,-8,-5.37,463,533,70,15.12,619,681,62,10.02,JACARACI BA,-14.8457532,-42.4328959,4,2033
BA,JACOBINA,120,100,-20,-16.67,2208,2706,498,22.55,124,109,-15,-12.1,3206,3106,-100,-3.12,4945,4644,-301,-6.09,10603,10665,62,0.58,JACOBINA BA,-11.1851561,-40.5112434,4,2034
BA,JAGUAQUARA,81,81,0,0.0,47,51,4,8.51,50,85,35,70.0,1432,1346,-86,-6.01,2107,2037,-70,-3.32,3717,3600,-117,-3.15,JAGUAQUARA BA,-13.5294974,-39.9693081,4,2035
BA,JAGUARARI,40,62,22,55.0,1862,1912,50,2.69,36,25,-11,-30.56,377,396,19,5.04,1718,1382,-336,-19.56,4033,3777,-256,-6.35,JAGUARARI BA,-10.2575875,-40.1944363,4,2036
BA,JAGUARIPE,173,166,-7,-4.05,46,38,-8,-17.39,7,5,-2,-28.57,66,72,6,9.09,891,664,-227,-25.48,1183,945,-238,-20.12,JAGUARIPE BA,-13.1147557,-38.8944977,4,2037
BA,JANDAIRA,569,480,-89,-15.64,5,1,-4,-80.0,0,0,0,0.0,31,31,0,0.0,275,319,44,16.0,880,831,-49,-5.57,JANDAIRA BA,-11.5628009,-37.7820255,4,2038
BA,JEQUIE,385,288,-97,-25.19,5461,5612,151,2.77,1638,836,-802,-48.96,6478,6121,-357,-5.51,10634,9506,-1128,-10.61,24596,22363,-2233,-9.08,JEQUIE BA,-13.8604033,-40.0719627,4,2039
BA,JEREMOABO,28,59,31,110.71,102,99,-3,-2.94,71,90,19,26.76,331,385,54,16.31,1948,1893,-55,-2.82,2480,2526,46,1.85,JEREMOABO BA,-10.0754917,-38.3476326,4,2040
BA,JIQUIRICA,15,17,2,13.33,25,20,-5,-20.0,1,0,-1,-100.0,115,110,-5,-4.35,602,666,64,10.63,758,813,55,7.26,JIQUIRICA BA,-13.255353,-39.5693044,4,2041
BA,JITAUNA,68,68,0,0.0,17,27,10,58.82,0,9,9,0.0,174,168,-6,-3.45,589,536,-53,-9.0,848,808,-40,-4.72,JITAUNA BA,-14.017019,-39.8889976,4,2042
BA,JOAO DOURADO,49,45,-4,-8.16,17,18,1,5.88,15,12,-3,-20.0,372,356,-16,-4.3,964,878,-86,-8.92,1417,1309,-108,-7.62,JOAO DOURADO BA,-11.3483643,-41.6626509,4,2043
BA,JUCURUCU,198,186,-12,-6.06,3,1,-2,-66.67,10,0,-10,-100.0,34,27,-7,-20.59,390,311,-79,-20.26,635,525,-110,-17.32,JUCURUCU BA,-16.843428,-40.1596925,4,2045
BA,JUSSARA,6,7,1,16.67,10,6,-4,-40.0,0,0,0,0.0,73,74,1,1.37,513,463,-50,-9.75,602,550,-52,-8.64,JUSSARA BA,-11.0473921,-41.97167,4,2046
BA,JUSSARI,84,94,10,11.9,3,4,1,33.33,0,0,0,0.0,42,51,9,21.43,563,473,-90,-15.99,692,622,-70,-10.12,JUSSARI BA,-15.1882453,-39.493597,4,2047
BA,JUSSIAPE,6,8,2,33.33,7,7,0,0.0,1,1,0,0.0,67,70,3,4.48,506,723,217,42.89,587,809,222,37.82,JUSSIAPE BA,-13.5176017,-41.5919452,4,2048
BA,LAFAIETE COUTINHO,61,66,5,8.2,40,35,-5,-12.5,0,0,0,0.0,14,13,-1,-7.14,295,290,-5,-1.69,410,404,-6,-1.46,LAFAIETE COUTINHO BA,-13.6557671,-40.2121188,4,2049
BA,LAGOA REAL,31,31,0,0.0,27,33,6,22.22,2,2,0,0.0,59,65,6,10.17,770,715,-55,-7.14,889,846,-43,-4.84,LAGOA REAL BA,-14.0346296,-42.1421925,4,2050
BA,LAJE,70,66,-4,-5.71,199,54,-145,-72.86,53,31,-22,-41.51,222,232,10,4.5,926,815,-111,-11.99,1470,1198,-272,-18.5,LAJE BA,-13.1809956,-39.4222968,4,2051
BA,LAJEDAO,200,195,-5,-2.5,5,28,23,460.0,0,0,0,0.0,40,45,5,12.5,265,211,-54,-20.38,510,479,-31,-6.08,LAJEDAO BA,-17.6125496,-40.3450272,4,2052
BA,LAJEDINHO,13,14,1,7.69,20,20,0,0.0,0,0,0,0.0,19,21,2,10.53,240,191,-49,-20.42,292,246,-46,-15.75,LAJEDINHO BA,-12.3555395,-40.9033041,4,2053
BA,LAJEDO DO TABOCAL,10,20,10,100.0,2,2,0,0.0,20,8,-12,-60.0,69,64,-5,-7.25,447,388,-59,-13.2,548,482,-66,-12.04,LAJEDO DO TABOCAL BA,-13.4740649,-40.2195324,4,2054
BA,LAMARAO,3,3,0,0.0,5,3,-2,-40.0,0,0,0,0.0,12,15,3,25.0,438,289,-149,-34.02,458,310,-148,-32.31,LAMARAO BA,-11.7954003,-38.8852303,4,2055
BA,LAPAO,71,46,-25,-35.21,105,87,-18,-17.14,72,103,31,43.06,256,246,-10,-3.91,892,877,-15,-1.68,1396,1359,-37,-2.65,LAPAO BA,-11.3827148,-41.833808,4,2056
BA,LENCOIS,44,40,-4,-9.09,19,19,0,0.0,1,7,6,600.0,69,71,2,2.9,844,308,-536,-63.51,977,445,-532,-54.45,LENCOIS BA,-12.5634288,-41.3901717,4,2058
BA,LICINIO DE ALMEIDA,11,18,7,63.64,32,23,-9,-28.12,0,0,0,0.0,308,308,0,0.0,609,607,-2,-0.33,960,956,-4,-0.42,LICINIO DE ALMEIDA BA,-14.684215,-42.509527,4,2059
BA,LIVRAMENTO DE NOSSA SENHORA,261,253,-8,-3.07,328,323,-5,-1.52,36,33,-3,-8.33,1009,995,-14,-1.39,1857,1752,-105,-5.65,3491,3356,-135,-3.87,LIVRAMENTO DE NOSSA SENHORA BA,-13.6505468,-41.8412103,4,2060
BA,LUIS EDUARDO MAGALHAES,2587,2629,42,1.62,3363,4061,698,20.76,1214,1468,254,20.92,7223,7656,433,5.99,9374,8562,-812,-8.66,23761,24376,615,2.59,LUIS EDUARDO MAGALHAES BA,-12.0869117,-45.7834163,4,2061
BA,MACAJUBA,23,15,-8,-34.78,14,8,-6,-42.86,0,0,0,0.0,32,32,0,0.0,397,16,-381,-95.97,466,71,-395,-84.76,MACAJUBA BA,-12.1376415,-40.3590055,4,2062
BA,MACARANI,326,322,-4,-1.23,382,247,-135,-35.34,3,3,0,0.0,153,156,3,1.96,1163,1055,-108,-9.29,2027,1783,-244,-12.04,MACARANI BA,-15.5610861,-40.4226078,4,2063
BA,MACAUBAS,14,16,2,14.29,159,162,3,1.89,43,27,-16,-37.21,746,730,-16,-2.14,1388,1401,13,0.94,2350,2336,-14,-0.6,MACAUBAS BA,-13.0174846,-42.6882221,4,2064
BA,MACURURE,0,0,0,0.0,0,0,0,0.0,0,0,0,0.0,25,30,5,20.0,791,596,-195,-24.65,816,626,-190,-23.28,MACURURE BA,-9.1717089,-39.0574899,4,2065
BA,MAETINGA,0,0,0,0.0,22,21,-1,-4.55,0,0,0,0.0,65,60,-5,-7.69,273,228,-45,-16.48,360,309,-51,-14.17,MAETINGA BA,-14.6627814,-41.4914419,4,2067
BA,MAIQUINIQUE,106,112,6,5.66,412,208,-204,-49.51,15,5,-10,-66.67,61,63,2,3.28,556,540,-16,-2.88,1150,928,-222,-19.3,MAIQUINIQUE BA,-15.6215177,-40.2650536,4,2068
BA,MAIRI,55,55,0,0.0,1,1,0,0.0,0,0,0,0.0,101,115,14,13.86,614,555,-59,-9.61,771,726,-45,-5.84,MAIRI BA,-11.7077488,-40.1484881,4,2069
BA,MALHADA,340,384,44,12.94,8,8,0,0.0,1,0,-1,-100.0,47,48,1,2.13,625,581,-44,-7.04,1021,1021,0,0.0,MALHADA BA,-14.3379191,-43.7716651,4,2070
BA,MALHADA DE PEDRAS,6,6,0,0.0,88,75,-13,-14.77,1,0,-1,-100.0,74,65,-9,-12.16,478,342,-136,-28.45,647,488,-159,-24.57,MALHADA DE PEDRAS BA,-14.3866285,-41.8791848,4,2071
BA,MANOEL VITORINO,95,99,4,4.21,2,2,0,0.0,0,0,0,0.0,103,99,-4,-3.88,808,425,-383,-47.4,1008,625,-383,-38.0,MANOEL VITORINO BA,-14.1448395,-40.2439696,4,2072
BA,MANSIDAO,8,13,5,62.5,0,0,0,0.0,0,0,0,0.0,12,12,0,0.0,513,487,-26,-5.07,533,512,-21,-3.94,MANSIDAO BA,-10.7196537,-44.0356021,4,2073
BA,MARACAS,115,107,-8,-6.96,458,444,-14,-3.06,214,285,71,33.18,391,409,18,4.6,1768,1626,-142,-8.03,2946,2871,-75,-2.55,MARACAS BA,-13.4408898,-40.433052,4,2074
BA,MARAGOGIPE,14,18,4,28.57,89,66,-23,-25.84,2,4,2,100.0,298,343,45,15.1,1522,1255,-267,-17.54,1925,1686,-239,-12.42,MARAGOGIPE BA,-12.7766206,-38.9174729,4,2075
BA,MARAU,232,217,-15,-6.47,26,20,-6,-23.08,18,18,0,0.0,215,204,-11,-5.12,1396,1160,-236,-16.91,1887,1619,-268,-14.2,MARAU BA,-14.103022,-39.0144322,4,2076
BA,MARCIONILIO SOUZA,82,93,11,13.41,24,24,0,0.0,0,0,0,0.0,64,64,0,0.0,413,421,8,1.94,583,602,19,3.26,MARCIONILIO SOUZA BA,-13.0024332,-40.5317476,4,2077
BA,MASCOTE,99,127,28,28.28,44,17,-27,-61.36,1,1,0,0.0,146,143,-3,-2.05,656,638,-18,-2.74,946,926,-20,-2.11,MASCOTE BA,-15.5645474,-39.3026663,4,2078
BA,MATINA,5,6,1,20.0,0,0,0,0.0,0,0,0,0.0,42,46,4,9.52,544,417,-127,-23.35,591,469,-122,-20.64,MATINA BA,-13.9098616,-42.8461536,4,2080
BA,MEDEIROS NETO,313,442,129,41.21,1126,1124,-2,-0.18,20,13,-7,-35.0,449,408,-41,-9.13,1136,1160,24,2.11,3044,3147,103,3.38,MEDEIROS NETO BA,-17.3714581,-40.2224736,4,2081
BA,MIGUEL CALMON,46,47,1,2.17,105,108,3,2.86,0,0,0,0.0,379,370,-9,-2.37,1191,1221,30,2.52,1721,1746,25,1.45,MIGUEL CALMON BA,-11.4309436,-40.5976501,4,2082
BA,MILAGRES,0,0,0,0.0,116,117,1,0.86,75,330,255,340.0,246,235,-11,-4.47,1360,1106,-254,-18.68,1797,1788,-9,-0.5,MILAGRES BA,-12.864635,-39.861092,4,2083
BA,MIRANGABA,40,42,2,5.0,20,28,8,40.0,0,0,0,0.0,54,56,2,3.7,921,41,-880,-95.55,1035,167,-868,-83.86,MIRANGABA BA,-10.9540277,-40.5764152,4,2084
BA,MIRANTE,7,3,-4,-57.14,0,0,0,0.0,0,1,1,0.0,58,59,1,1.72,406,314,-92,-22.66,471,377,-94,-19.96,MIRANTE BA,-14.2401367,-40.7661915,4,2085
BA,MONTE SANTO,15,10,-5,-33.33,22,23,1,4.55,44,17,-27,-61.36,387,370,-17,-4.39,2248,1927,-321,-14.28,2716,2347,-369,-13.59,MONTE SANTO BA,-10.4382898,-39.3304065,4,2086
BA,MORPARA,0,1,1,0.0,0,0,0,0.0,0,0,0,0.0,25,28,3,12.0,404,303,-101,-25.0,429,332,-97,-22.61,MORPARA BA,-11.5628341,-43.2768414,4,2087
BA,MORRO DO CHAPEU,62,58,-4,-6.45,114,120,6,5.26,234,242,8,3.42,397,378,-19,-4.79,1674,1377,-297,-17.74,2481,2175,-306,-12.33,MORRO DO CHAPEU BA,-11.5500293,-41.1570248,4,2088
BA,MORTUGABA,2,1,-1,-50.0,23,18,-5,-21.74,14,2,-12,-85.71,167,163,-4,-2.4,527,444,-83,-15.75,733,628,-105,-14.32,MORTUGABA BA,-15.0232826,-42.3695423,4,2089
BA,MUCUGE,1528,1851,323,21.14,70,76,6,8.57,10,3,-7,-70.0,181,173,-8,-4.42,825,554,-271,-32.85,2614,2657,43,1.64,MUCUGE BA,-13.0053,-41.370271,4,2090
BA,MUCURI,1452,1368,-84,-5.79,1786,1830,44,2.46,201,145,-56,-27.86,1097,1140,43,3.92,4029,4482,453,11.24,8565,8965,400,4.67,MUCURI BA,-18.0787487,-39.5470583,4,2091
BA,MULUNGU DO MORRO,0,0,0,0.0,21,16,-5,-23.81,0,0,0,0.0,23,21,-2,-8.7,751,737,-14,-1.86,795,774,-21,-2.64,MULUNGU DO MORRO BA,-11.9653564,-41.6408239,4,2092
BA,MUNDO NOVO,87,57,-30,-34.48,22,20,-2,-9.09,10,14,4,40.0,144,169,25,17.36,676,630,-46,-6.8,939,890,-49,-5.22,MUNDO NOVO BA,-11.8573859,-40.4731656,4,2093
BA,MUNIZ FERREIRA,23,22,-1,-4.35,31,25,-6,-19.35,6,9,3,50.0,57,54,-3,-5.26,440,309,-131,-29.77,557,419,-138,-24.78,MUNIZ FERREIRA BA,-13.0012551,-39.1102126,4,2094
BA,MUTUIPE,12,14,2,16.67,183,183,0,0.0,0,1,1,0.0,444,451,7,1.58,2048,2444,396,19.34,2687,3093,406,15.11,MUTUIPE BA,-13.2282298,-39.5060149,4,2097
BA,NAZARE,36,29,-7,-19.44,1,1,0,0.0,0,0,0,0.0,15,22,7,46.67,218,193,-25,-11.47,270,245,-25,-9.26,NAZARE BA,-13.0345586,-39.0062515,4,2098
BA,NILO PECANHA,40,50,10,25.0,34,41,7,20.59,0,1,1,0.0,63,56,-7,-11.11,675,473,-202,-29.93,812,621,-191,-23.52,NILO PECANHA BA,-13.6015675,-39.1043356,4,2099
BA,NORDESTINA,1,1,0,0.0,299,306,7,2.34,0,0,0,0.0,45,53,8,17.78,433,406,-27,-6.24,778,766,-12,-1.54,NORDESTINA BA,-10.8258183,-39.4297655,4,2100
BA,NOVA CANAA,174,132,-42,-24.14,16,17,1,6.25,1,2,1,100.0,131,111,-20,-15.27,589,518,-71,-12.05,911,780,-131,-14.38,NOVA CANAA BA,-14.7936791,-40.1453848,4,2101
BA,NOVA FATIMA,9,5,-4,-44.44,29,44,15,51.72,0,21,21,0.0,81,73,-8,-9.88,449,418,-31,-6.9,568,561,-7,-1.23,NOVA FATIMA BA,-11.6046105,-39.631054,4,2102
BA,NOVA IBIA,69,74,5,7.25,0,0,0,0.0,2,0,-2,-100.0,11,12,1,9.09,341,364,23,6.74,423,450,27,6.38,NOVA IBIA BA,-13.8102566,-39.624783,4,2103
BA,NOVA REDENCAO,7,14,7,100.0,0,0,0,0.0,0,0,0,0.0,54,30,-24,-44.44,390,393,3,0.77,451,437,-14,-3.1,NOVA REDENCAO BA,-12.817268,-41.0709301,4,2105
BA,NOVA SOURE,27,92,65,240.74,115,110,-5,-4.35,0,8,8,0.0,156,150,-6,-3.85,101,1096,995,985.15,399,1456,1057,264.91,NOVA SOURE BA,-11.2409332,-38.4774123,4,2106
BA,NOVA VICOSA,1430,1239,-191,-13.36,210,226,16,7.62,70,144,74,105.71,894,884,-10,-1.12,2738,1984,-754,-27.54,5342,4477,-865,-16.19,NOVA VICOSA BA,-17.8907712,-39.3725471,4,2107
BA,NOVO HORIZONTE,0,0,0,0.0,1,0,-1,-100.0,0,1,1,0.0,26,24,-2,-7.69,455,404,-51,-11.21,482,429,-53,-11.0,NOVO HORIZONTE BA,-12.8085637,-42.1674812,4,2108
BA,NOVO TRIUNFO,0,0,0,0.0,0,0,0,0.0,7,4,-3,-42.86,25,25,0,0.0,599,707,108,18.03,631,736,105,16.64,NOVO TRIUNFO BA,-10.3353896,-38.4246424,4,2109
BA,OLINDINA,8,4,-4,-50.0,97,111,14,14.43,1,1,0,0.0,234,268,34,14.53,907,815,-92,-10.14,1247,1199,-48,-3.85,OLINDINA BA,-11.3601309,-38.3269571,4,2110
BA,OLIVEIRA DOS BREJINHOS,2,1,-1,-50.0,183,174,-9,-4.92,2,804,802,40100.0,211,185,-26,-12.32,861,846,-15,-1.74,1259,2010,751,59.65,OLIVEIRA DOS BREJINHOS BA,-12.3193308,-42.8914271,4,2111
BA,OURICANGAS,13,12,-1,-7.69,9,10,1,11.11,12,3,-9,-75.0,46,79,33,71.74,335,353,18,5.37,415,457,42,10.12,OURICANGAS BA,-12.0105291,-38.6259109,4,2112
BA,OUROLANDIA,3,5,2,66.67,433,373,-60,-13.86,232,33,-199,-85.78,151,148,-3,-1.99,803,579,-224,-27.9,1622,1138,-484,-29.84,OUROLANDIA BA,-10.9686909,-41.0808672,4,2113
BA,PALMAS DE MONTE ALTO,89,90,1,1.12,154,175,21,13.64,0,0,0,0.0,166,159,-7,-4.22,792,670,-122,-15.4,1201,1094,-107,-8.91,PALMAS DE MONTE ALTO BA,-14.2636093,-43.1649976,4,2114
BA,PALMEIRAS,5,6,1,20.0,89,110,21,23.6,6,3,-3,-50.0,105,99,-6,-5.71,431,313,-118,-27.38,636,531,-105,-16.51,PALMEIRAS BA,-12.5151234,-41.5746054,4,2115
BA,PARAMIRIM,4,6,2,50.0,381,373,-8,-2.1,10,8,-2,-20.0,418,394,-24,-5.74,796,832,36,4.52,1609,1613,4,0.25,PARAMIRIM BA,-13.4437218,-42.2419768,4,2116
BA,PARATINGA,1,3,2,200.0,63,68,5,7.94,14,6,-8,-57.14,309,294,-15,-4.85,1865,966,-899,-48.2,2252,1337,-915,-40.63,PARATINGA BA,-12.692459,-43.1805318,4,2117
BA,PARIPIRANGA,11,7,-4,-36.36,6,11,5,83.33,9,7,-2,-22.22,323,340,17,5.26,1497,1311,-186,-12.42,1846,1676,-170,-9.21,PARIPIRANGA BA,-10.6828923,-37.8621523,4,2118
BA,PAU BRASIL,36,37,1,2.78,31,31,0,0.0,0,0,0,0.0,56,51,-5,-8.93,691,606,-85,-12.3,814,725,-89,-10.93,PAU BRASIL BA,-15.4645802,-39.6518409,4,2119
BA,PAULO AFONSO,64,68,4,6.25,1990,1906,-84,-4.22,513,999,486,94.74,3757,3652,-105,-2.79,8220,7478,-742,-9.03,14544,14103,-441,-3.03,PAULO AFONSO BA,-9.3991006,-38.226711,4,2120
BA,PE DE SERRA,28,23,-5,-17.86,9,8,-1,-11.11,56,31,-25,-44.64,80,77,-3,-3.75,724,636,-88,-12.15,897,775,-122,-13.6,PE DE SERRA BA,-11.8346273,-39.6108675,4,2121
BA,PEDRAO,9,12,3,33.33,0,0,0,0.0,0,0,0,0.0,17,14,-3,-17.65,306,268,-38,-12.42,332,294,-38,-11.45,PEDRAO BA,-12.1451302,-38.6466197,4,2122
BA,PEDRO ALEXANDRE,16,18,2,12.5,0,0,0,0.0,0,0,0,0.0,25,31,6,24.0,889,724,-165,-18.56,930,773,-157,-16.88,PEDRO ALEXANDRE BA,-10.0118695,-37.894739,4,2123
BA,PIATA,14,13,-1,-7.14,118,309,191,161.86,2,2,0,0.0,125,136,11,8.8,559,486,-73,-13.06,818,946,128,15.65,PIATA BA,-13.1535638,-41.7743761,4,2124
BA,PILAO ARCADO,3,3,0,0.0,28,33,5,17.86,0,0,0,0.0,59,98,39,66.1,1800,1659,-141,-7.83,1890,1793,-97,-5.13,PILAO ARCADO BA,-10.0004334,-42.4793189,4,2125
BA,PINDAI,4,5,1,25.0,43,50,7,16.28,4,35,31,775.0,87,86,-1,-1.15,582,558,-24,-4.12,720,734,14,1.94,PINDAI BA,-14.4911899,-42.6864686,4,2126
BA,PINDOBACU,14,13,-1,-7.14,65,71,6,9.23,0,0,0,0.0,175,185,10,5.71,1112,792,-320,-28.78,1366,1061,-305,-22.33,PINDOBACU BA,-10.7439121,-40.3619457,4,2127
BA,PINTADAS,15,21,6,40.0,32,28,-4,-12.5,29,22,-7,-24.14,128,127,-1,-0.78,526,452,-74,-14.07,730,650,-80,-10.96,PINTADAS BA,-11.813042,-39.9076005,4,2128
BA,PIRAI DO NORTE,47,39,-8,-17.02,1,1,0,0.0,0,0,0,0.0,45,46,1,2.22,562,465,-97,-17.26,655,551,-104,-15.88,PIRAI DO NORTE BA,-13.7613252,-39.3743055,4,2129
BA,PIRIPA,1,1,0,0.0,24,21,-3,-12.5,3,0,-3,-100.0,69,68,-1,-1.45,584,435,-149,-25.51,681,525,-156,-22.91,PIRIPA BA,-14.9419863,-41.7149815,4,2130
BA,PIRITIBA,46,25,-21,-45.65,7,6,-1,-14.29,4,0,-4,-100.0,151,182,31,20.53,634,631,-3,-0.47,842,844,2,0.24,PIRITIBA BA,-11.7320314,-40.5561536,4,2131
BA,PLANALTINO,26,31,5,19.23,0,0,0,0.0,5,0,-5,-100.0,28,28,0,0.0,368,236,-132,-35.87,427,295,-132,-30.91,PLANALTINO BA,-13.2600789,-40.3692123,4,2132
BA,PLANALTO,122,133,11,9.02,24,19,-5,-20.83,10,15,5,50.0,396,376,-20,-5.05,1107,967,-140,-12.65,1659,1510,-149,-8.98,PLANALTO BA,-14.6689214,-40.481006,4,2133
BA,POCOES,102,80,-22,-21.57,208,188,-20,-9.62,15,29,14,93.33,1077,1080,3,0.28,2394,1984,-410,-17.13,3796,3361,-435,-11.46,POCOES BA,-14.5274879,-40.3665326,4,2134
BA,POJUCA,103,85,-18,-17.48,2294,2223,-71,-3.1,297,287,-10,-3.37,760,720,-40,-5.26,3542,3003,-539,-15.22,6996,6318,-678,-9.69,POJUCA BA,-12.4260268,-38.3266573,4,2135
BA,PONTO NOVO,12,8,-4,-33.33,16,20,4,25.0,1,0,-1,-100.0,86,94,8,9.3,897,706,-191,-21.29,1012,828,-184,-18.18,PONTO NOVO BA,-10.8642828,-40.1328306,4,2136
BA,PORTO SEGURO,1629,1713,84,5.16,969,859,-110,-11.35,733,694,-39,-5.32,6622,6221,-401,-6.06,22319,20507,-1812,-8.12,32272,29994,-2278,-7.06,PORTO SEGURO BA,-16.443473,-39.064251,4,2137
BA,POTIRAGUA,192,189,-3,-1.56,281,49,-232,-82.56,0,0,0,0.0,75,67,-8,-10.67,608,604,-4,-0.66,1156,909,-247,-21.37,POTIRAGUA BA,-15.5935151,-39.871412,4,2138
BA,PRADO,1126,991,-135,-11.99,344,347,3,0.87,18,11,-7,-38.89,452,485,33,7.3,1707,1486,-221,-12.95,3647,3320,-327,-8.97,PRADO BA,-17.336357,-39.222721,4,2139
BA,PRESIDENTE DUTRA,42,40,-2,-4.76,196,526,330,168.37,97,103,6,6.19,1802,2171,369,20.48,1603,1957,354,22.08,3740,4797,1057,28.26,PRESIDENTE DUTRA BA,-11.2959181,-41.9871566,4,2140
BA,PRESIDENTE JANIO QUADROS,2,3,1,50.0,33,31,-2,-6.06,0,0,0,0.0,51,47,-4,-7.84,512,344,-168,-32.81,598,425,-173,-28.93,PRESIDENTE JANIO QUADROS BA,-14.685696,-41.6770097,4,2141
BA,PRESIDENTE TANCREDO NEVES,71,66,-5,-7.04,225,110,-115,-51.11,15,11,-4,-26.67,430,440,10,2.33,1192,799,-393,-32.97,1933,1426,-507,-26.23,PRESIDENTE TANCREDO NEVES BA,-13.4556558,-39.4212197,4,2142
BA,QUEIMADAS,48,54,6,12.5,722,700,-22,-3.05,284,262,-22,-7.75,628,638,10,1.59,2084,1242,-842,-40.4,3766,2896,-870,-23.1,QUEIMADAS BA,-10.9807081,-39.6249588,4,2143
BA,QUIJINGUE,8,7,-1,-12.5,2,2,0,0.0,7,8,1,14.29,100,109,9,9.0,809,991,182,22.5,926,1117,191,20.63,QUIJINGUE BA,-10.7513728,-39.2075228,4,2144
BA,QUIXABEIRA,2,2,0,0.0,4,21,17,425.0,2,1,-1,-50.0,44,36,-8,-18.18,520,477,-43,-8.27,572,537,-35,-6.12,QUIXABEIRA BA,-11.4123294,-40.1264724,4,2145
BA,RAFAEL JAMBEIRO,39,42,3,7.69,11,11,0,0.0,1,4,3,300.0,336,336,0,0.0,1131,128,-1003,-88.68,1518,521,-997,-65.68,RAFAEL JAMBEIRO BA,-12.3988144,-39.5020289,4,2146
BA,REMANSO,22,25,3,13.64,43,38,-5,-11.63,4,3,-1,-25.0,713,673,-40,-5.61,671,1941,1270,189.27,1453,2680,1227,84.45,REMANSO BA,-9.6179416,-42.0830557,4,2147
BA,RETIROLANDIA,14,13,-1,-7.14,323,315,-8,-2.48,23,30,7,30.43,135,140,5,3.7,613,604,-9,-1.47,1108,1102,-6,-0.54,RETIROLANDIA BA,-11.4935873,-39.4245887,4,2148
BA,RIACHAO DAS NEVES,1423,1437,14,0.98,61,83,22,36.07,35,21,-14,-40.0,164,145,-19,-11.59,1056,986,-70,-6.63,2739,2672,-67,-2.45,RIACHAO DAS NEVES BA,-11.7481049,-44.9109851,4,2149
BA,RIACHAO DO JACUIPE,48,44,-4,-8.33,432,467,35,8.1,116,74,-42,-36.21,664,647,-17,-2.56,1590,1290,-300,-18.87,2850,2522,-328,-11.51,RIACHAO DO JACUIPE BA,-11.8071084,-39.3816843,4,2150
BA,RIACHO DE SANTANA,0,0,0,0.0,5,3,-2,-40.0,0,0,0,0.0,8,8,0,0.0,151,112,-39,-25.83,164,123,-41,-25.0,RIACHO DE SANTANA BA,-13.6100985,-42.9355254,4,2151
BA,RIBEIRA DO AMPARO,788,985,197,25.0,0,14,14,0.0,0,4,4,0.0,33,35,2,6.06,686,810,124,18.08,1507,1848,341,22.63,RIBEIRA DO AMPARO BA,-11.0412527,-38.4299461,4,2152
BA,RIBEIRA DO POMBAL,42,45,3,7.14,308,335,27,8.77,146,452,306,209.59,1682,1685,3,0.18,2359,2100,-259,-10.98,4537,4617,80,1.76,RIBEIRA DO POMBAL BA,-10.837299,-38.538152,4,2153
BA,RIBEIRAO DO LARGO,202,193,-9,-4.46,15,11,-4,-26.67,0,0,0,0.0,5,8,3,60.0,540,591,51,9.44,762,803,41,5.38,RIBEIRAO DO LARGO BA,-15.4588477,-40.7411582,4,2154
BA,RIO DE CONTAS,32,36,4,12.5,29,26,-3,-10.34,5,2,-3,-60.0,126,128,2,1.59,665,677,12,1.8,857,869,12,1.4,RIO DE CONTAS BA,-13.5803333,-41.8112152,4,2155
BA,RIO DO ANTONIO,7,7,0,0.0,34,33,-1,-2.94,0,0,0,0.0,120,110,-10,-8.33,638,619,-19,-2.98,799,769,-30,-3.75,RIO DO ANTONIO BA,-14.4072692,-42.0766717,4,2156
BA,RIO DO PIRES,12,11,-1,-8.33,27,32,5,18.52,4,0,-4,-100.0,104,89,-15,-14.42,501,509,8,1.6,648,641,-7,-1.08,RIO DO PIRES BA,-13.1252598,-42.2901946,4,2157
BA,RIO REAL,210,607,397,189.05,117,111,-6,-5.13,3,3,0,0.0,891,916,25,2.81,1464,1233,-231,-15.78,2685,2870,185,6.89,RIO REAL BA,-11.4869788,-37.9317491,4,2158
BA,RODELAS,99,88,-11,-11.11,0,0,0,0.0,0,1,1,0.0,67,63,-4,-5.97,484,395,-89,-18.39,650,547,-103,-15.85,RODELAS BA,-8.8485589,-38.7663939,4,2159
BA,RUY BARBOSA,0,0,0,0.0,2,2,0,0.0,0,0,0,0.0,3,4,1,33.33,268,244,-24,-8.96,273,250,-23,-8.42,RUY BARBOSA BA,-12.2856669,-40.4958361,4,2160
BA,SALINAS DA MARGARIDA,55,58,3,5.45,8,8,0,0.0,0,0,0,0.0,129,146,17,13.18,720,430,-290,-40.28,912,642,-270,-29.61,SALINAS DA MARGARIDA BA,-12.8733508,-38.7593794,4,2161
BA,SALVADOR,832,674,-158,-18.99,40034,38294,-1740,-4.35,42739,49457,6718,15.72,119097,112236,-6861,-5.76,491318,527950,36632,7.46,694020,728611,34591,4.98,SALVADOR BA,-12.9822499,-38.4812772,4,2162
BA,SANTA BARBARA,12,8,-4,-33.33,8,8,0,0.0,3,3,0,0.0,200,175,-25,-12.5,981,689,-292,-29.77,1204,883,-321,-26.66,SANTA BARBARA BA,-11.9543757,-38.9736385,4,2163
BA,SANTA BRIGIDA,2,1,-1,-50.0,31,29,-2,-6.45,0,0,0,0.0,80,64,-16,-20.0,848,535,-313,-36.91,961,629,-332,-34.55,SANTA BRIGIDA BA,-9.7343772,-38.1259256,4,2164
BA,SANTA CRUZ CABRALIA,417,436,19,4.56,472,524,52,11.02,90,115,25,27.78,656,614,-42,-6.4,2226,2157,-69,-3.1,3861,3846,-15,-0.39,SANTA CRUZ CABRALIA BA,-16.2815556,-39.0239196,4,2165
BA,SANTA CRUZ DA VITORIA,94,75,-19,-20.21,6,10,4,66.67,0,0,0,0.0,50,56,6,12.0,408,430,22,5.39,558,571,13,2.33,SANTA CRUZ DA VITORIA BA,-14.9629349,-39.8105374,4,2166
BA,SANTA INES,184,187,3,1.63,176,231,55,31.25,101,112,11,10.89,4397,4456,59,1.34,4924,4549,-375,-7.62,9782,9535,-247,-2.53,SANTA INES BA,-13.2897697,-39.8179701,4,2167
BA,SANTALUZ,37,42,5,13.51,546,582,36,6.59,110,43,-67,-60.91,416,412,-4,-0.96,1521,1475,-46,-3.02,2630,2554,-76,-2.89,SANTALUZ BA,-11.2505314,-39.3746617,4,2168
BA,SANTA LUZIA,389,382,-7,-1.8,17,16,-1,-5.88,0,0,0,0.0,525,505,-20,-3.81,2809,2607,-202,-7.19,3740,3510,-230,-6.15,SANTA LUZIA BA,-15.4307844,-39.3303259,4,2169
BA,SANTA MARIA DA VITORIA,318,323,5,1.57,210,214,4,1.9,286,292,6,2.1,1321,1276,-45,-3.41,2235,2097,-138,-6.17,4370,4202,-168,-3.84,SANTA MARIA DA VITORIA BA,-13.3901477,-44.2013167,4,2170
BA,SANTANA,4,15,11,275.0,892,743,-149,-16.7,157,171,14,8.92,2518,2748,230,9.13,5815,4685,-1130,-19.43,9386,8362,-1024,-10.91,SANTANA BA,-12.979217,-44.05064,4,2171
BA,SANTANOPOLIS,15,13,-2,-13.33,3,3,0,0.0,4,4,0,0.0,23,27,4,17.39,487,280,-207,-42.51,532,327,-205,-38.53,SANTANOPOLIS BA,-12.0243828,-38.8650365,4,2172
BA,SANTA RITA DE CASSIA,105,135,30,28.57,6,13,7,116.67,0,0,0,0.0,176,164,-12,-6.82,1041,960,-81,-7.78,1328,1272,-56,-4.22,SANTA RITA DE CASSIA BA,-11.0013969,-44.5209684,4,2173
BA,SANTO AMARO,155,160,5,3.23,740,749,9,1.22,149,202,53,35.57,1122,1094,-28,-2.5,2987,2005,-982,-32.88,5153,4210,-943,-18.3,SANTO AMARO BA,-12.5519686,-38.7060448,4,2175
BA,SANTO ANTONIO DE JESUS,214,171,-43,-20.09,5162,4791,-371,-7.19,483,361,-122,-25.26,7314,6912,-402,-5.5,8535,8368,-167,-1.96,21708,20603,-1105,-5.09,SANTO ANTONIO DE JESUS BA,-12.9689361,-39.260914,4,2176
BA,SANTO ESTEVAO,19,26,7,36.84,3665,3973,308,8.4,43,24,-19,-44.19,1184,1212,28,2.36,2263,2006,-257,-11.36,7174,7241,67,0.93,SANTO ESTEVAO BA,-12.4340621,-39.2556115,4,2177
BA,SAO DESIDERIO,4003,4589,586,14.64,435,359,-76,-17.47,275,455,180,65.45,674,657,-17,-2.52,1913,1793,-120,-6.27,7300,7853,553,7.58,SAO DESIDERIO BA,-12.357196,-44.976881,4,2178
BA,SAO DOMINGOS,2,3,1,50.0,27,38,11,40.74,0,0,0,0.0,3,4,1,33.33,248,225,-23,-9.27,280,270,-10,-3.57,SAO DOMINGOS BA,-11.4636112,-39.526527,4,2179
BA,SAO FELIPE,24,21,-3,-12.5,42,26,-16,-38.1,11,14,3,27.27,400,423,23,5.75,841,821,-20,-2.38,1318,1305,-13,-0.99,SAO FELIPE BA,-12.8413439,-39.0942048,4,2182
BA,SAO GABRIEL,7,4,-3,-42.86,2,1,-1,-50.0,1,1,0,0.0,111,126,15,13.51,839,757,-82,-9.77,960,889,-71,-7.4,SAO GABRIEL BA,-11.2281863,-41.8768254,4,2184
BA,SAO GONCALO DOS CAMPOS,115,156,41,35.65,1887,2913,1026,54.37,205,222,17,8.29,1615,1853,238,14.74,1904,1773,-131,-6.88,5726,6917,1191,20.8,SAO GONCALO DOS CAMPOS BA,-12.4339991,-38.9488082,4,2185
BA,SAO JOSE DA VITORIA,21,26,5,23.81,0,0,0,0.0,0,0,0,0.0,45,52,7,15.56,498,487,-11,-2.21,564,565,1,0.18,SAO JOSE DA VITORIA BA,-15.0790716,-39.3365369,4,2186
BA,SAO JOSE DO JACUIPE,5,4,-1,-20.0,4,4,0,0.0,0,0,0,0.0,52,50,-2,-3.85,598,505,-93,-15.55,659,563,-96,-14.57,SAO JOSE DO JACUIPE BA,-11.5040358,-40.025658,4,2187
BA,SAO MIGUEL DAS MATAS,19,15,-4,-21.05,21,17,-4,-19.05,0,0,0,0.0,155,165,10,6.45,555,442,-113,-20.36,750,639,-111,-14.8,SAO MIGUEL DAS MATAS BA,-13.047749,-39.4554608,4,2188
BA,SATIRO DIAS,457,594,137,29.98,105,128,23,21.9,5,5,0,0.0,86,91,5,5.81,884,683,-201,-22.74,1537,1501,-36,-2.34,SATIRO DIAS BA,-11.6033746,-38.581456,4,2191
BA,SAUBARA,0,0,0,0.0,4,5,1,25.0,9,8,-1,-11.11,103,98,-5,-4.85,893,875,-18,-2.02,1009,986,-23,-2.28,SAUBARA BA,-12.7372926,-38.7662996,4,2192
BA,SAUDE,13,12,-1,-7.69,0,0,0,0.0,0,0,0,0.0,58,53,-5,-8.62,623,520,-103,-16.53,694,585,-109,-15.71,SAUDE BA,-10.9414907,-40.4205842,4,2193
BA,SEABRA,26,25,-1,-3.85,207,238,31,14.98,47,34,-13,-27.66,1423,1448,25,1.76,2697,3139,442,16.39,4400,4884,484,11.0,SEABRA BA,-12.4172071,-41.772051,4,2194
BA,SEBASTIAO LARANJEIRAS,33,36,3,9.09,0,0,0,0.0,0,0,0,0.0,65,69,4,6.15,616,22,-594,-96.43,714,127,-587,-82.21,SEBASTIAO LARANJEIRAS BA,-14.571002,-42.943438,4,2195
BA,SENHOR DO BONFIM,57,65,8,14.04,547,534,-13,-2.38,367,305,-62,-16.89,2759,2631,-128,-4.64,4529,4510,-19,-0.42,8259,8045,-214,-2.59,SENHOR DO BONFIM BA,-10.4602509,-40.189151,4,2196
BA,SERRA DO RAMALHO,425,384,-41,-9.65,62,72,10,16.13,3,0,-3,-100.0,312,304,-8,-2.56,1494,1321,-173,-11.58,2296,2081,-215,-9.36,SERRA DO RAMALHO BA,-13.5442363,-43.5773151,4,2197
BA,SENTO SE,321,464,143,44.55,74,109,35,47.3,0,38,38,0.0,227,227,0,0.0,1772,1656,-116,-6.55,2394,2494,100,4.18,SENTO SE BA,-9.7406436,-41.8830056,4,2198
BA,SERRA DOURADA,40,37,-3,-7.5,89,79,-10,-11.24,5,12,7,140.0,130,129,-1,-0.77,860,45,-815,-94.77,1124,302,-822,-73.13,SERRA DOURADA BA,-12.758418,-43.9500907,4,2199
BA,SERRA PRETA,45,42,-3,-6.67,2,3,1,50.0,23,38,15,65.22,104,89,-15,-14.42,716,442,-274,-38.27,890,614,-276,-31.01,SERRA PRETA BA,-12.1589615,-39.3320929,4,2200
BA,SERRINHA,9,8,-1,-11.11,1,1,0,0.0,2,2,0,0.0,39,42,3,7.69,410,167,-243,-59.27,461,220,-241,-52.28,SERRINHA BA,-11.6568168,-38.9637086,4,2201
BA,SERROLANDIA,4,4,0,0.0,163,106,-57,-34.97,0,0,0,0.0,147,157,10,6.8,596,514,-82,-13.76,910,781,-129,-14.18,SERROLANDIA BA,-11.4200011,-40.2974938,4,2202
BA,SITIO DO MATO,149,110,-39,-26.17,40,30,-10,-25.0,30,25,-5,-16.67,40,43,3,7.5,523,444,-79,-15.11,782,652,-130,-16.62,SITIO DO MATO BA,-13.0843136,-43.4686989,4,2204
BA,SITIO DO QUINTO,0,0,0,0.0,0,0,0,0.0,0,0,0,0.0,47,55,8,17.02,575,509,-66,-11.48,622,564,-58,-9.32,SITIO DO QUINTO BA,-10.3675979,-38.2041664,4,2205
BA,SOBRADINHO,100,68,-32,-32.0,171,197,26,15.2,64,6,-58,-90.62,342,358,16,4.68,1462,931,-531,-36.32,2139,1560,-579,-27.07,SOBRADINHO BA,-9.469775,-40.7957473,4,2206
BA,SOUTO SOARES,0,0,0,0.0,0,0,0,0.0,0,0,0,0.0,58,47,-11,-18.97,543,600,57,10.5,601,647,46,7.65,SOUTO SOARES BA,-12.0878456,-41.6495346,4,2207
BA,TABOCAS DO BREJO VELHO,9,7,-2,-22.22,0,14,14,0.0,0,1,1,0.0,97,102,5,5.15,772,640,-132,-17.1,878,764,-114,-12.98,TABOCAS DO BREJO VELHO BA,-12.7020751,-44.0091066,4,2208
BA,TANHACU,68,43,-25,-36.76,95,77,-18,-18.95,7,16,9,128.57,307,316,9,2.93,854,732,-122,-14.29,1331,1184,-147,-11.04,TANHACU BA,-14.019662,-41.247271,4,2209
BA,TANQUE NOVO,0,0,0,0.0,43,36,-7,-16.28,1,1,0,0.0,250,272,22,8.8,637,543,-94,-14.76,931,852,-79,-8.49,TANQUE NOVO BA,-13.5474243,-42.4907587,4,2210
BA,TANQUINHO,39,34,-5,-12.82,3,11,8,266.67,0,4,4,0.0,68,71,3,4.41,324,321,-3,-0.93,434,441,7,1.61,TANQUINHO BA,-11.9747061,-39.1057638,4,2211
BA,TAPEROA,7,10,3,42.86,42,34,-8,-19.05,0,0,0,0.0,106,100,-6,-5.66,814,790,-24,-2.95,969,934,-35,-3.61,TAPEROA BA,-13.537334,-39.0986475,4,2212
BA,TAPIRAMUTA,22,17,-5,-22.73,3,3,0,0.0,8,0,-8,-100.0,83,80,-3,-3.61,782,626,-156,-19.95,898,726,-172,-19.15,TAPIRAMUTA BA,-11.8447604,-40.7970527,4,2213
BA,TEIXEIRA DE FREITAS,2197,2406,209,9.51,1675,1720,45,2.69,1387,883,-504,-36.34,7514,7657,143,1.9,11001,10755,-246,-2.24,23774,23421,-353,-1.48,TEIXEIRA DE FREITAS BA,-17.5376644,-39.7458096,4,2214
BA,TEODORO SAMPAIO,70,68,-2,-2.86,82,134,52,63.41,0,0,0,0.0,94,73,-21,-22.34,572,428,-144,-25.17,818,703,-115,-14.06,TEODORO SAMPAIO BA,-12.3053855,-38.6408979,4,2215
BA,TEOFILANDIA,4,6,2,50.0,13,14,1,7.69,7,8,1,14.29,119,108,-11,-9.24,845,796,-49,-5.8,988,932,-56,-5.67,TEOFILANDIA BA,-11.4891658,-38.9997411,4,2216
BA,TEOLANDIA,25,20,-5,-20.0,7,1,-6,-85.71,36,37,1,2.78,115,132,17,14.78,875,776,-99,-11.31,1058,966,-92,-8.7,TEOLANDIA BA,-13.603575,-39.4927143,4,2217
BA,TERRA NOVA,0,0,0,0.0,1,0,-1,-100.0,0,0,0,0.0,40,40,0,0.0,479,346,-133,-27.77,520,386,-134,-25.77,TERRA NOVA BA,-12.4069929,-38.6191596,4,2218
BA,TREMEDAL,32,31,-1,-3.12,32,17,-15,-46.88,21,0,-21,-100.0,66,59,-7,-10.61,624,561,-63,-10.1,775,668,-107,-13.81,TREMEDAL BA,-14.9772387,-41.4110979,4,2219
BA,TUCANO,36,40,4,11.11,83,88,5,6.02,25,5,-20,-80.0,554,564,10,1.81,2400,2488,88,3.67,3098,3185,87,2.81,TUCANO BA,-10.963517,-38.785957,4,2220
BA,UAUA,5,1,-4,-80.0,52,44,-8,-15.38,2,1,-1,-50.0,250,243,-7,-2.8,881,783,-98,-11.12,1190,1072,-118,-9.92,UAUA BA,-9.8384079,-39.4793914,4,2221
BA,UBAIRA,66,55,-11,-16.67,12,16,4,33.33,132,56,-76,-57.58,222,239,17,7.66,1305,2158,853,65.36,1737,2524,787,45.31,UBAIRA BA,-13.2616682,-39.6612866,4,2222
BA,UBATA,57,65,8,14.04,93,120,27,29.03,1,0,-1,-100.0,446,439,-7,-1.57,589,829,240,40.75,1186,1453,267,22.51,UBATA BA,-14.212002,-39.5245924,4,2224
BA,UIBAI,3,0,-3,-100.0,0,0,0,0.0,0,0,0,0.0,78,43,-35,-44.87,506,597,91,17.98,587,640,53,9.03,UIBAI BA,-11.3349074,-42.1305245,4,2225
BA,UMBURANAS,0,2,2,0.0,6,22,16,266.67,64,108,44,68.75,180,197,17,9.44,1052,873,-179,-17.02,1302,1202,-100,-7.68,UMBURANAS BA,-10.728752,-41.3220445,4,2226
BA,UNA,630,566,-64,-10.16,91,48,-43,-47.25,17,61,44,258.82,282,292,10,3.55,1620,1537,-83,-5.12,2640,2504,-136,-5.15,UNA BA,-15.2724926,-39.24688538418685,4,2227
BA,URANDI,35,26,-9,-25.71,255,251,-4,-1.57,1,0,-1,-100.0,262,250,-12,-4.58,472,421,-51,-10.81,1025,948,-77,-7.51,URANDI BA,-14.7680766,-42.6573988,4,2228
BA,URUCUCA,417,416,-1,-0.24,116,112,-4,-3.45,42,22,-20,-47.62,315,361,46,14.6,671,608,-63,-9.39,1561,1519,-42,-2.69,URUCUCA BA,-14.5913092,-39.2862094,4,2229
BA,UTINGA,53,43,-10,-18.87,0,0,0,0.0,15,9,-6,-40.0,220,210,-10,-4.55,990,935,-55,-5.56,1278,1197,-81,-6.34,UTINGA BA,-12.0781018,-41.090787,4,2230
BA,VALENCA,927,700,-227,-24.49,1339,1338,-1,-0.07,260,90,-170,-65.38,3193,3051,-142,-4.45,6170,5184,-986,-15.98,11889,10363,-1526,-12.84,VALENCA BA,-13.3723582,-39.0694243,4,2231
BA,VALENTE,13,13,0,0.0,760,782,22,2.89,6,2,-4,-66.67,348,338,-10,-2.87,1290,1038,-252,-19.53,2417,2173,-244,-10.1,VALENTE BA,-11.4127335,-39.4627304,4,2232
BA,VARZEA DA ROCA,13,16,3,23.08,0,0,0,0.0,22,3,-19,-86.36,86,100,14,16.28,611,471,-140,-22.91,732,590,-142,-19.4,VARZEA DA ROCA BA,-11.606293,-40.134634,4,2233
BA,VARZEA DO POCO,0,0,0,0.0,0,0,0,0.0,0,0,0,0.0,118,144,26,22.03,506,281,-225,-44.47,624,425,-199,-31.89,VARZEA DO POCO BA,-11.5283388,-40.318907,4,2234
BA,VARZEA NOVA,3,4,1,33.33,3,3,0,0.0,1,2,1,100.0,184,192,8,4.35,676,642,-34,-5.03,867,843,-24,-2.77,VARZEA NOVA BA,-11.2527934,-40.9456569,4,2235
BA,VARZEDO,17,21,4,23.53,212,267,55,25.94,1,0,-1,-100.0,54,51,-3,-5.56,278,298,20,7.19,562,637,75,13.35,VARZEDO BA,-12.9755592,-39.3943596,4,2236
BA,VEREDA,162,148,-14,-8.64,43,0,-43,-100.0,0,0,0,0.0,19,15,-4,-21.05,330,309,-21,-6.36,554,472,-82,-14.8,VEREDA BA,-17.2247466,-40.0856161,4,2238
BA,VITORIA DA CONQUISTA,1354,1394,40,2.95,10488,11682,1194,11.38,4144,4354,210,5.07,18446,18323,-123,-0.67,36652,35098,-1554,-4.24,71084,70851,-233,-0.33,VITORIA DA CONQUISTA BA,-14.8567487,-40.8414804,4,2239
BA,WAGNER,54,107,53,98.15,7,7,0,0.0,0,0,0,0.0,45,41,-4,-8.89,401,374,-27,-6.73,507,529,22,4.34,WAGNER BA,-12.2818593,-41.1686734,4,2240
BA,WANDERLEY,71,75,4,5.63,2,4,2,100.0,25,18,-7,-28.0,102,94,-8,-7.84,776,653,-123,-15.85,976,844,-132,-13.52,WANDERLEY BA,-12.1208986,-43.8905685,4,2241
BA,WENCESLAU GUIMARAES,111,92,-19,-17.12,14,13,-1,-7.14,0,0,0,0.0,157,146,-11,-7.01,1098,1006,-92,-8.38,1380,1257,-123,-8.91,WENCESLAU GUIMARAES BA,-13.6866356,-39.479122,4,2242
BA,XIQUE-XIQUE,17,18,1,5.88,130,142,12,9.23,6,4,-2,-33.33,591,617,26,4.4,1801,1850,49,2.72,2545,2631,86,3.38,XIQUE-XIQUE BA,-10.8217193,-42.7265689,4,2243
MG,ABADIA DOS DOURADOS,187,133,-54,-28.88,495,523,28,5.66,109,102,-7,-6.42,326,236,-90,-27.61,831,595,-236,-28.4,1948,1589,-359,-18.43,ABADIA DOS DOURADOS MG,-18.4911191,-47.4063589,10,2244
MG,ABAETE,546,556,10,1.83,626,514,-112,-17.89,114,136,22,19.3,999,968,-31,-3.1,1850,1682,-168,-9.08,4135,3856,-279,-6.75,ABAETE MG,-19.1566833,-45.4481213,10,2245
MG,ABRE CAMPO,168,168,0,0.0,179,161,-18,-10.06,47,67,20,42.55,435,452,17,3.91,883,774,-109,-12.34,1712,1622,-90,-5.26,ABRE CAMPO MG,-20.295421,-42.480131,10,2246
MG,ACAIACA,44,33,-11,-25.0,62,66,4,6.45,4,4,0,0.0,54,63,9,16.67,299,289,-10,-3.34,463,455,-8,-1.73,ACAIACA MG,-20.3621646,-43.1444162,10,2247
MG,ACUCENA,85,77,-8,-9.41,0,0,0,0.0,1,3,2,200.0,69,62,-7,-10.14,347,283,-64,-18.44,502,425,-77,-15.34,ACUCENA MG,-19.073056,-42.546666,10,2248
MG,AGUA BOA,164,158,-6,-3.66,6,5,-1,-16.67,10,4,-6,-60.0,182,188,6,3.3,531,486,-45,-8.47,893,841,-52,-5.82,AGUA BOA MG,-17.9968063,-42.3904573,10,2249
MG,AGUA COMPRIDA,222,242,20,9.01,16,18,2,12.5,0,0,0,0.0,15,19,4,26.67,169,163,-6,-3.55,422,442,20,4.74,AGUA COMPRIDA MG,-20.0574733,-48.1093074,10,2250
MG,AGUANIL,115,89,-26,-22.61,155,177,22,14.19,10,7,-3,-30.0,56,60,4,7.14,77,285,208,270.13,413,618,205,49.64,AGUANIL MG,-20.9424533,-45.3927152,10,2251
MG,AGUAS FORMOSAS,154,151,-3,-1.95,144,166,22,15.28,4,3,-1,-25.0,378,369,-9,-2.38,1068,888,-180,-16.85,1748,1577,-171,-9.78,AGUAS FORMOSAS MG,-17.083056,-40.935555,10,2252
MG,AGUAS VERMELHAS,240,245,5,2.08,18,19,1,5.56,6,3,-3,-50.0,229,242,13,5.68,610,713,103,16.89,1103,1222,119,10.79,AGUAS VERMELHAS MG,-15.7469091,-41.4601975,10,2253
MG,AIMORES,312,248,-64,-20.51,300,377,77,25.67,12,10,-2,-16.67,589,627,38,6.45,1799,1820,21,1.17,3012,3082,70,2.32,AIMORES MG,-19.4917754,-41.0615603,10,2254
MG,AIURUOCA,289,300,11,3.81,56,80,24,42.86,4,4,0,0.0,137,142,5,3.65,430,389,-41,-9.53,916,915,-1,-0.11,AIURUOCA MG,-21.9759554,-44.6036637,10,2255
MG,ALAGOA,38,42,4,10.53,37,41,4,10.81,0,3,3,0.0,53,48,-5,-9.43,248,252,4,1.61,376,386,10,2.66,ALAGOA MG,-22.1697202,-44.6400042,10,2256
MG,ALBERTINA,66,71,5,7.58,52,82,30,57.69,1,3,2,200.0,76,79,3,3.95,203,219,16,7.88,398,454,56,14.07,ALBERTINA MG,-20.66164,-43.784039,10,2257
MG,ALFENAS,1756,1807,51,2.9,2397,2533,136,5.67,850,861,11,1.29,5102,4974,-128,-2.51,11081,11719,638,5.76,21186,21894,708,3.34,ALFENAS MG,-21.4297405,-45.9479419,10,2259
MG,ALMENARA,279,248,-31,-11.11,148,200,52,35.14,1132,1130,-2,-0.18,1200,1245,45,3.75,2685,2826,141,5.25,5444,5649,205,3.77,ALMENARA MG,-16.1740678,-40.6904907,10,2261
MG,ALPERCATA,111,97,-14,-12.61,108,78,-30,-27.78,14,12,-2,-14.29,105,148,43,40.95,471,332,-139,-29.51,809,667,-142,-17.55,ALPERCATA MG,-18.9803616,-41.9827637,10,2262
MG,ALPINOPOLIS,298,285,-13,-4.36,437,442,5,1.14,38,37,-1,-2.63,705,713,8,1.13,1206,1157,-49,-4.06,2684,2634,-50,-1.86,ALPINOPOLIS MG,-20.863611,-46.387777,10,2263
MG,ALTEROSA,174,155,-19,-10.92,160,156,-4,-2.5,4,18,14,350.0,356,356,0,0.0,861,716,-145,-16.84,1555,1401,-154,-9.9,ALTEROSA MG,-21.249166,-46.143055,10,2264
MG,ALTO CAPARAO,35,27,-8,-22.86,7,8,1,14.29,2,1,-1,-50.0,136,142,6,4.41,372,333,-39,-10.48,552,511,-41,-7.43,ALTO CAPARAO MG,-20.4405661,-41.8683799,10,2265
MG,ALTO RIO DOCE,76,70,-6,-7.89,115,81,-34,-29.57,9,10,1,11.11,195,175,-20,-10.26,501,470,-31,-6.19,896,806,-90,-10.04,ALTO RIO DOCE MG,-21.0239537,-43.4133507,10,2266
MG,ALVARENGA,3,3,0,0.0,1,1,0,0.0,0,1,1,0.0,29,36,7,24.14,289,310,21,7.27,322,351,29,9.01,ALVARENGA MG,-19.4175,-41.728334,10,2267
MG,ALVINOPOLIS,202,190,-12,-5.94,1010,1122,112,11.09,37,25,-12,-32.43,432,440,8,1.85,692,553,-139,-20.09,2373,2330,-43,-1.81,ALVINOPOLIS MG,-20.1105199,-43.0601805,10,2268
MG,ALVORADA DE MINAS,78,81,3,3.85,0,1,1,0.0,0,0,0,0.0,49,50,1,2.04,317,302,-15,-4.73,444,434,-10,-2.25,ALVORADA DE MINAS MG,-18.7318587,-43.3641479,10,2269
MG,AMPARO DO SERRA,74,78,4,5.41,31,31,0,0.0,2,0,-2,-100.0,68,68,0,0.0,249,164,-85,-34.14,424,341,-83,-19.58,AMPARO DO SERRA MG,-20.5070255,-42.8028462,10,2270
MG,ANDRADAS,2030,1803,-227,-11.18,3181,3377,196,6.16,100,76,-24,-24.0,1914,1983,69,3.61,3188,3034,-154,-4.83,10413,10273,-140,-1.34,ANDRADAS MG,-22.0680484,-46.5688976,10,2271
MG,CACHOEIRA DE PAJEU,14,14,0,0.0,16,16,0,0.0,26,1,-25,-96.15,122,127,5,4.1,486,459,-27,-5.56,664,617,-47,-7.08,CACHOEIRA DE PAJEU MG,-15.965833,-41.496666,10,2272
MG,ANDRELANDIA,326,386,60,18.4,147,166,19,12.93,10,10,0,0.0,389,397,8,2.06,776,827,51,6.57,1648,1786,138,8.37,ANDRELANDIA MG,-21.739722,-44.308889,10,2273
MG,ANGELANDIA,251,307,56,22.31,18,31,13,72.22,0,4,4,0.0,118,90,-28,-23.73,377,362,-15,-3.98,764,794,30,3.93,ANGELANDIA MG,-17.7253,-42.2728,10,2274
MG,ANTONIO DIAS,234,208,-26,-11.11,797,929,132,16.56,236,107,-129,-54.66,213,207,-6,-2.82,745,712,-33,-4.43,2225,2163,-62,-2.79,ANTONIO DIAS MG,-19.6525,-42.872778,10,2276
MG,ANTONIO PRADO DE MINAS,18,18,0,0.0,0,0,0,0.0,0,0,0,0.0,11,8,-3,-27.27,180,198,18,10.0,209,224,15,7.18,ANTONIO PRADO DE MINAS MG,-21.0171988,-42.1101106,10,2277
MG,ARACAI,55,48,-7,-12.73,355,180,-175,-49.3,10,8,-2,-20.0,18,16,-2,-11.11,229,185,-44,-19.21,667,437,-230,-34.48,ARACAI MG,-19.200833,-44.2475,10,2278
MG,ARACITABA,18,10,-8,-44.44,12,15,3,25.0,0,0,0,0.0,15,12,-3,-20.0,160,134,-26,-16.25,205,171,-34,-16.59,ARACITABA MG,-21.3425,-43.378611,10,2279
MG,ARACUAI,284,318,34,11.97,318,312,-6,-1.89,128,176,48,37.5,1043,1016,-27,-2.59,2262,1910,-352,-15.56,4035,3732,-303,-7.51,ARACUAI MG,-16.8484451,-42.0661868,10,2280
MG,ARAGUARI,1908,1732,-176,-9.22,5187,5493,306,5.9,1302,1482,180,13.82,5954,5909,-45,-0.76,10051,10114,63,0.63,24402,24730,328,1.34,ARAGUARI MG,-18.6511256,-48.1933764,10,2281
MG,ARANTINA,3,4,1,33.33,24,39,15,62.5,7,14,7,100.0,38,41,3,7.89,316,223,-93,-29.43,388,321,-67,-17.27,ARANTINA MG,-21.911667,-44.255833,10,2282
MG,ARAPONGA,72,73,1,1.39,23,17,-6,-26.09,1,4,3,300.0,67,79,12,17.91,318,347,29,9.12,481,520,39,8.11,ARAPONGA MG,-20.666667,-42.520556,10,2283
MG,ARAPUA,30,25,-5,-16.67,281,332,51,18.15,5,9,4,80.0,21,23,2,9.52,269,162,-107,-39.78,606,551,-55,-9.08,ARAPUA MG,-19.034444,-46.155556,10,2285
MG,ARAUJOS,113,171,58,51.33,728,638,-90,-12.36,19,26,7,36.84,331,373,42,12.69,616,508,-108,-17.53,1807,1716,-91,-5.04,ARAUJOS MG,-19.948055,-45.165556,10,2286
MG,ARAXA,793,712,-81,-10.21,5484,5255,-229,-4.18,1499,1715,216,14.41,7026,6917,-109,-1.55,14207,13443,-764,-5.38,29009,28042,-967,-3.33,ARAXA MG,-19.5928536,-46.940241,10,2287
MG,ARCEBURGO,396,401,5,1.26,765,788,23,3.01,18,20,2,11.11,263,279,16,6.08,663,564,-99,-14.93,2105,2052,-53,-2.52,ARCEBURGO MG,-21.364444,-46.939722,10,2288
MG,ARCOS,195,225,30,15.38,3578,3719,141,3.94,457,486,29,6.35,2402,2360,-42,-1.75,4243,4024,-219,-5.16,10875,10814,-61,-0.56,ARCOS MG,-20.282223,-45.539444,10,2289
MG,AREADO,316,236,-80,-25.32,126,132,6,4.76,32,57,25,78.12,460,419,-41,-8.91,866,825,-41,-4.73,1800,1669,-131,-7.28,AREADO MG,-21.3582771,-46.1476688,10,2290
MG,ARGIRITA,75,78,3,4.0,46,38,-8,-17.39,0,1,1,0.0,42,44,2,4.76,236,232,-4,-1.69,399,393,-6,-1.5,ARGIRITA MG,-21.612761,-42.8371922,10,2291
MG,ARICANDUVA,25,31,6,24.0,2,6,4,200.0,0,0,0,0.0,39,31,-8,-20.51,259,234,-25,-9.65,325,302,-23,-7.08,ARICANDUVA MG,-17.8678,-42.5569,10,2292
MG,ARINOS,377,349,-28,-7.43,52,39,-13,-25.0,6,10,4,66.67,351,314,-37,-10.54,897,669,-228,-25.42,1683,1381,-302,-17.94,ARINOS MG,-15.917223,-46.106111,10,2293
MG,ASTOLFO DUTRA,130,103,-27,-20.77,2286,1765,-521,-22.79,56,23,-33,-58.93,381,358,-23,-6.04,857,849,-8,-0.93,3710,3098,-612,-16.5,ASTOLFO DUTRA MG,-21.3132636,-42.8624102,10,2294
MG,ATALEIA,221,210,-11,-4.98,21,10,-11,-52.38,1,2,1,100.0,108,102,-6,-5.56,694,567,-127,-18.3,1045,891,-154,-14.74,ATALEIA MG,-18.04432,-41.1110524,10,2295
MG,AUGUSTO DE LIMA,108,111,3,2.78,7,61,54,771.43,2,0,-2,-100.0,92,67,-25,-27.17,352,319,-33,-9.38,561,558,-3,-0.53,AUGUSTO DE LIMA MG,-18.1092963,-44.2651945,10,2296
MG,BALDIM,136,137,1,0.74,123,107,-16,-13.01,893,779,-114,-12.77,95,101,6,6.32,382,330,-52,-13.61,1629,1454,-175,-10.74,BALDIM MG,-19.2913568,-43.9558262,10,2298
MG,BAMBUI,559,539,-20,-3.58,1343,1331,-12,-0.89,85,96,11,12.94,900,872,-28,-3.11,1441,1443,2,0.14,4328,4281,-47,-1.09,BAMBUI MG,-20.0131996,-45.9777034,10,2299
MG,BANDEIRA,35,35,0,0.0,5,5,0,0.0,13,7,-6,-46.15,18,20,2,11.11,237,220,-17,-7.17,308,287,-21,-6.82,BANDEIRA MG,-15.884444,-40.559167,10,2300
MG,BANDEIRA DO SUL,21,15,-6,-28.57,528,172,-356,-67.42,15,2,-13,-86.67,121,130,9,7.44,289,226,-63,-21.8,974,545,-429,-44.05,BANDEIRA DO SUL MG,-21.728056,-46.385555,10,2301
MG,BARAO DE COCAIS,37,23,-14,-37.84,1002,1212,210,20.96,714,881,167,23.39,1030,1292,262,25.44,3005,3066,61,2.03,5788,6474,686,11.85,BARAO DE COCAIS MG,-19.9452437,-43.4870298,10,2302
MG,BARAO DE MONTE ALTO,139,129,-10,-7.19,6,7,1,16.67,2,6,4,200.0,31,39,8,25.81,352,374,22,6.25,530,555,25,4.72,BARAO DE MONTE ALTO MG,-21.244722,-42.2375,10,2303
MG,BARBACENA,773,751,-22,-2.85,4239,4489,250,5.9,724,906,182,25.14,7294,6848,-446,-6.11,15047,13913,-1134,-7.54,28077,26907,-1170,-4.17,BARBACENA MG,-21.2254524,-43.7735087,10,2304
MG,BARRA LONGA,97,112,15,15.46,16,16,0,0.0,19,6,-13,-68.42,100,106,6,6.0,265,242,-23,-8.68,497,482,-15,-3.02,BARRA LONGA MG,-20.2833541,-43.0423516,10,2305
MG,BARROSO,23,23,0,0.0,662,758,96,14.5,36,33,-3,-8.33,661,639,-22,-3.33,1365,1218,-147,-10.77,2747,2671,-76,-2.77,BARROSO MG,-21.187137,-43.9771259,10,2306
MG,BELMIRO BRAGA,173,191,18,10.4,211,204,-7,-3.32,0,3,3,0.0,21,24,3,14.29,252,148,-104,-41.27,657,570,-87,-13.24,BELMIRO BRAGA MG,-21.9486291,-43.413564,10,2308
MG,BELO HORIZONTE,800,2019,1219,152.38,69016,66156,-2860,-4.14,109473,122841,13368,12.21,168656,155254,-13402,-7.95,852926,857675,4749,0.56,1200871,1203945,3074,0.26,BELO HORIZONTE MG,-19.9227318,-43.9450948,10,2309
MG,BELO VALE,90,86,-4,-4.44,135,252,117,86.67,0,21,21,0.0,184,176,-8,-4.35,374,331,-43,-11.5,783,866,83,10.6,BELO VALE MG,-20.407778,-44.024167,10,2311
MG,BERILO,7,7,0,0.0,7,3,-4,-57.14,2,2,0,0.0,99,88,-11,-11.11,521,386,-135,-25.91,636,486,-150,-23.58,BERILO MG,-16.9515764,-42.4643732,10,2312
MG,BERTOPOLIS,50,47,-3,-6.0,0,0,0,0.0,0,0,0,0.0,8,11,3,37.5,132,155,23,17.42,190,213,23,12.11,BERTOPOLIS MG,-17.063333,-40.573889,10,2313
MG,BERIZAL,68,71,3,4.41,37,54,17,45.95,29,15,-14,-48.28,48,48,0,0.0,276,375,99,35.87,458,563,105,22.93,BERIZAL MG,-15.6118785,-41.7417382,10,2314
MG,BIAS FORTES,32,42,10,31.25,26,13,-13,-50.0,0,0,0,0.0,18,20,2,11.11,224,153,-71,-31.7,300,228,-72,-24.0,BIAS FORTES MG,-21.605833,-43.756944,10,2316
MG,BICAS,111,99,-12,-10.81,646,630,-16,-2.48,281,269,-12,-4.27,713,715,2,0.28,1125,762,-363,-32.27,2876,2475,-401,-13.94,BICAS MG,-21.7213723,-43.0604327,10,2317
MG,BIQUINHAS,48,36,-12,-25.0,2,0,-2,-100.0,1,1,0,0.0,51,55,4,7.84,219,215,-4,-1.83,321,307,-14,-4.36,BIQUINHAS MG,-18.783611,-45.502222,10,2318
MG,BOA ESPERANCA,1555,1551,-4,-0.26,937,901,-36,-3.84,130,181,51,39.23,1956,1962,6,0.31,2711,2701,-10,-0.37,7289,7296,7,0.1,BOA ESPERANCA MG,-21.0901253,-45.5660195,10,2319
MG,BOCAINA DE MINAS,66,62,-4,-6.06,50,52,2,4.0,0,5,5,0.0,64,64,0,0.0,400,310,-90,-22.5,580,493,-87,-15.0,BOCAINA DE MINAS MG,-22.167778,-44.394722,10,2320
MG,BOCAIUVA,909,934,25,2.75,2201,2260,59,2.68,139,143,4,2.88,1643,1794,151,9.19,3036,2642,-394,-12.98,7928,7773,-155,-1.96,BOCAIUVA MG,-17.1160208,-43.8122678,10,2321
MG,BOM DESPACHO,1033,995,-38,-3.68,2265,2455,190,8.39,334,397,63,18.86,3051,2998,-53,-1.74,4648,4524,-124,-2.67,11331,11369,38,0.34,BOM DESPACHO MG,-19.7375242,-45.2517288,10,2322
MG,BOM JARDIM DE MINAS,122,122,0,0.0,89,81,-8,-8.99,0,5,5,0.0,199,180,-19,-9.55,593,583,-10,-1.69,1003,971,-32,-3.19,BOM JARDIM DE MINAS MG,-21.9476466,-44.1906033,10,2323
MG,BOM JESUS DA PENHA,135,198,63,46.67,15,3,-12,-80.0,31,29,-2,-6.45,93,98,5,5.38,354,356,2,0.56,628,684,56,8.92,BOM JESUS DA PENHA MG,-21.0178774,-46.5213848,10,2324
MG,BOM JESUS DO AMPARO,255,223,-32,-12.55,45,38,-7,-15.56,0,0,0,0.0,264,256,-8,-3.03,505,483,-22,-4.36,1069,1000,-69,-6.45,BOM JESUS DO AMPARO MG,-19.7045132,-43.4752911,10,2325
MG,BOM JESUS DO GALHO,116,124,8,6.9,4,6,2,50.0,5,3,-2,-40.0,239,247,8,3.35,442,406,-36,-8.14,806,786,-20,-2.48,BOM JESUS DO GALHO MG,-19.8283191,-42.3162256,10,2326
MG,BOM REPOUSO,190,190,0,0.0,113,93,-20,-17.7,7,5,-2,-28.57,222,215,-7,-3.15,436,395,-41,-9.4,968,898,-70,-7.23,BOM REPOUSO MG,-22.4657069,-46.1485376,10,2327
MG,BOM SUCESSO,0,1,1,0.0,0,0,0,0.0,0,3,3,0.0,8,9,1,12.5,353,386,33,9.35,361,399,38,10.53,BOM SUCESSO MG,-21.0323516,-44.7598082,10,2328
MG,BONFIM,372,341,-31,-8.33,0,0,0,0.0,0,0,0,0.0,54,42,-12,-22.22,757,649,-108,-14.27,1183,1032,-151,-12.76,BONFIM MG,-17.1095565,-43.8179164,10,2329
MG,BONFINOPOLIS DE MINAS,432,434,2,0.46,17,21,4,23.53,3,0,-3,-100.0,122,122,0,0.0,434,423,-11,-2.53,1008,1000,-8,-0.79,BONFINOPOLIS DE MINAS MG,-16.5660011,-45.98645,10,2330
MG,BONITO DE MINAS,50,59,9,18.0,2,4,2,100.0,0,0,0,0.0,73,76,3,4.11,390,377,-13,-3.33,515,516,1,0.19,BONITO DE MINAS MG,-15.3191266,-44.7544,10,2331
MG,BORDA DA MATA,85,83,-2,-2.35,1189,1179,-10,-0.84,17,9,-8,-47.06,584,609,25,4.28,934,869,-65,-6.96,2809,2749,-60,-2.14,BORDA DA MATA MG,-22.274167,-46.165278,10,2332
MG,BOTELHOS,749,681,-68,-9.08,242,187,-55,-22.73,27,48,21,77.78,465,449,-16,-3.44,1190,1087,-103,-8.66,2673,2452,-221,-8.27,BOTELHOS MG,-21.65,-46.394722,10,2333
MG,BOTUMIRIM,18,18,0,0.0,34,81,47,138.24,0,0,0,0.0,32,32,0,0.0,316,260,-56,-17.72,400,391,-9,-2.25,BOTUMIRIM MG,-16.862778,-43.011111,10,2334
MG,BRASILANDIA DE MINAS,284,329,45,15.85,107,123,16,14.95,5,15,10,200.0,298,306,8,2.68,821,750,-71,-8.65,1515,1523,8,0.53,BRASILANDIA DE MINAS MG,-17.0096409,-46.0087622,10,2335
MG,BRASILIA DE MINAS,57,56,-1,-1.75,71,87,16,22.54,82,90,8,9.76,841,770,-71,-8.44,1648,1580,-68,-4.13,2699,2583,-116,-4.3,BRASILIA DE MINAS MG,-16.2075114,-44.430559,10,2336
MG,BRAS PIRES,5,2,-3,-60.0,8,7,-1,-12.5,6,9,3,50.0,45,41,-4,-8.89,276,115,-161,-58.33,340,174,-166,-48.82,BRAS PIRES MG,-20.8483109,-43.2430524,10,2337
MG,BRAUNAS,32,20,-12,-37.5,4,3,-1,-25.0,0,0,0,0.0,58,61,3,5.17,282,261,-21,-7.45,376,345,-31,-8.24,BRAUNAS MG,-19.055556,-42.716111,10,2338
MG,BUENO BRANDAO,93,73,-20,-21.51,90,86,-4,-4.44,0,0,0,0.0,232,258,26,11.21,655,615,-40,-6.11,1070,1032,-38,-3.55,BUENO BRANDAO MG,-22.441976,-46.3517971,10,2341
MG,BUENOPOLIS,73,59,-14,-19.18,24,28,4,16.67,6,8,2,33.33,243,231,-12,-4.94,554,548,-6,-1.08,900,874,-26,-2.89,BUENOPOLIS MG,-17.8756607,-44.1749365,10,2342
MG,BURITIS,149,169,20,13.42,365,351,-14,-3.84,44,26,-18,-40.91,1220,1096,-124,-10.16,1858,1700,-158,-8.5,3636,3342,-294,-8.09,BURITIS MG,-15.621389,-46.423889,10,2344
MG,CABECEIRA GRANDE,388,398,10,2.58,37,35,-2,-5.41,0,0,0,0.0,62,61,-1,-1.61,440,426,-14,-3.18,927,920,-7,-0.76,CABECEIRA GRANDE MG,-16.0297,-47.0906,10,2346
MG,CABO VERDE,603,573,-30,-4.98,118,147,29,24.58,18,9,-9,-50.0,243,264,21,8.64,638,621,-17,-2.66,1620,1614,-6,-0.37,CABO VERDE MG,-21.4743338,-46.3964995,10,2347
MG,CACHOEIRA DA PRATA,24,28,4,16.67,65,94,29,44.62,10,14,4,40.0,96,121,25,26.04,239,191,-48,-20.08,434,448,14,3.23,CACHOEIRA DA PRATA MG,-19.524723,-44.453056,10,2348
MG,CACHOEIRA DE MINAS,194,163,-31,-15.98,1047,1090,43,4.11,26,16,-10,-38.46,166,179,13,7.83,528,492,-36,-6.82,1961,1940,-21,-1.07,CACHOEIRA DE MINAS MG,-22.3554043,-45.7796324,10,2349
MG,CACHOEIRA DOURADA,269,280,11,4.09,1,0,-1,-100.0,3,2,-1,-33.33,15,13,-2,-13.33,437,351,-86,-19.68,725,646,-79,-10.9,CACHOEIRA DOURADA MG,-18.4934052,-49.5139895,10,2350
MG,CAIANA,22,22,0,0.0,6,6,0,0.0,5,2,-3,-60.0,68,73,5,7.35,342,224,-118,-34.5,443,327,-116,-26.19,CAIANA MG,-20.695555,-41.924723,10,2353
MG,CALDAS,165,167,2,1.21,552,520,-32,-5.8,16,13,-3,-18.75,407,430,23,5.65,781,655,-126,-16.13,1921,1785,-136,-7.08,CALDAS MG,-21.923611,-46.386111,10,2355
MG,CAMACHO,26,37,11,42.31,1,1,0,0.0,5,1,-4,-80.0,28,28,0,0.0,221,220,-1,-0.45,281,287,6,2.14,CAMACHO MG,-20.625556,-45.156667,10,2356
MG,CAMANDUCAIA,155,142,-13,-8.39,1891,2170,279,14.75,58,84,26,44.83,899,886,-13,-1.45,2710,2307,-403,-14.87,5713,5589,-124,-2.17,CAMANDUCAIA MG,-22.755278,-46.144444,10,2357
MG,CAMBUI,117,100,-17,-14.53,2209,2308,99,4.48,95,79,-16,-16.84,1975,1998,23,1.16,2354,2154,-200,-8.5,6750,6639,-111,-1.64,CAMBUI MG,-22.6122501,-46.0572137,10,2358
MG,CAMBUQUIRA,480,372,-108,-22.5,192,272,80,41.67,6,1,-5,-83.33,285,277,-8,-2.81,724,801,77,10.64,1687,1723,36,2.13,CAMBUQUIRA MG,-21.853056,-45.2953619,10,2359
MG,CAMPANARIO,85,85,0,0.0,7,0,-7,-100.0,0,0,0,0.0,52,45,-7,-13.46,277,242,-35,-12.64,421,372,-49,-11.64,CAMPANARIO MG,-18.2398144,-41.7271768,10,2360
MG,CAMPANHA,597,593,-4,-0.67,720,709,-11,-1.53,5,5,0,0.0,590,628,38,6.44,1063,894,-169,-15.9,2975,2829,-146,-4.91,CAMPANHA MG,-21.8361108,-45.401986,10,2361
MG,CAMPESTRE,36,34,-2,-5.56,1,1,0,0.0,0,0,0,0.0,56,44,-12,-21.43,511,507,-4,-0.78,604,586,-18,-2.98,CAMPESTRE MG,-21.0029918,-43.7327528,10,2362
MG,CAMPINA VERDE,632,634,2,0.32,200,222,22,11.0,19,14,-5,-26.32,694,630,-64,-9.22,1030,1005,-25,-2.43,2575,2505,-70,-2.72,CAMPINA VERDE MG,-19.535277,-49.486389,10,2363
MG,CAMPO AZUL,8,9,1,12.5,0,0,0,0.0,0,0,0,0.0,26,26,0,0.0,346,306,-40,-11.56,380,341,-39,-10.26,CAMPO AZUL MG,-16.5078525,-44.8133524,10,2364
MG,CAMPO BELO,377,334,-43,-11.41,3348,3248,-100,-2.99,532,464,-68,-12.78,2839,2681,-158,-5.57,3258,3782,524,16.08,10354,10509,155,1.5,CAMPO BELO MG,-20.8975,-45.277223,10,2365
MG,CAMPO DO MEIO,416,460,44,10.58,139,142,3,2.16,11,7,-4,-36.36,270,243,-27,-10.0,679,565,-114,-16.79,1515,1417,-98,-6.47,CAMPO DO MEIO MG,-21.1072006,-45.8301735,10,2366
MG,CAMPO FLORIDO,847,846,-1,-0.12,775,850,75,9.68,6,10,4,66.67,166,172,6,3.61,633,620,-13,-2.05,2427,2498,71,2.93,CAMPO FLORIDO MG,-19.760833,-48.572223,10,2367
MG,CAMPOS ALTOS,789,867,78,9.89,34,30,-4,-11.76,12,12,0,0.0,520,506,-14,-2.69,812,787,-25,-3.08,2167,2202,35,1.62,CAMPOS ALTOS MG,-19.696389,-46.171389,10,2368
MG,CAMPOS GERAIS,1067,1201,134,12.56,248,246,-2,-0.81,158,23,-135,-85.44,844,852,8,0.95,1601,1468,-133,-8.31,3918,3790,-128,-3.27,CAMPOS GERAIS MG,-21.2333342,-45.7584127,10,2369
MG,CANAA,57,59,2,3.51,6,6,0,0.0,4,3,-1,-25.0,59,59,0,0.0,236,244,8,3.39,362,371,9,2.49,CANAA MG,-20.685555,-42.62,10,2370
MG,CANAPOLIS,3,4,1,33.33,1,0,-1,-100.0,24,18,-6,-25.0,58,55,-3,-5.17,677,605,-72,-10.64,763,682,-81,-10.62,CANAPOLIS MG,-18.7228793,-49.2016329,10,2371
MG,CANA VERDE,75,68,-7,-9.33,102,172,70,68.63,5,5,0,0.0,78,77,-1,-1.28,341,291,-50,-14.66,601,613,12,2.0,CANA VERDE MG,-21.021308,-45.1817881,10,2372
MG,CANDEIAS,35,54,19,54.29,2752,2930,178,6.47,704,895,191,27.13,2751,2584,-167,-6.07,9423,8430,-993,-10.54,15665,14893,-772,-4.93,CANDEIAS MG,-20.7676161,-45.2763777,10,2373
MG,CANTAGALO,41,39,-2,-4.88,38,58,20,52.63,2,19,17,850.0,50,46,-4,-8.0,342,276,-66,-19.3,473,438,-35,-7.4,CANTAGALO MG,-20.4673592,-43.0356224,10,2374
MG,CAPARAO,17,14,-3,-17.65,7,6,-1,-14.29,0,3,3,0.0,84,77,-7,-8.33,361,298,-63,-17.45,469,398,-71,-15.14,CAPARAO MG,-20.5232726,-41.9049984,10,2375
MG,CAPELA NOVA,29,26,-3,-10.34,29,28,-1,-3.45,0,0,0,0.0,129,127,-2,-1.55,263,300,37,14.07,450,481,31,6.89,CAPELA NOVA MG,-20.9236773,-43.6179487,10,2376
MG,CAPELINHA,558,551,-7,-1.25,677,672,-5,-0.74,219,174,-45,-20.55,1538,1555,17,1.11,2630,2605,-25,-0.95,5622,5557,-65,-1.16,CAPELINHA MG,-17.693889,-42.518611,10,2377
MG,CAPETINGA,361,390,29,8.03,211,245,34,16.11,3,2,-1,-33.33,123,138,15,12.2,385,414,29,7.53,1083,1189,106,9.79,CAPETINGA MG,-20.6193382,-47.0577418,10,2378
MG,CAPINOPOLIS,371,381,10,2.7,570,716,146,25.61,42,12,-30,-71.43,508,528,20,3.94,960,841,-119,-12.4,2451,2478,27,1.1,CAPINOPOLIS MG,-18.682778,-49.569723,10,2380
MG,CAPITAO ANDRADE,33,34,1,3.03,10,4,-6,-60.0,4,17,13,325.0,50,44,-6,-12.0,282,270,-12,-4.26,379,369,-10,-2.64,CAPITAO ANDRADE MG,-19.0675,-41.859722,10,2381
MG,CAPITAO ENEAS,338,368,30,8.88,1388,1399,11,0.79,11,6,-5,-45.45,223,229,6,2.69,787,778,-9,-1.14,2747,2780,33,1.2,CAPITAO ENEAS MG,-16.3236018,-43.7154584,10,2382
MG,CAPITOLIO,137,122,-15,-10.95,264,242,-22,-8.33,54,48,-6,-11.11,411,406,-5,-1.22,1550,1277,-273,-17.61,2416,2095,-321,-13.29,CAPITOLIO MG,-20.6142437,-46.0487652,10,2383
MG,CAPUTIRA,70,69,-1,-1.43,12,8,-4,-33.33,4,4,0,0.0,102,95,-7,-6.86,346,360,14,4.05,534,536,2,0.37,CAPUTIRA MG,-20.171945,-42.270278,10,2384
MG,CARAI,65,57,-8,-12.31,64,54,-10,-15.62,2,0,-2,-100.0,160,152,-8,-5.0,595,732,137,23.03,886,995,109,12.3,CARAI MG,-17.1884104,-41.6976554,10,2385
MG,CARANAIBA,36,35,-1,-2.78,11,15,4,36.36,3,6,3,100.0,21,22,1,4.76,128,189,61,47.66,199,267,68,34.17,CARANAIBA MG,-20.8736914,-43.7379458,10,2386
MG,CARANDAI,750,694,-56,-7.47,730,771,41,5.62,35,38,3,8.57,858,769,-89,-10.37,1684,1633,-51,-3.03,4057,3905,-152,-3.75,CARANDAI MG,-20.9523934,-43.8043903,10,2387
MG,CARANGOLA,159,131,-28,-17.61,319,346,27,8.46,78,74,-4,-5.13,1454,1413,-41,-2.82,3022,2718,-304,-10.06,5032,4682,-350,-6.96,CARANGOLA MG,-20.733056,-42.029445,10,2388
MG,CARATINGA,535,465,-70,-13.08,2009,1942,-67,-3.33,1020,975,-45,-4.41,5602,5528,-74,-1.32,9503,10138,635,6.68,18669,19048,379,2.03,CARATINGA MG,-19.7900887,-42.140533,10,2389
MG,CARBONITA,191,196,5,2.62,34,30,-4,-11.76,35,40,5,14.29,223,217,-6,-2.69,1040,885,-155,-14.9,1523,1368,-155,-10.18,CARBONITA MG,-17.5308667,-43.0136207,10,2390
MG,CAREACU,169,196,27,15.98,187,187,0,0.0,22,25,3,13.64,177,201,24,13.56,392,383,-9,-2.3,947,992,45,4.75,CAREACU MG,-22.0434124,-45.6995247,10,2391
MG,CARLOS CHAGAS,931,822,-109,-11.71,441,534,93,21.09,11,23,12,109.09,370,352,-18,-4.86,1206,979,-227,-18.82,2959,2710,-249,-8.42,CARLOS CHAGAS MG,-21.744351,-43.3908675,10,2392
MG,CARMESIA,14,10,-4,-28.57,21,17,-4,-19.05,0,0,0,0.0,41,37,-4,-9.76,277,203,-74,-26.71,353,267,-86,-24.36,CARMESIA MG,-19.0854535,-43.1392003,10,2393
MG,CARMO DA CACHOEIRA,1415,1326,-89,-6.29,69,50,-19,-27.54,34,41,7,20.59,323,374,51,15.79,753,692,-61,-8.1,2594,2483,-111,-4.28,CARMO DA CACHOEIRA MG,-21.460556,-45.223334,10,2394
MG,CARMO DA MATA,307,307,0,0.0,997,1058,61,6.12,27,21,-6,-22.22,293,309,16,5.46,543,499,-44,-8.1,2167,2194,27,1.25,CARMO DA MATA MG,-20.558334,-44.8703774,10,2395
MG,CARMO DE MINAS,1029,997,-32,-3.11,128,93,-35,-27.34,42,31,-11,-26.19,286,512,226,79.02,630,533,-97,-15.4,2115,2166,51,2.41,CARMO DE MINAS MG,-22.1216655,-45.1323836,10,2396
MG,CARMO DO CAJURU,490,464,-26,-5.31,1903,1834,-69,-3.63,112,336,224,200.0,722,825,103,14.27,1427,1346,-81,-5.68,4654,4805,151,3.24,CARMO DO CAJURU MG,-20.184444,-44.770834,10,2397
MG,CARMO DO PARANAIBA,1273,1022,-251,-19.72,725,741,16,2.21,98,98,0,0.0,1424,1389,-35,-2.46,2073,1647,-426,-20.55,5593,4897,-696,-12.44,CARMO DO PARANAIBA MG,-18.9992327,-46.306916,10,2398
MG,CARMO DO RIO CLARO,1039,1012,-27,-2.6,301,330,29,9.63,49,39,-10,-20.41,784,816,32,4.08,1371,1284,-87,-6.35,3544,3481,-63,-1.78,CARMO DO RIO CLARO MG,-20.973315,-46.1186754,10,2399
MG,CARMOPOLIS DE MINAS,306,310,4,1.31,1127,1018,-109,-9.67,33,20,-13,-39.39,789,833,44,5.58,1302,1325,23,1.77,3557,3506,-51,-1.43,CARMOPOLIS DE MINAS MG,-20.541224,-44.6350611,10,2400
MG,CARNEIRINHO,445,458,13,2.92,906,907,1,0.11,4,3,-1,-25.0,198,193,-5,-2.53,671,567,-104,-15.5,2224,2128,-96,-4.32,CARNEIRINHO MG,-19.6975,-50.688055,10,2401
MG,CARRANCAS,176,184,8,4.55,39,44,5,12.82,22,6,-16,-72.73,74,73,-1,-1.35,356,337,-19,-5.34,667,644,-23,-3.45,CARRANCAS MG,-21.4910462,-44.6436151,10,2402
MG,CARVALHOPOLIS,20,40,20,100.0,80,68,-12,-15.0,1,4,3,300.0,49,27,-22,-44.9,245,233,-12,-4.9,395,372,-23,-5.82,CARVALHOPOLIS MG,-21.7773461,-45.8412117,10,2403
MG,CARVALHOS,51,50,-1,-1.96,63,59,-4,-6.35,2,2,0,0.0,108,111,3,2.78,245,205,-40,-16.33,469,427,-42,-8.96,CARVALHOS MG,-22.001667,-44.461667,10,2404
MG,CASA GRANDE,63,57,-6,-9.52,5,0,-5,-100.0,0,0,0,0.0,20,21,1,5.0,223,190,-33,-14.8,311,268,-43,-13.83,CASA GRANDE MG,-20.7937571,-43.928693,10,2405
MG,CASCALHO RICO,200,219,19,9.5,68,64,-4,-5.88,0,0,0,0.0,40,31,-9,-22.5,265,225,-40,-15.09,573,539,-34,-5.93,CASCALHO RICO MG,-18.579344,-47.875774,10,2406
MG,CASSIA,600,584,-16,-2.67,430,307,-123,-28.6,16,20,4,25.0,543,630,87,16.02,1147,1088,-59,-5.14,2736,2629,-107,-3.91,CASSIA MG,-20.5796525,-46.9262786,10,2407
MG,CONCEICAO DA BARRA DE MINAS,38,24,-14,-36.84,6,6,0,0.0,0,0,0,0.0,65,38,-27,-41.54,220,188,-32,-14.55,329,256,-73,-22.19,CONCEICAO DA BARRA DE MINAS MG,-21.128889,-44.472223,10,2408
MG,CATAGUASES,309,297,-12,-3.88,4832,4695,-137,-2.84,419,446,27,6.44,3256,3133,-123,-3.78,6775,6541,-234,-3.45,15591,15112,-479,-3.07,CATAGUASES MG,-21.387426,-42.6957219,10,2409
MG,CATAS ALTAS,21,18,-3,-14.29,313,502,189,60.38,24,22,-2,-8.33,125,111,-14,-11.2,540,497,-43,-7.96,1023,1150,127,12.41,CATAS ALTAS MG,-20.0748989,-43.4078304,10,2410
MG,CATAS ALTAS DA NORUEGA,28,35,7,25.0,114,157,43,37.72,11,11,0,0.0,23,25,2,8.7,191,250,59,30.89,367,478,111,30.25,CATAS ALTAS DA NORUEGA MG,-20.690277,-43.4975,10,2411
MG,CATUTI,2,1,-1,-50.0,0,0,0,0.0,0,0,0,0.0,25,21,-4,-16.0,259,263,4,1.54,286,285,-1,-0.35,CATUTI MG,-15.3597,-42.9628,10,2413
MG,CEDRO DO ABAETE,15,11,-4,-26.67,0,0,0,0.0,0,0,0,0.0,5,0,-5,-100.0,172,164,-8,-4.65,192,175,-17,-8.85,CEDRO DO ABAETE MG,-19.148333,-45.711389,10,2415
MG,CENTRAL DE MINAS,10,11,1,10.0,24,21,-3,-12.5,3,13,10,333.33,203,193,-10,-4.93,228,196,-32,-14.04,468,434,-34,-7.26,CENTRAL DE MINAS MG,-18.7612885,-41.3071204,10,2416
MG,CENTRALINA,159,139,-20,-12.58,9,24,15,166.67,0,2,2,0.0,277,266,-11,-3.97,552,357,-195,-35.33,997,788,-209,-20.96,CENTRALINA MG,-18.5843349,-49.1954739,10,2417
MG,CHALE,14,3,-11,-78.57,16,12,-4,-25.0,2,5,3,150.0,87,80,-7,-8.05,57,304,247,433.33,176,404,228,129.55,CHALE MG,-20.0419748,-41.6914563,10,2419
MG,CHAPADA DO NORTE,3,1,-2,-66.67,8,9,1,12.5,10,1,-9,-90.0,107,97,-10,-9.35,371,328,-43,-11.59,499,436,-63,-12.63,CHAPADA DO NORTE MG,-17.0880036,-42.5380774,10,2420
MG,CHAPADA GAUCHA,200,216,16,8.0,6,7,1,16.67,2,2,0,0.0,266,296,30,11.28,706,391,-315,-44.62,1180,912,-268,-22.71,CHAPADA GAUCHA MG,-15.2946253,-45.6284904,10,2421
MG,CIPOTANEA,6,5,-1,-16.67,4,3,-1,-25.0,38,34,-4,-10.53,39,34,-5,-12.82,296,270,-26,-8.78,383,346,-37,-9.66,CIPOTANEA MG,-20.905278,-43.365556,10,2423
MG,CLARO DOS POCOES,106,129,23,21.7,17,18,1,5.88,0,11,11,0.0,86,87,1,1.16,373,345,-28,-7.51,582,590,8,1.37,CLARO DOS POCOES MG,-17.0758235,-44.2117357,10,2425
MG,CLAUDIO,298,321,23,7.72,4353,4996,643,14.77,275,273,-2,-0.73,1435,1505,70,4.88,2563,2482,-81,-3.16,8924,9577,653,7.32,CLAUDIO MG,-20.4448485,-44.7655217,10,2426
MG,COIMBRA,217,182,-35,-16.13,130,129,-1,-0.77,12,26,14,116.67,305,274,-31,-10.16,318,237,-81,-25.47,982,848,-134,-13.65,COIMBRA MG,-20.8563255,-42.8026943,10,2427
MG,COLUNA,36,34,-2,-5.56,41,23,-18,-43.9,0,0,0,0.0,180,171,-9,-5.0,386,304,-82,-21.24,643,532,-111,-17.26,COLUNA MG,-18.2326274,-42.8400811,10,2428
MG,COMENDADOR GOMES,2875,1925,-950,-33.04,1,1,0,0.0,14,1,-13,-92.86,50,50,0,0.0,306,283,-23,-7.52,3246,2260,-986,-30.38,COMENDADOR GOMES MG,-19.695155,-49.0843408,10,2429
MG,COMERCINHO,8,8,0,0.0,4,3,-1,-25.0,0,0,0,0.0,48,47,-1,-2.08,334,298,-36,-10.78,394,356,-38,-9.64,COMERCINHO MG,-16.2965093,-41.7930954,10,2430
MG,CONCEICAO DA APARECIDA,189,184,-5,-2.65,60,43,-17,-28.33,9,16,7,77.78,255,261,6,2.35,529,556,27,5.1,1042,1060,18,1.73,CONCEICAO DA APARECIDA MG,-21.094166,-46.204444,10,2431
MG,CONCEICAO DAS PEDRAS,38,29,-9,-23.68,14,14,0,0.0,0,0,0,0.0,29,21,-8,-27.59,202,183,-19,-9.41,283,247,-36,-12.72,CONCEICAO DAS PEDRAS MG,-22.1596572,-45.4550521,10,2432
MG,CONCEICAO DAS ALAGOAS,750,703,-47,-6.27,2043,2016,-27,-1.32,35,52,17,48.57,683,756,73,10.69,1710,1392,-318,-18.6,5221,4919,-302,-5.78,CONCEICAO DAS ALAGOAS MG,-19.9194009,-48.3803414,10,2433
MG,CONCEICAO DE IPANEMA,4,6,2,50.0,17,13,-4,-23.53,0,0,0,0.0,28,25,-3,-10.71,314,212,-102,-32.48,363,256,-107,-29.48,CONCEICAO DE IPANEMA MG,-19.928334,-41.693889,10,2434
MG,CONCEICAO DO MATO DENTRO,145,129,-16,-11.03,1674,1786,112,6.69,810,1105,295,36.42,523,581,58,11.09,2074,2500,426,20.54,5226,6101,875,16.74,CONCEICAO DO MATO DENTRO MG,-19.037222,-43.425278,10,2435
MG,CONCEICAO DO RIO VERDE,791,816,25,3.16,307,236,-71,-23.13,73,59,-14,-19.18,413,408,-5,-1.21,640,600,-40,-6.25,2224,2119,-105,-4.72,CONCEICAO DO RIO VERDE MG,-21.881078,-45.0868526,10,2437
MG,CONCEICAO DOS OUROS,47,47,0,0.0,1230,1397,167,13.58,24,23,-1,-4.17,261,266,5,1.92,573,498,-75,-13.09,2135,2231,96,4.5,CONCEICAO DOS OUROS MG,-22.413056,-45.797777,10,2438
MG,CONEGO MARINHO,2,4,2,100.0,5,5,0,0.0,0,0,0,0.0,30,25,-5,-16.67,309,320,11,3.56,346,354,8,2.31,CONEGO MARINHO MG,-15.2974056,-44.4140513,10,2439
MG,CONGONHAL,30,39,9,30.0,394,445,51,12.94,38,25,-13,-34.21,348,308,-40,-11.49,562,495,-67,-11.92,1372,1312,-60,-4.37,CONGONHAL MG,-22.1532505,-46.0404698,10,2441
MG,CONGONHAS DO NORTE,8,12,4,50.0,3,3,0,0.0,1,3,2,200.0,63,60,-3,-4.76,222,197,-25,-11.26,297,275,-22,-7.41,CONGONHAS DO NORTE MG,-18.8100392,-43.6783242,10,2443
MG,CONQUISTA,175,165,-10,-5.71,462,487,25,5.41,9,10,1,11.11,139,122,-17,-12.23,534,522,-12,-2.25,1319,1306,-13,-0.99,CONQUISTA MG,-19.936944,-47.543055,10,2444
MG,CONSELHEIRO LAFAIETE,215,200,-15,-6.98,1299,1559,260,20.02,669,698,29,4.33,7162,6664,-498,-6.95,12135,12397,262,2.16,21480,21518,38,0.18,CONSELHEIRO LAFAIETE MG,-20.6596107,-43.785743,10,2445
MG,CONSELHEIRO PENA,171,173,2,1.17,322,352,30,9.32,15,6,-9,-60.0,512,542,30,5.86,1015,806,-209,-20.59,2035,1879,-156,-7.67,CONSELHEIRO PENA MG,-19.1720883,-41.471995,10,2446
MG,CONSOLACAO,20,27,7,35.0,11,11,0,0.0,0,0,0,0.0,10,12,2,20.0,130,102,-28,-21.54,171,152,-19,-11.11,CONSOLACAO MG,-22.551389,-45.921111,10,2447
MG,COQUEIRAL,529,508,-21,-3.97,152,160,8,5.26,5,10,5,100.0,177,176,-1,-0.56,415,396,-19,-4.58,1278,1250,-28,-2.19,COQUEIRAL MG,-21.1898365,-45.4409829,10,2449
MG,CORACAO DE JESUS,154,154,0,0.0,78,80,2,2.56,30,30,0,0.0,336,343,7,2.08,736,696,-40,-5.43,1334,1303,-31,-2.32,CORACAO DE JESUS MG,-16.6888187,-44.3577401,10,2450
MG,CORDISBURGO,189,175,-14,-7.41,22,42,20,90.91,10,6,-4,-40.0,117,113,-4,-3.42,405,440,35,8.64,743,776,33,4.44,CORDISBURGO MG,-19.125834,-44.320278,10,2451
MG,CORDISLANDIA,152,166,14,9.21,27,25,-2,-7.41,0,1,1,0.0,13,19,6,46.15,210,164,-46,-21.9,402,375,-27,-6.72,CORDISLANDIA MG,-21.792843,-45.7029983,10,2452
MG,CORINTO,472,419,-53,-11.23,351,506,155,44.16,23,14,-9,-39.13,816,786,-30,-3.68,1266,1149,-117,-9.24,2928,2874,-54,-1.84,CORINTO MG,-18.363056,-44.456111,10,2453
MG,COROACI,62,57,-5,-8.06,1,1,0,0.0,0,0,0,0.0,108,104,-4,-3.7,480,375,-105,-21.88,651,537,-114,-17.51,COROACI MG,-18.6194369,-42.2830239,10,2454
MG,COROMANDEL,1647,1621,-26,-1.58,719,729,10,1.39,176,179,3,1.7,1286,1288,2,0.16,2017,1741,-276,-13.68,5845,5558,-287,-4.91,COROMANDEL MG,-18.473889,-47.200278,10,2455
MG,CORONEL MURTA,15,12,-3,-20.0,166,147,-19,-11.45,10,17,7,70.0,79,75,-4,-5.06,414,365,-49,-11.84,684,616,-68,-9.94,CORONEL MURTA MG,-16.6165034,-42.1848073,10,2457
MG,CORONEL PACHECO,55,56,1,1.82,113,118,5,4.42,5,7,2,40.0,37,35,-2,-5.41,239,148,-91,-38.08,449,364,-85,-18.93,CORONEL PACHECO MG,-21.5878865,-43.2615975,10,2458
MG,CORREGO DANTA,111,85,-26,-23.42,23,22,-1,-4.35,0,0,0,0.0,140,130,-10,-7.14,350,311,-39,-11.14,624,548,-76,-12.18,CORREGO DANTA MG,-19.823889,-45.904167,10,2460
MG,CORREGO FUNDO,86,68,-18,-20.93,713,659,-54,-7.57,6,9,3,50.0,196,190,-6,-3.06,491,422,-69,-14.05,1492,1348,-144,-9.65,CORREGO FUNDO MG,-20.4490405,-45.5558238,10,2462
MG,CORREGO NOVO,40,44,4,10.0,0,0,0,0.0,19,1,-18,-94.74,32,30,-2,-6.25,277,206,-71,-25.63,368,281,-87,-23.64,CORREGO NOVO MG,-19.832223,-42.395833,10,2463
MG,COUTO DE MAGALHAES DE MINAS,68,73,5,7.35,7,8,1,14.29,5,0,-5,-100.0,306,322,16,5.23,310,259,-51,-16.45,696,662,-34,-4.89,COUTO DE MAGALHAES DE MINAS MG,-18.073056,-43.4718628,10,2464
MG,CRISOLITA,137,123,-14,-10.22,0,0,0,0.0,0,0,0,0.0,14,23,9,64.29,288,232,-56,-19.44,439,378,-61,-13.9,CRISOLITA MG,-17.2391664,-40.9132444,10,2465
MG,CRISTAIS,492,440,-52,-10.57,1773,1712,-61,-3.44,9,9,0,0.0,269,278,9,3.35,647,531,-116,-17.93,3190,2970,-220,-6.9,CRISTAIS MG,-20.875834,-45.518611,10,2466
MG,CRISTALIA,100,134,34,34.0,1,3,2,200.0,0,0,0,0.0,31,34,3,9.68,351,290,-61,-17.38,483,461,-22,-4.55,CRISTALIA MG,-16.7179933,-42.8648107,10,2467
MG,CRISTIANO OTONI,75,63,-12,-16.0,120,114,-6,-5.0,15,24,9,60.0,121,126,5,4.13,377,287,-90,-23.87,708,614,-94,-13.28,CRISTIANO OTONI MG,-20.8324096,-43.8053057,10,2468
MG,CRISTINA,250,238,-12,-4.8,605,594,-11,-1.82,10,2,-8,-80.0,166,176,10,6.02,468,468,0,0.0,1499,1478,-21,-1.4,CRISTINA MG,-22.212222,-45.264167,10,2469
MG,CRUCILANDIA,37,20,-17,-45.95,72,66,-6,-8.33,9,13,4,44.44,120,124,4,3.33,422,451,29,6.87,660,674,14,2.12,CRUCILANDIA MG,-20.3985647,-44.3429275,10,2470
MG,CRUZEIRO DA FORTALEZA,219,205,-14,-6.39,44,44,0,0.0,7,8,1,14.29,136,135,-1,-0.74,310,349,39,12.58,716,741,25,3.49,CRUZEIRO DA FORTALEZA MG,-18.9461873,-46.6738005,10,2471
MG,CRUZILIA,299,292,-7,-2.34,896,1025,129,14.4,29,20,-9,-31.03,597,591,-6,-1.01,916,883,-33,-3.6,2737,2811,74,2.7,CRUZILIA MG,-21.838333,-44.808056,10,2472
MG,CUPARAQUE,27,21,-6,-22.22,12,12,0,0.0,0,0,0,0.0,98,105,7,7.14,205,361,156,76.1,342,499,157,45.91,CUPARAQUE MG,-18.9697,-41.0986,10,2473
MG,CURRAL DE DENTRO,128,134,6,4.69,50,29,-21,-42.0,0,0,0,0.0,34,35,1,2.94,284,267,-17,-5.99,496,465,-31,-6.25,CURRAL DE DENTRO MG,-15.9332656,-41.8568896,10,2474
MG,CURVELO,2285,1969,-316,-13.83,3464,3475,11,0.32,585,576,-9,-1.54,4150,4198,48,1.16,7407,7566,159,2.15,17891,17784,-107,-0.6,CURVELO MG,-18.7571926,-44.4305993,10,2475
MG,DATAS,156,139,-17,-10.9,38,17,-21,-55.26,0,0,0,0.0,78,66,-12,-15.38,329,249,-80,-24.32,601,471,-130,-21.63,DATAS MG,-18.4459187,-43.6584287,10,2476
MG,DELFIM MOREIRA,165,162,-3,-1.82,159,201,42,26.42,7,3,-4,-57.14,109,116,7,6.42,422,379,-43,-10.19,862,861,-1,-0.12,DELFIM MOREIRA MG,-22.5086783,-45.2792398,10,2477
MG,DELFINOPOLIS,1095,1138,43,3.93,23,15,-8,-34.78,4,4,0,0.0,164,188,24,14.63,523,521,-2,-0.38,1809,1866,57,3.15,DELFINOPOLIS MG,-20.344749,-46.8546425,10,2478
MG,DESCOBERTO,85,76,-9,-10.59,478,321,-157,-32.85,0,3,3,0.0,78,66,-12,-15.38,261,271,10,3.83,902,737,-165,-18.29,DESCOBERTO MG,-21.459444,-42.967223,10,2480
MG,DESTERRO DE ENTRE RIOS,18,37,19,105.56,306,376,70,22.88,0,8,8,0.0,163,172,9,5.52,377,266,-111,-29.44,864,859,-5,-0.58,DESTERRO DE ENTRE RIOS MG,-20.66,-44.332223,10,2481
MG,DESTERRO DO MELO,48,42,-6,-12.5,8,7,-1,-12.5,0,0,0,0.0,60,52,-8,-13.33,238,197,-41,-17.23,354,298,-56,-15.82,DESTERRO DO MELO MG,-21.1460033,-43.518329,10,2482
MG,DIAMANTINA,257,260,3,1.17,320,371,51,15.94,158,290,132,83.54,2297,2221,-76,-3.31,6156,6076,-80,-1.3,9188,9218,30,0.33,DIAMANTINA MG,-18.2440862,-43.6006487,10,2483
MG,DIOGO DE VASCONCELOS,14,15,1,7.14,0,0,0,0.0,2,2,0,0.0,28,32,4,14.29,179,118,-61,-34.08,223,167,-56,-25.11,DIOGO DE VASCONCELOS MG,-20.4868723,-43.1984645,10,2484
MG,DIONISIO,60,42,-18,-30.0,47,46,-1,-2.13,34,19,-15,-44.12,125,103,-22,-17.6,545,565,20,3.67,811,775,-36,-4.44,DIONISIO MG,-19.841944,-42.776945,10,2485
MG,DIVINESIA,32,36,4,12.5,129,141,12,9.3,32,22,-10,-31.25,57,52,-5,-8.77,311,158,-153,-49.2,561,409,-152,-27.09,DIVINESIA MG,-20.990277,-43.003889,10,2486
MG,DIVINO,37,35,-2,-5.41,86,96,10,11.63,17,20,3,17.65,527,546,19,3.61,989,895,-94,-9.5,1656,1592,-64,-3.86,DIVINO MG,-20.6151497,-42.1474733,10,2487
MG,DIVINO DAS LARANJEIRAS,36,38,2,5.56,7,7,0,0.0,15,4,-11,-73.33,58,63,5,8.62,336,346,10,2.98,452,458,6,1.33,DIVINO DAS LARANJEIRAS MG,-18.7775,-41.479167,10,2488
MG,DIVINOLANDIA DE MINAS,30,24,-6,-20.0,25,37,12,48.0,0,0,0,0.0,131,120,-11,-8.4,191,194,3,1.57,377,375,-2,-0.53,DIVINOLANDIA DE MINAS MG,-18.8021453,-42.6153788,10,2489
MG,DIVINOPOLIS,673,723,50,7.43,12612,12493,-119,-0.94,2253,1950,-303,-13.45,14929,14373,-556,-3.72,26265,25667,-598,-2.28,56732,55206,-1526,-2.69,DIVINOPOLIS MG,-20.1597921,-44.8739341,10,2490
MG,DIVISA ALEGRE,6,7,1,16.67,223,235,12,5.38,0,0,0,0.0,125,121,-4,-3.2,351,301,-50,-14.25,705,664,-41,-5.82,DIVISA ALEGRE MG,-15.7207751,-41.3442809,10,2491
MG,DIVISA NOVA,160,158,-2,-1.25,23,11,-12,-52.17,4,0,-4,-100.0,123,108,-15,-12.2,336,315,-21,-6.25,646,592,-54,-8.36,DIVISA NOVA MG,-21.5126801,-46.1926626,10,2492
MG,DIVISOPOLIS,28,34,6,21.43,2,6,4,200.0,0,0,0,0.0,40,51,11,27.5,423,271,-152,-35.93,493,362,-131,-26.57,DIVISOPOLIS MG,-15.7216545,-41.0032019,10,2493
MG,DOM BOSCO,68,75,7,10.29,2,2,0,0.0,0,0,0,0.0,33,31,-2,-6.06,209,156,-53,-25.36,312,264,-48,-15.38,DOM BOSCO MG,-16.6516044,-46.2677917,10,2494
MG,DOM CAVATI,22,18,-4,-18.18,57,60,3,5.26,2,2,0,0.0,131,124,-7,-5.34,381,381,0,0.0,593,585,-8,-1.35,DOM CAVATI MG,-19.3744152,-42.1067301,10,2495
MG,DOM JOAQUIM,29,28,-1,-3.45,4,5,1,25.0,3,1,-2,-66.67,89,87,-2,-2.25,286,285,-1,-0.35,411,406,-5,-1.22,DOM JOAQUIM MG,-18.967137,-43.2552141,10,2496
MG,DOM SILVERIO,103,74,-29,-28.16,354,352,-2,-0.56,2,2,0,0.0,184,183,-1,-0.54,318,274,-44,-13.84,961,885,-76,-7.91,DOM SILVERIO MG,-20.1631352,-42.9666824,10,2497
MG,DOM VICOSO,97,91,-6,-6.19,3,0,-3,-100.0,1,2,1,100.0,20,19,-1,-5.0,204,164,-40,-19.61,325,276,-49,-15.08,DOM VICOSO MG,-22.2534164,-45.1603324,10,2498
MG,DONA EUSEBIA,103,93,-10,-9.71,173,117,-56,-32.37,25,2,-23,-92.0,234,288,54,23.08,343,358,15,4.37,878,858,-20,-2.28,DONA EUSEBIA MG,-21.316667,-42.810556,10,2499
MG,DORES DE CAMPOS,21,17,-4,-19.05,1970,1939,-31,-1.57,38,26,-12,-31.58,313,296,-17,-5.43,569,386,-183,-32.16,2911,2664,-247,-8.49,DORES DE CAMPOS MG,-21.107222,-44.0225,10,2500
MG,DORES DE GUANHAES,59,46,-13,-22.03,156,155,-1,-0.64,0,0,0,0.0,102,100,-2,-1.96,300,332,32,10.67,617,633,16,2.59,DORES DE GUANHAES MG,-19.0578968,-42.9292569,10,2501
MG,DORES DO INDAIA,264,299,35,13.26,347,315,-32,-9.22,40,29,-11,-27.5,443,399,-44,-9.93,1015,877,-138,-13.6,2109,1919,-190,-9.01,DORES DO INDAIA MG,-19.4636451,-45.60166,10,2502
MG,DORES DO TURVO,75,66,-9,-12.0,17,21,4,23.53,1,0,-1,-100.0,59,51,-8,-13.56,145,242,97,66.9,297,380,83,27.95,DORES DO TURVO MG,-20.975278,-43.188889,10,2503
MG,DORESOPOLIS,31,32,1,3.23,78,73,-5,-6.41,1,0,-1,-100.0,4,5,1,25.0,177,181,4,2.26,291,291,0,0.0,DORESOPOLIS MG,-20.287222,-45.903056,10,2504
MG,DOURADOQUARA,38,41,3,7.89,46,50,4,8.7,8,2,-6,-75.0,11,12,1,9.09,264,189,-75,-28.41,367,294,-73,-19.89,DOURADOQUARA MG,-18.431062,-47.608269,10,2505
MG,DURANDE,21,15,-6,-28.57,11,8,-3,-27.27,0,9,9,0.0,97,89,-8,-8.25,214,310,96,44.86,343,431,88,25.66,DURANDE MG,-20.203611,-41.798055,10,2506
MG,ELOI MENDES,878,850,-28,-3.19,1195,1299,104,8.7,176,185,9,5.11,1296,1276,-20,-1.54,1745,1721,-24,-1.38,5290,5331,41,0.78,ELOI MENDES MG,-21.6094466,-45.5660211,10,2507
MG,ENGENHEIRO CALDAS,120,118,-2,-1.67,298,302,4,1.34,2,6,4,200.0,321,312,-9,-2.8,625,749,124,19.84,1366,1487,121,8.86,ENGENHEIRO CALDAS MG,-19.201389,-42.046944,10,2508
MG,ENGENHEIRO NAVARRO,162,141,-21,-12.96,32,28,-4,-12.5,3,5,2,66.67,100,100,0,0.0,421,349,-72,-17.1,718,623,-95,-13.23,ENGENHEIRO NAVARRO MG,-17.286622,-43.9515719,10,2509
MG,ENTRE FOLHAS,21,12,-9,-42.86,52,46,-6,-11.54,3,2,-1,-33.33,67,60,-7,-10.45,280,229,-51,-18.21,423,349,-74,-17.49,ENTRE FOLHAS MG,-19.6258823,-42.2328975,10,2510
MG,ENTRE RIOS DE MINAS,249,206,-43,-17.27,152,154,2,1.32,25,39,14,56.0,641,628,-13,-2.03,913,788,-125,-13.69,1980,1815,-165,-8.33,ENTRE RIOS DE MINAS MG,-20.670834,-44.065556,10,2511
MG,ERVALIA,127,137,10,7.87,600,524,-76,-12.67,57,35,-22,-38.6,595,603,8,1.34,1038,1066,28,2.7,2417,2365,-52,-2.15,ERVALIA MG,-20.8400156,-42.653352,10,2512
MG,ESPERA FELIZ,115,113,-2,-1.74,254,267,13,5.12,103,40,-63,-61.17,1083,1097,14,1.29,1659,1488,-171,-10.31,3214,3005,-209,-6.5,ESPERA FELIZ MG,-20.6494192,-41.9080693,10,2514
MG,ESPINOSA,24,23,-1,-4.17,795,714,-81,-10.19,25,22,-3,-12.0,747,744,-3,-0.4,1251,1303,52,4.16,2842,2806,-36,-1.27,ESPINOSA MG,-14.9232007,-42.8093337,10,2515
MG,ESPIRITO SANTO DO DOURADO,86,72,-14,-16.28,296,230,-66,-22.3,2,0,-2,-100.0,53,62,9,16.98,289,296,7,2.42,726,660,-66,-9.09,ESPIRITO SANTO DO DOURADO MG,-22.046666,-45.950833,10,2516
MG,ESTIVA,130,117,-13,-10.0,179,206,27,15.08,13,22,9,69.23,466,489,23,4.94,799,876,77,9.64,1587,1710,123,7.75,ESTIVA MG,-22.4638686,-46.0182101,10,2517
MG,ESTRELA DALVA,34,67,33,97.06,1,1,0,0.0,0,0,0,0.0,36,40,4,11.11,216,190,-26,-12.04,287,298,11,3.83,ESTRELA DALVA MG,-21.741666,-42.460833,10,2518
MG,ESTRELA DO INDAIA,125,136,11,8.8,4,3,-1,-25.0,2,1,-1,-50.0,86,77,-9,-10.47,254,243,-11,-4.33,471,460,-11,-2.34,ESTRELA DO INDAIA MG,-19.5225,-45.7875,10,2519
MG,ESTRELA DO SUL,562,320,-242,-43.06,324,318,-6,-1.85,4,10,6,150.0,115,119,4,3.48,469,274,-195,-41.58,1474,1041,-433,-29.38,ESTRELA DO SUL MG,-18.7420499,-47.6900736,10,2520
MG,EUGENOPOLIS,117,91,-26,-22.22,537,487,-50,-9.31,39,45,6,15.38,209,212,3,1.44,585,356,-229,-39.15,1487,1191,-296,-19.91,EUGENOPOLIS MG,-21.0968165,-42.1850985,10,2521
MG,EXTREMA,40,49,9,22.5,10825,10715,-110,-1.02,191,217,26,13.61,4190,5798,1608,38.38,9408,9892,484,5.14,24654,26671,2017,8.18,EXTREMA MG,-22.8549109,-46.3190079,10,2523
MG,FAMA,72,71,-1,-1.39,7,2,-5,-71.43,4,3,-1,-25.0,16,20,4,25.0,147,157,10,6.8,246,253,7,2.85,FAMA MG,-21.4090398,-45.8322579,10,2524
MG,FARIA LEMOS,177,159,-18,-10.17,98,93,-5,-5.1,2,3,1,50.0,21,22,1,4.76,232,146,-86,-37.07,530,423,-107,-20.19,FARIA LEMOS MG,-20.8051202,-42.0127393,10,2525
MG,FELICIO DOS SANTOS,36,38,2,5.56,4,11,7,175.0,0,0,0,0.0,99,93,-6,-6.06,274,277,3,1.09,413,419,6,1.45,FELICIO DOS SANTOS MG,-18.0765035,-43.2471128,10,2526
MG,SAO GONCALO DO RIO PRETO,33,33,0,0.0,36,35,-1,-2.78,1,0,-1,-100.0,38,35,-3,-7.89,280,250,-30,-10.71,388,353,-35,-9.02,SAO GONCALO DO RIO PRETO MG,-18.0042852,-43.3811575,10,2527
MG,FELISBURGO,60,55,-5,-8.33,12,14,2,16.67,0,0,0,0.0,76,73,-3,-3.95,497,481,-16,-3.22,645,623,-22,-3.41,FELISBURGO MG,-16.638889,-40.760556,10,2528
MG,FELIXLANDIA,847,810,-37,-4.37,60,52,-8,-13.33,5,4,-1,-20.0,371,387,16,4.31,859,882,23,2.68,2142,2135,-7,-0.33,FELIXLANDIA MG,-18.7573983,-44.8991465,10,2529
MG,FERNANDES TOURINHO,149,92,-57,-38.26,5,4,-1,-20.0,0,1,1,0.0,47,40,-7,-14.89,390,168,-222,-56.92,591,305,-286,-48.39,FERNANDES TOURINHO MG,-19.152778,-42.083056,10,2530
MG,FERROS,247,224,-23,-9.31,47,52,5,10.64,24,7,-17,-70.83,183,182,-1,-0.55,463,439,-24,-5.18,964,904,-60,-6.22,FERROS MG,-19.234984,-43.019542,10,2531
MG,FERVEDOURO,86,53,-33,-38.37,70,54,-16,-22.86,22,11,-11,-50.0,162,187,25,15.43,384,310,-74,-19.27,724,615,-109,-15.06,FERVEDOURO MG,-20.7292242,-42.2785942,10,2532
MG,FLORESTAL,355,335,-20,-5.63,86,98,12,13.95,44,49,5,11.36,214,218,4,1.87,669,565,-104,-15.55,1368,1265,-103,-7.53,FLORESTAL MG,-19.8878705,-44.4314766,10,2533
MG,FORMIGA,812,876,64,7.88,3321,3185,-136,-4.1,2173,2574,401,18.45,4455,4257,-198,-4.44,7422,7988,566,7.63,18183,18880,697,3.83,FORMIGA MG,-20.4648425,-45.4266753,10,2534
MG,FORMOSO,279,297,18,6.45,6,10,4,66.67,0,0,0,0.0,129,116,-13,-10.08,402,331,-71,-17.66,816,754,-62,-7.6,FORMOSO MG,-14.9513078,-46.234247,10,2535
MG,FORTUNA DE MINAS,113,117,4,3.54,62,64,2,3.23,1,8,7,700.0,43,50,7,16.28,223,195,-28,-12.56,442,434,-8,-1.81,FORTUNA DE MINAS MG,-19.561662,-44.4451854,10,2537
MG,FRANCISCO BADARO,3,2,-1,-33.33,2,1,-1,-50.0,1,0,-1,-100.0,95,86,-9,-9.47,371,203,-168,-45.28,472,292,-180,-38.14,FRANCISCO BADARO MG,-16.9917524,-42.350899,10,2538
MG,FRANCISCO DUMONT,175,193,18,10.29,21,29,8,38.1,1,2,1,100.0,54,62,8,14.81,365,323,-42,-11.51,616,609,-7,-1.14,FRANCISCO DUMONT MG,-17.3117541,-44.2322232,10,2539
MG,FRANCISCO SA,434,438,4,0.92,74,84,10,13.51,26,24,-2,-7.69,630,564,-66,-10.48,1461,1263,-198,-13.55,2625,2373,-252,-9.6,FRANCISCO SA MG,-16.4777211,-43.4942587,10,2540
MG,FRANCISCOPOLIS,40,39,-1,-2.5,118,131,13,11.02,17,24,7,41.18,70,75,5,7.14,343,291,-52,-15.16,588,560,-28,-4.76,FRANCISCOPOLIS MG,-17.9594883,-42.0081094,10,2541
MG,FREI GASPAR,147,148,1,0.68,10,8,-2,-20.0,0,0,0,0.0,53,46,-7,-13.21,325,284,-41,-12.62,535,486,-49,-9.16,FREI GASPAR MG,-18.0633426,-41.4300673,10,2542
MG,FREI INOCENCIO,178,157,-21,-11.8,6,7,1,16.67,0,1,1,0.0,255,253,-2,-0.78,317,502,185,58.36,756,920,164,21.69,FREI INOCENCIO MG,-18.563076,-41.9064881,10,2543
MG,FREI LAGONEGRO,5,5,0,0.0,0,0,0,0.0,0,0,0,0.0,12,11,-1,-8.33,268,190,-78,-29.1,285,206,-79,-27.72,FREI LAGONEGRO MG,-18.1671176,-42.7656893,10,2544
MG,FRONTEIRA,33,38,5,15.15,150,148,-2,-1.33,6,4,-2,-33.33,350,348,-2,-0.57,1564,1407,-157,-10.04,2103,1945,-158,-7.51,FRONTEIRA MG,-20.286111,-49.202778,10,2545
MG,FRONTEIRA DOS VALES,30,23,-7,-23.33,0,0,0,0.0,0,0,0,0.0,12,13,1,8.33,294,183,-111,-37.76,336,219,-117,-34.82,FRONTEIRA DOS VALES MG,-16.8915896,-40.9251061,10,2546
MG,FRUTA DE LEITE,3,2,-1,-33.33,4,4,0,0.0,3,3,0,0.0,23,24,1,4.35,296,268,-28,-9.46,329,301,-28,-8.51,FRUTA DE LEITE MG,-16.1169,-42.5278,10,2547
MG,FRUTAL,1505,1506,1,0.07,2777,2951,174,6.27,187,138,-49,-26.2,3267,3230,-37,-1.13,4714,4625,-89,-1.89,12450,12450,0,0.0,FRUTAL MG,-20.0220064,-48.9280076,10,2548
MG,FUNILANDIA,230,191,-39,-16.96,57,38,-19,-33.33,6,91,85,1416.67,68,73,5,7.35,374,329,-45,-12.03,735,722,-13,-1.77,FUNILANDIA MG,-19.3711961,-44.0599481,10,2549
MG,GALILEIA,153,146,-7,-4.58,127,121,-6,-4.72,35,34,-1,-2.86,72,71,-1,-1.39,418,416,-2,-0.48,805,788,-17,-2.11,GALILEIA MG,-19.0008674,-41.5383935,10,2550
MG,GAMELEIRAS,18,29,11,61.11,0,0,0,0.0,0,0,0,0.0,34,33,-1,-2.94,296,289,-7,-2.36,348,351,3,0.86,GAMELEIRAS MG,-15.0833558,-43.1171391,10,2551
MG,GLAUCILANDIA,27,25,-2,-7.41,28,29,1,3.57,3,1,-2,-66.67,11,17,6,54.55,253,158,-95,-37.55,322,230,-92,-28.57,GLAUCILANDIA MG,-16.8497,-43.6972,10,2552
MG,GOIABEIRA,10,12,2,20.0,16,14,-2,-12.5,0,0,0,0.0,81,69,-12,-14.81,209,172,-37,-17.7,316,267,-49,-15.51,GOIABEIRA MG,-18.9804026,-41.224571,10,2553
MG,GOIANA,579,438,-141,-24.35,13801,13955,154,1.12,169,156,-13,-7.69,2100,2177,77,3.67,6101,5007,-1094,-17.93,22750,21733,-1017,-4.47,GOIANA MG,-21.5375,-43.2014,10,2554
MG,GONCALVES,123,119,-4,-3.25,50,58,8,16.0,27,24,-3,-11.11,193,175,-18,-9.33,334,279,-55,-16.47,727,655,-72,-9.9,GONCALVES MG,-22.658883,-45.8558405,10,2555
MG,GONZAGA,14,12,-2,-14.29,1,1,0,0.0,1,1,0,0.0,76,70,-6,-7.89,144,155,11,7.64,236,239,3,1.27,GONZAGA MG,-18.8239154,-42.4787064,10,2556
MG,GOUVEIA,89,75,-14,-15.73,549,634,85,15.48,4,6,2,50.0,415,392,-23,-5.54,715,694,-21,-2.94,1772,1801,29,1.64,GOUVEIA MG,-18.4545728,-43.7415904,10,2557
MG,GOVERNADOR VALADARES,1009,968,-41,-4.06,5970,6059,89,1.49,2518,2271,-247,-9.81,16822,16664,-158,-0.94,29482,29282,-200,-0.68,55801,55244,-557,-1.0,GOVERNADOR VALADARES MG,-18.8539497,-41.9458753,10,2558
MG,GRAO MOGOL,310,382,72,23.23,207,302,95,45.89,1,1,0,0.0,216,220,4,1.85,882,880,-2,-0.23,1616,1785,169,10.46,GRAO MOGOL MG,-16.5634214,-42.8929185,10,2559
MG,GRUPIARA,20,25,5,25.0,7,3,-4,-57.14,0,0,0,0.0,6,3,-3,-50.0,367,260,-107,-29.16,400,291,-109,-27.25,GRUPIARA MG,-18.492777,-47.7225,10,2560
MG,GUANHAES,1059,994,-65,-6.14,606,654,48,7.92,71,87,16,22.54,2047,2195,148,7.23,2804,2761,-43,-1.53,6587,6691,104,1.58,GUANHAES MG,-18.7753627,-42.9340634,10,2561
MG,GUAPE,382,407,25,6.54,198,200,2,1.01,120,328,208,173.33,377,377,0,0.0,824,748,-76,-9.22,1901,2060,159,8.36,GUAPE MG,-20.7619447,-45.9174969,10,2562
MG,GUARACIABA,116,114,-2,-1.72,106,95,-11,-10.38,31,24,-7,-22.58,119,124,5,4.2,1203,1131,-72,-5.99,1575,1488,-87,-5.52,GUARACIABA MG,-20.5718037,-43.0057078,10,2563
MG,GUARACIAMA,51,43,-8,-15.69,1,1,0,0.0,2,3,1,50.0,28,26,-2,-7.14,276,293,17,6.16,358,366,8,2.23,GUARACIAMA MG,-17.0129899,-43.6696448,10,2564
MG,GUARANESIA,568,515,-53,-9.33,2596,2797,201,7.74,21,12,-9,-42.86,497,472,-25,-5.03,1214,1213,-1,-0.08,4896,5009,113,2.31,GUARANESIA MG,-21.3024827,-46.7956962,10,2565
MG,GUARANI,217,206,-11,-5.07,374,277,-97,-25.94,19,31,12,63.16,187,190,3,1.6,588,469,-119,-20.24,1385,1173,-212,-15.31,GUARANI MG,-21.35876,-43.0481021,10,2566
MG,GUARDA-MOR,622,646,24,3.86,76,70,-6,-7.89,11,6,-5,-45.45,163,176,13,7.98,561,459,-102,-18.18,1433,1357,-76,-5.3,GUARDA-MOR MG,-17.7698233,-47.0986827,10,2568
MG,GUAXUPE,979,951,-28,-2.86,2991,3359,368,12.3,274,243,-31,-11.31,4549,4380,-169,-3.72,4806,4693,-113,-2.35,13599,13626,27,0.2,GUAXUPE MG,-21.3087615,-46.7190609,10,2569
MG,GUIDOVAL,35,35,0,0.0,555,673,118,21.26,17,19,2,11.76,174,157,-17,-9.77,350,313,-37,-10.57,1131,1197,66,5.84,GUIDOVAL MG,-21.1514477,-42.7997151,10,2570
MG,GUIMARANIA,290,343,53,18.28,88,92,4,4.55,10,1,-9,-90.0,186,205,19,10.22,401,401,0,0.0,975,1042,67,6.87,GUIMARANIA MG,-18.8442251,-46.7925141,10,2571
MG,GUIRICEMA,37,23,-14,-37.84,360,379,19,5.28,9,7,-2,-22.22,218,232,14,6.42,363,286,-77,-21.21,987,927,-60,-6.08,GUIRICEMA MG,-21.0086064,-42.7190891,10,2572
MG,GURINHATA,326,300,-26,-7.98,15,15,0,0.0,0,0,0,0.0,95,79,-16,-16.84,300,255,-45,-15.0,736,649,-87,-11.82,GURINHATA MG,-19.2114486,-49.7840077,10,2573
MG,HELIODORA,250,267,17,6.8,300,242,-58,-19.33,2,1,-1,-50.0,109,110,1,0.92,273,246,-27,-9.89,934,866,-68,-7.28,HELIODORA MG,-22.0675,-45.542222,10,2574
MG,IAPU,115,102,-13,-11.3,111,110,-1,-0.9,26,13,-13,-50.0,274,288,14,5.11,454,399,-55,-12.11,980,912,-68,-6.94,IAPU MG,-19.436389,-42.217223,10,2575
MG,IBERTIOGA,150,133,-17,-11.33,12,15,3,25.0,0,0,0,0.0,89,120,31,34.83,357,260,-97,-27.17,608,528,-80,-13.16,IBERTIOGA MG,-21.431111,-43.966111,10,2576
MG,IBIA,1649,1724,75,4.55,403,437,34,8.44,34,20,-14,-41.18,930,826,-104,-11.18,1764,1580,-184,-10.43,4780,4587,-193,-4.04,IBIA MG,-19.4771843,-46.5386956,10,2577
MG,IBIAI,73,93,20,27.4,0,7,7,0.0,1,3,2,200.0,64,65,1,1.56,380,322,-58,-15.26,518,490,-28,-5.41,IBIAI MG,-16.861111,-44.913889,10,2578
MG,IBIRACATU,1,1,0,0.0,7,4,-3,-42.86,0,0,0,0.0,11,11,0,0.0,349,336,-13,-3.72,368,352,-16,-4.35,IBIRACATU MG,-15.6666425,-44.1651165,10,2579
MG,IBIRACI,716,814,98,13.69,247,189,-58,-23.48,4,1,-3,-75.0,416,435,19,4.57,632,550,-82,-12.97,2015,1989,-26,-1.29,IBIRACI MG,-20.461944,-47.122223,10,2580
MG,IBITIURA DE MINAS,28,20,-8,-28.57,37,40,3,8.11,0,0,0,0.0,47,40,-7,-14.89,260,241,-19,-7.31,372,341,-31,-8.33,IBITIURA DE MINAS MG,-22.060833,-46.439722,10,2582
MG,IBITURUNA,78,65,-13,-16.67,18,18,0,0.0,4,5,1,25.0,37,39,2,5.41,234,208,-26,-11.11,371,335,-36,-9.7,IBITURUNA MG,-21.1515725,-44.7474347,10,2583
MG,ICARAI DE MINAS,6,8,2,33.33,7,9,2,28.57,2,2,0,0.0,53,58,5,9.43,370,361,-9,-2.43,438,438,0,0.0,ICARAI DE MINAS MG,-16.2176592,-44.9023441,10,2584
MG,IGARATINGA,413,430,17,4.12,1480,1487,7,0.47,17,25,8,47.06,507,473,-34,-6.71,688,689,1,0.15,3105,3104,-1,-0.03,IGARATINGA MG,-19.955278,-44.7089254,10,2586
MG,IGUATAMA,159,163,4,2.52,381,380,-1,-0.26,8,7,-1,-12.5,191,193,2,1.05,582,475,-107,-18.38,1321,1218,-103,-7.8,IGUATAMA MG,-20.174445,-45.711111,10,2587
MG,ILICINEA,394,376,-18,-4.57,648,642,-6,-0.93,16,2,-14,-87.5,279,281,2,0.72,651,527,-124,-19.05,1988,1828,-160,-8.05,ILICINEA MG,-20.9390196,-45.8263558,10,2589
MG,IMBE DE MINAS,101,98,-3,-2.97,12,11,-1,-8.33,0,0,0,0.0,47,53,6,12.77,372,298,-74,-19.89,532,460,-72,-13.53,IMBE DE MINAS MG,-19.5989453,-41.9694294,10,2590
MG,INCONFIDENTES,65,59,-6,-9.23,400,362,-38,-9.5,2,1,-1,-50.0,193,157,-36,-18.65,342,353,11,3.22,1002,932,-70,-6.99,INCONFIDENTES MG,-22.3168866,-46.3279182,10,2591
MG,INDAIABIRA,41,36,-5,-12.2,43,42,-1,-2.33,4,2,-2,-50.0,28,23,-5,-17.86,321,296,-25,-7.79,437,399,-38,-8.7,INDAIABIRA MG,-15.4914,-42.1981,10,2592
MG,INDIANOPOLIS,561,560,-1,-0.18,290,564,274,94.48,306,2187,1881,614.71,106,104,-2,-1.89,511,576,65,12.72,1774,3991,2217,124.97,INDIANOPOLIS MG,-19.0391972,-47.9178436,10,2593
MG,INGAI,214,169,-45,-21.03,87,105,18,20.69,0,0,0,0.0,106,56,-50,-47.17,135,204,69,51.11,542,534,-8,-1.48,INGAI MG,-21.400833,-44.917223,10,2594
MG,INHAPIM,109,101,-8,-7.34,101,147,46,45.54,30,34,4,13.33,826,819,-7,-0.85,1514,1513,-1,-0.07,2580,2614,34,1.32,INHAPIM MG,-19.5501834,-42.1209879,10,2595
MG,IPANEMA,76,61,-15,-19.74,290,240,-50,-17.24,82,53,-29,-35.37,755,744,-11,-1.46,948,841,-107,-11.29,2151,1939,-212,-9.86,IPANEMA MG,-19.7999954,-41.7138807,10,2599
MG,IPATINGA,92,77,-15,-16.3,14767,12838,-1929,-13.06,8999,8210,-789,-8.77,14291,14081,-210,-1.47,31118,30046,-1072,-3.44,69267,65252,-4015,-5.8,IPATINGA MG,-19.4777807,-42.5270802,10,2600
MG,IPIACU,462,663,201,43.51,97,156,59,60.82,4,0,-4,-100.0,55,54,-1,-1.82,203,200,-3,-1.48,821,1073,252,30.69,IPIACU MG,-18.6934499,-49.9439567,10,2601
MG,IPUIUNA,240,213,-27,-11.25,148,118,-30,-20.27,18,16,-2,-11.11,325,288,-37,-11.38,571,573,2,0.35,1302,1208,-94,-7.22,IPUIUNA MG,-22.0993203,-46.1896557,10,2602
MG,IRAI DE MINAS,275,239,-36,-13.09,65,63,-2,-3.08,0,1,1,0.0,265,204,-61,-23.02,706,558,-148,-20.96,1311,1065,-246,-18.76,IRAI DE MINAS MG,-18.9865339,-47.4642202,10,2603
MG,ITABIRA,810,680,-130,-16.05,7013,7099,86,1.23,1952,4628,2676,137.09,5765,5633,-132,-2.29,12522,12908,386,3.08,28062,30948,2886,10.28,ITABIRA MG,-19.6186264,-43.2267011,10,2604
MG,ITABIRINHA,11,9,-2,-18.18,191,201,10,5.24,45,52,7,15.56,299,260,-39,-13.04,576,352,-224,-38.89,1122,874,-248,-22.1,ITABIRINHA MG,-18.5711894,-41.2339862,10,2605
MG,ITABIRITO,145,156,11,7.59,4328,5091,763,17.63,1501,4081,2580,171.89,2856,2748,-108,-3.78,6667,6681,14,0.21,15497,18757,3260,21.04,ITABIRITO MG,-20.2519724,-43.8029171,10,2606
MG,ITACAMBIRA,307,273,-34,-11.07,7,6,-1,-14.29,0,1,1,0.0,20,17,-3,-15.0,232,221,-11,-4.74,566,518,-48,-8.48,ITACAMBIRA MG,-17.0671616,-43.3130919,10,2607
MG,ITACARAMBI,397,436,39,9.82,127,130,3,2.36,0,1,1,0.0,296,282,-14,-4.73,968,943,-25,-2.58,1788,1792,4,0.22,ITACARAMBI MG,-15.1,-44.092222,10,2608
MG,ITAGUARA,89,104,15,16.85,1024,1072,48,4.69,19,12,-7,-36.84,723,687,-36,-4.98,1138,1024,-114,-10.02,2993,2899,-94,-3.14,ITAGUARA MG,-20.391389,-44.488055,10,2609
MG,ITAIPE,23,28,5,21.74,0,1,1,0.0,1,0,-1,-100.0,126,127,1,0.79,577,408,-169,-29.29,727,564,-163,-22.42,ITAIPE MG,-17.401944,-41.670278,10,2610
MG,ITAJUBA,213,201,-12,-5.63,6990,6944,-46,-0.66,488,631,143,29.3,5099,4722,-377,-7.39,10382,9918,-464,-4.47,23172,22416,-756,-3.26,ITAJUBA MG,-22.4238234,-45.4524156,10,2611
MG,ITAMARANDIBA,839,862,23,2.74,233,288,55,23.61,367,209,-158,-43.05,990,991,1,0.1,2277,2293,16,0.7,4706,4643,-63,-1.34,ITAMARANDIBA MG,-17.8575,-42.859722,10,2612
MG,ITAMARATI DE MINAS,36,35,-1,-2.78,158,180,22,13.92,2,2,0,0.0,57,44,-13,-22.81,321,62,-259,-80.69,574,323,-251,-43.73,ITAMARATI DE MINAS MG,-21.415833,-42.817778,10,2613
MG,ITAMBACURI,334,294,-40,-11.98,258,246,-12,-4.65,1,1,0,0.0,456,466,10,2.19,1073,914,-159,-14.82,2122,1921,-201,-9.47,ITAMBACURI MG,-18.0391974,-41.6751876,10,2614
MG,ITAMBE DO MATO DENTRO,20,14,-6,-30.0,10,10,0,0.0,0,0,0,0.0,29,29,0,0.0,200,185,-15,-7.5,259,238,-21,-8.11,ITAMBE DO MATO DENTRO MG,-19.4144399,-43.3223059,10,2615
MG,ITAMOGI,346,337,-9,-2.6,179,198,19,10.61,7,8,1,14.29,414,425,11,2.66,667,652,-15,-2.25,1613,1620,7,0.43,ITAMOGI MG,-21.0793213,-47.048612,10,2616
MG,ITAMONTE,145,114,-31,-21.38,1270,1283,13,1.02,39,35,-4,-10.26,511,506,-5,-0.98,988,912,-76,-7.69,2953,2850,-103,-3.49,ITAMONTE MG,-22.2830726,-44.8695785,10,2617
MG,ITANHANDU,1303,1220,-83,-6.37,1100,1076,-24,-2.18,38,35,-3,-7.89,619,567,-52,-8.4,1114,1167,53,4.76,4174,4065,-109,-2.61,ITANHANDU MG,-22.2957913,-44.9366732,10,2618
MG,ITANHOMI,51,45,-6,-11.76,31,40,9,29.03,6,32,26,433.33,328,284,-44,-13.41,692,584,-108,-15.61,1108,985,-123,-11.1,ITANHOMI MG,-19.171111,-41.864167,10,2619
MG,ITAOBIM,48,41,-7,-14.58,202,172,-30,-14.85,18,15,-3,-16.67,742,738,-4,-0.54,1401,1185,-216,-15.42,2411,2151,-260,-10.78,ITAOBIM MG,-16.5614934,-41.502275,10,2620
MG,ITAPAGIPE,471,461,-10,-2.12,1078,1030,-48,-4.45,3,0,-3,-100.0,370,324,-46,-12.43,855,851,-4,-0.47,2777,2666,-111,-4.0,ITAPAGIPE MG,-19.9033884,-49.3666934,10,2621
MG,ITAPECERICA,298,292,-6,-2.01,1707,1595,-112,-6.56,115,109,-6,-5.22,666,601,-65,-9.76,1147,1153,6,0.52,3933,3750,-183,-4.65,ITAPECERICA MG,-20.472778,-45.125556,10,2622
MG,ITAPEVA,279,217,-62,-22.22,249,200,-49,-19.68,11,6,-5,-45.45,789,822,33,4.18,980,891,-89,-9.08,2308,2136,-172,-7.45,ITAPEVA MG,-22.7071665,-46.23015850595238,10,2623
MG,ITAU DE MINAS,53,50,-3,-5.66,739,711,-28,-3.79,696,716,20,2.87,465,445,-20,-4.3,1283,1284,1,0.08,3236,3206,-30,-0.93,ITAU DE MINAS MG,-20.739722,-46.752222,10,2625
MG,ITAUNA,498,503,5,1.0,9103,9742,639,7.02,1294,1389,95,7.34,5058,4887,-171,-3.38,9655,9593,-62,-0.64,25608,26114,506,1.98,ITAUNA MG,-20.075556,-44.576389,10,2626
MG,ITAVERAVA,42,30,-12,-28.57,51,59,8,15.69,0,11,11,0.0,75,66,-9,-12.0,309,191,-118,-38.19,477,357,-120,-25.16,ITAVERAVA MG,-20.6763122,-43.6098991,10,2627
MG,ITINGA,52,48,-4,-7.69,260,193,-67,-25.77,1,4,3,300.0,99,88,-11,-11.11,418,351,-67,-16.03,830,684,-146,-17.59,ITINGA MG,-16.6066757,-41.7702077,10,2628
MG,ITUETA,16,17,1,6.25,45,58,13,28.89,7,7,0,0.0,70,79,9,12.86,306,300,-6,-1.96,444,461,17,3.83,ITUETA MG,-19.3962456,-41.2263075,10,2629
MG,ITUIUTABA,972,974,2,0.21,4975,4734,-241,-4.84,739,831,92,12.45,5703,5230,-473,-8.29,8593,7958,-635,-7.39,20982,19727,-1255,-5.98,ITUIUTABA MG,-18.9691887,-49.4639335,10,2630
MG,ITURAMA,797,682,-115,-14.43,3141,3307,166,5.28,337,292,-45,-13.35,2036,2094,58,2.85,4043,4048,5,0.12,10354,10423,69,0.67,ITURAMA MG,-19.7272733,-50.193488,10,2632
MG,ITUTINGA,173,174,1,0.58,30,33,3,10.0,10,9,-1,-10.0,84,78,-6,-7.14,364,302,-62,-17.03,661,596,-65,-9.83,ITUTINGA MG,-21.297383,-44.6575084,10,2633
MG,JABOTICATUBAS,149,165,16,10.74,243,211,-32,-13.17,42,51,9,21.43,693,676,-17,-2.45,1216,1216,0,0.0,2343,2319,-24,-1.02,JABOTICATUBAS MG,-19.521667,-43.745277,10,2634
MG,JACINTO,128,109,-19,-14.84,0,0,0,0.0,1,0,-1,-100.0,100,103,3,3.0,607,422,-185,-30.48,836,634,-202,-24.16,JACINTO MG,-16.1460987,-40.2948032,10,2635
MG,JACUI,214,261,47,21.96,164,171,7,4.27,6,4,-2,-33.33,153,151,-2,-1.31,380,351,-29,-7.63,917,938,21,2.29,JACUI MG,-21.0169567,-46.7458301,10,2636
MG,JACUTINGA,505,461,-44,-8.71,3038,3244,206,6.78,75,68,-7,-9.33,1058,1077,19,1.8,2112,1980,-132,-6.25,6788,6830,42,0.62,JACUTINGA MG,-22.285833,-46.612222,10,2637
MG,JAIBA,3570,3662,92,2.58,797,1011,214,26.85,71,75,4,5.63,825,727,-98,-11.88,1625,1574,-51,-3.14,6888,7049,161,2.34,JAIBA MG,-15.3373744,-43.6734439,10,2639
MG,JAMPRUCA,77,73,-4,-5.19,23,28,5,21.74,0,0,0,0.0,36,30,-6,-16.67,294,206,-88,-29.93,430,337,-93,-21.63,JAMPRUCA MG,-18.4613981,-41.8092299,10,2640
MG,JANAUBA,1009,1071,62,6.14,1560,1693,133,8.53,169,177,8,4.73,3455,3565,110,3.18,5242,5224,-18,-0.34,11435,11730,295,2.58,JANAUBA MG,-15.8019291,-43.309246,10,2641
MG,JANUARIA,221,216,-5,-2.26,317,290,-27,-8.52,60,42,-18,-30.0,2000,1940,-60,-3.0,2507,2418,-89,-3.55,5105,4906,-199,-3.9,JANUARIA MG,-15.4875,-44.361111,10,2642
MG,JAPONVAR,12,11,-1,-8.33,8,11,3,37.5,4,7,3,75.0,69,63,-6,-8.7,393,363,-30,-7.63,486,455,-31,-6.38,JAPONVAR MG,-15.9980389,-44.2755057,10,2644
MG,JENIPAPO DE MINAS,0,0,0,0.0,2,8,6,300.0,5,2,-3,-60.0,64,48,-16,-25.0,382,377,-5,-1.31,453,435,-18,-3.97,JENIPAPO DE MINAS MG,-17.08493,-42.259576,10,2646
MG,JEQUERI,585,625,40,6.84,66,78,12,18.18,17,12,-5,-29.41,134,128,-6,-4.48,707,659,-48,-6.79,1509,1502,-7,-0.46,JEQUERI MG,-20.453056,-42.666111,10,2647
MG,JEQUITAI,279,161,-118,-42.29,75,74,-1,-1.33,3,0,-3,-100.0,91,97,6,6.59,399,381,-18,-4.51,847,713,-134,-15.82,JEQUITAI MG,-17.2328217,-44.4383463,10,2648
MG,JEQUITIBA,371,266,-105,-28.3,37,45,8,21.62,40,36,-4,-10.0,132,166,34,25.76,323,314,-9,-2.79,903,827,-76,-8.42,JEQUITIBA MG,-19.2361583,-44.03063,10,2649
MG,JEQUITINHONHA,380,350,-30,-7.89,42,34,-8,-19.05,0,0,0,0.0,364,356,-8,-2.2,906,856,-50,-5.52,1692,1596,-96,-5.67,JEQUITINHONHA MG,-16.433333,-41.003056,10,2650
MG,JESUANIA,278,262,-16,-5.76,36,34,-2,-5.56,0,0,0,0.0,50,52,2,4.0,285,299,14,4.91,649,647,-2,-0.31,JESUANIA MG,-21.997777,-45.290833,10,2651
MG,JOAIMA,211,185,-26,-12.32,16,25,9,56.25,1,2,1,100.0,120,139,19,15.83,747,833,86,11.51,1095,1184,89,8.13,JOAIMA MG,-16.6563139,-41.0234956,10,2652
MG,JOANESIA,6,2,-4,-66.67,1,0,-1,-100.0,0,32,32,0.0,37,39,2,5.41,267,295,28,10.49,311,368,57,18.33,JOANESIA MG,-19.1756282,-42.6815534,10,2653
MG,JOAO MONLEVADE,30,20,-10,-33.33,2719,2697,-22,-0.81,3261,3471,210,6.44,4649,4621,-28,-0.6,8386,8011,-375,-4.47,19045,18820,-225,-1.18,JOAO MONLEVADE MG,-19.809444,-43.173334,10,2654
MG,JOAO PINHEIRO,3036,3306,270,8.89,3843,3908,65,1.69,494,599,105,21.26,2037,2186,149,7.31,4062,4007,-55,-1.35,13472,14006,534,3.96,JOAO PINHEIRO MG,-17.742777,-46.175278,10,2655
MG,JOAQUIM FELICIO,91,105,14,15.38,81,76,-5,-6.17,1,0,-1,-100.0,22,25,3,13.64,257,207,-50,-19.46,452,413,-39,-8.63,JOAQUIM FELICIO MG,-17.7602437,-44.1701635,10,2656
MG,JORDANIA,144,128,-16,-11.11,1,1,0,0.0,0,0,0,0.0,111,99,-12,-10.81,491,480,-11,-2.24,747,708,-39,-5.22,JORDANIA MG,-15.899444,-40.178889,10,2657
MG,JOSE GONCALVES DE MINAS,6,4,-2,-33.33,0,0,0,0.0,4,1,-3,-75.0,38,39,1,2.63,216,269,53,24.54,264,313,49,18.56,JOSE GONCALVES DE MINAS MG,-16.9066539,-42.6074998,10,2658
MG,JOSE RAYDAN,20,19,-1,-5.0,71,93,22,30.99,0,0,0,0.0,63,59,-4,-6.35,299,164,-135,-45.15,453,335,-118,-26.05,JOSE RAYDAN MG,-18.2220672,-42.4991123,10,2659
MG,JOSENOPOLIS,326,359,33,10.12,0,0,0,0.0,0,0,0,0.0,20,19,-1,-5.0,310,250,-60,-19.35,656,628,-28,-4.27,JOSENOPOLIS MG,-16.5460934,-42.5140963,10,2660
MG,NOVA UNIAO,20,12,-8,-40.0,0,1,1,0.0,5,3,-2,-40.0,106,104,-2,-1.89,302,339,37,12.25,433,459,26,6.0,NOVA UNIAO MG,-19.6901893,-43.580107,10,2661
MG,JUIZ DE FORA,1129,1044,-85,-7.53,19149,18444,-705,-3.68,6889,7082,193,2.8,32792,30689,-2103,-6.41,84212,83812,-400,-0.47,144171,141071,-3100,-2.15,JUIZ DE FORA MG,-21.7609533,-43.3501129,10,2663
MG,JURAMENTO,115,98,-17,-14.78,0,2,2,0.0,0,2,2,0.0,36,35,-1,-2.78,231,156,-75,-32.47,382,293,-89,-23.3,JURAMENTO MG,-16.8458291,-43.5867351,10,2664
MG,JURUAIA,104,94,-10,-9.62,1384,1385,1,0.07,11,8,-3,-27.27,355,400,45,12.68,553,517,-36,-6.51,2407,2404,-3,-0.12,JURUAIA MG,-21.252778,-46.577223,10,2665
MG,JUVENILIA,22,34,12,54.55,9,6,-3,-33.33,1,1,0,0.0,20,18,-2,-10.0,347,324,-23,-6.63,399,383,-16,-4.01,JUVENILIA MG,-14.2660795,-44.1618528,10,2666
MG,LADAINHA,40,53,13,32.5,8,9,1,12.5,0,0,0,0.0,87,87,0,0.0,663,519,-144,-21.72,798,668,-130,-16.29,LADAINHA MG,-17.6265078,-41.7385789,10,2667
MG,LAGAMAR,172,196,24,13.95,129,119,-10,-7.75,1,1,0,0.0,148,156,8,5.41,373,254,-119,-31.9,823,726,-97,-11.79,LAGAMAR MG,-18.1789844,-46.8077038,10,2668
MG,LAGOA DA PRATA,260,271,11,4.23,4160,4464,304,7.31,176,183,7,3.98,3246,3121,-125,-3.85,4200,4216,16,0.38,12042,12255,213,1.77,LAGOA DA PRATA MG,-20.022778,-45.5440462,10,2669
MG,LAGOA DOS PATOS,39,41,2,5.13,7,11,4,57.14,0,0,0,0.0,31,28,-3,-9.68,328,315,-13,-3.96,405,395,-10,-2.47,LAGOA DOS PATOS MG,-16.7544395,-43.88381791229015,10,2670
MG,LAGOA DOURADA,320,341,21,6.56,126,115,-11,-8.73,13,11,-2,-15.38,401,379,-22,-5.49,845,893,48,5.68,1705,1739,34,1.99,LAGOA DOURADA MG,-20.914444,-44.077778,10,2671
MG,LAGOA FORMOSA,589,583,-6,-1.02,524,495,-29,-5.53,55,36,-19,-34.55,622,602,-20,-3.22,1528,1429,-99,-6.48,3318,3145,-173,-5.21,LAGOA FORMOSA MG,-18.7741896,-46.4082511,10,2672
MG,LAGOA GRANDE,1316,1057,-259,-19.68,223,256,33,14.8,5,7,2,40.0,371,366,-5,-1.35,1055,723,-332,-31.47,2970,2409,-561,-18.89,LAGOA GRANDE MG,-18.6002698,-46.5200751,10,2673
MG,LAJINHA,113,97,-16,-14.16,162,151,-11,-6.79,20,21,1,5.0,587,581,-6,-1.02,1300,1438,138,10.62,2182,2288,106,4.86,LAJINHA MG,-20.1520595,-41.6240623,10,2675
MG,LAMBARI,89,93,4,4.49,600,591,-9,-1.5,27,24,-3,-11.11,783,778,-5,-0.64,1375,809,-566,-41.16,2874,2295,-579,-20.15,LAMBARI MG,-21.9754009,-45.3505415,10,2676
MG,LAMIM,8,12,4,50.0,19,20,1,5.26,1,12,11,1100.0,55,65,10,18.18,223,132,-91,-40.81,306,241,-65,-21.24,LAMIM MG,-20.7905386,-43.4733218,10,2677
MG,LARANJAL,43,53,10,23.26,157,184,27,17.2,1,1,0,0.0,99,89,-10,-10.1,532,493,-39,-7.33,832,820,-12,-1.44,LARANJAL MG,-21.365278,-42.477778,10,2678
MG,LASSANCE,1248,1335,87,6.97,9,4,-5,-55.56,0,1,1,0.0,88,116,28,31.82,337,411,74,21.96,1682,1867,185,11.0,LASSANCE MG,-17.886944,-44.576667,10,2679
MG,LAVRAS,954,861,-93,-9.75,4142,3969,-173,-4.18,1092,1044,-48,-4.4,6180,5976,-204,-3.3,13131,12446,-685,-5.22,25499,24296,-1203,-4.72,LAVRAS MG,-21.2425512,-44.9991978,10,2680
MG,LEME DO PRADO,11,10,-1,-9.09,3,4,1,33.33,23,12,-11,-47.83,61,54,-7,-11.48,334,267,-67,-20.06,432,347,-85,-19.68,LEME DO PRADO MG,-17.0827986,-42.6952729,10,2682
MG,LEOPOLDINA,663,577,-86,-12.97,1871,1495,-376,-20.1,190,162,-28,-14.74,3069,3049,-20,-0.65,4830,5028,198,4.1,10623,10311,-312,-2.94,LEOPOLDINA MG,-21.5314282,-42.6403534,10,2683
MG,LIBERDADE,151,146,-5,-3.31,55,51,-4,-7.27,1,1,0,0.0,120,129,9,7.5,273,229,-44,-16.12,600,556,-44,-7.33,LIBERDADE MG,-22.0253009,-44.3208231,10,2684
MG,LIMA DUARTE,345,334,-11,-3.19,377,351,-26,-6.9,63,60,-3,-4.76,630,594,-36,-5.71,1220,1146,-74,-6.07,2635,2485,-150,-5.69,LIMA DUARTE MG,-21.842777,-43.792777,10,2685
MG,LIMEIRA DO OESTE,228,168,-60,-26.32,1287,1360,73,5.67,2,3,1,50.0,250,235,-15,-6.0,593,472,-121,-20.4,2360,2238,-122,-5.17,LIMEIRA DO OESTE MG,-19.5521959,-50.5772673,10,2686
MG,LONTRA,6,3,-3,-50.0,0,2,2,0.0,0,0,0,0.0,60,71,11,18.33,525,384,-141,-26.86,591,460,-131,-22.17,LONTRA MG,-15.9034782,-44.3030383,10,2687
MG,LUISBURGO,13,15,2,15.38,26,28,2,7.69,2,1,-1,-50.0,56,49,-7,-12.5,309,241,-68,-22.01,406,334,-72,-17.73,LUISBURGO MG,-20.4394,-42.1025,10,2688
MG,LUISLANDIA,10,4,-6,-60.0,1,1,0,0.0,0,0,0,0.0,38,42,4,10.53,308,263,-45,-14.61,357,310,-47,-13.17,LUISLANDIA MG,-16.1150169,-44.5849349,10,2689
MG,LUMINARIAS,216,296,80,37.04,112,138,26,23.21,4,5,1,25.0,143,171,28,19.58,328,262,-66,-20.12,803,872,69,8.59,LUMINARIAS MG,-21.5112256,-44.903813,10,2690
MG,LUZ,517,512,-5,-0.97,615,545,-70,-11.38,38,36,-2,-5.26,941,976,35,3.72,1765,1669,-96,-5.44,3876,3738,-138,-3.56,LUZ MG,-19.7871171,-45.6846736,10,2691
MG,MACHACALIS,74,63,-11,-14.86,8,16,8,100.0,0,0,0,0.0,62,56,-6,-9.68,410,311,-99,-24.15,554,446,-108,-19.49,MACHACALIS MG,-17.0770336,-40.7187273,10,2692
MG,MACHADO,1295,1694,399,30.81,2381,2291,-90,-3.78,126,119,-7,-5.56,1981,2029,48,2.42,3068,2694,-374,-12.19,8851,8827,-24,-0.27,MACHADO MG,-21.6762861,-45.9211696,10,2693
MG,MADRE DE DEUS DE MINAS,247,262,15,6.07,192,185,-7,-3.65,18,32,14,77.78,122,122,0,0.0,293,238,-55,-18.77,872,839,-33,-3.78,MADRE DE DEUS DE MINAS MG,-21.482223,-44.329723,10,2694
MG,MALACACHETA,59,62,3,5.08,68,73,5,7.35,24,33,9,37.5,247,257,10,4.05,969,1058,89,9.18,1367,1483,116,8.49,MALACACHETA MG,-17.843055,-42.077778,10,2695
MG,MAMONAS,0,0,0,0.0,62,54,-8,-12.9,11,2,-9,-81.82,43,36,-7,-16.28,261,229,-32,-12.26,377,321,-56,-14.85,MAMONAS MG,-15.0477099,-42.9499586,10,2696
MG,MANGA,222,253,31,13.96,44,40,-4,-9.09,9,0,-9,-100.0,346,337,-9,-2.6,969,1011,42,4.33,1590,1641,51,3.21,MANGA MG,-14.7528035,-43.9417044,10,2697
MG,MANHUACU,428,396,-32,-7.48,2258,2577,319,14.13,5622,5736,114,2.03,5143,5003,-140,-2.72,9028,8566,-462,-5.12,22479,22278,-201,-0.89,MANHUACU MG,-20.2574434,-42.0340769,10,2698
MG,MANHUMIRIM,97,152,55,56.7,76,80,4,5.26,23,38,15,65.22,944,920,-24,-2.54,1631,1850,219,13.43,2771,3040,269,9.71,MANHUMIRIM MG,-20.3599141,-41.9554606,10,2699
MG,MANTENA,100,78,-22,-22.0,1191,1132,-59,-4.95,31,26,-5,-16.13,1079,1097,18,1.67,1441,1434,-7,-0.49,3842,3767,-75,-1.95,MANTENA MG,-18.7809937,-40.9808279,10,2700
MG,MARAVILHAS,174,149,-25,-14.37,547,621,74,13.53,15,14,-1,-6.67,243,255,12,4.94,447,430,-17,-3.8,1426,1469,43,3.02,MARAVILHAS MG,-19.515278,-44.676389,10,2701
MG,MAR DE ESPANHA,220,227,7,3.18,2086,1917,-169,-8.1,9,19,10,111.11,359,364,5,1.39,603,537,-66,-10.95,3277,3064,-213,-6.5,MAR DE ESPANHA MG,-21.866945,-43.01,10,2702
MG,MARIA DA FE,142,131,-11,-7.75,291,233,-58,-19.93,7,12,5,71.43,298,314,16,5.37,789,665,-124,-15.72,1527,1355,-172,-11.26,MARIA DA FE MG,-22.3081652,-45.3752771,10,2703
MG,MARIANA,283,220,-63,-22.26,2989,2839,-150,-5.02,1486,3142,1656,111.44,2708,2674,-34,-1.26,8709,8106,-603,-6.92,16175,16981,806,4.98,MARIANA MG,-20.3781468,-43.4174862,10,2704
MG,MARILAC,132,186,54,40.91,1,1,0,0.0,0,0,0,0.0,35,44,9,25.71,240,167,-73,-30.42,408,398,-10,-2.45,MARILAC MG,-18.5075,-42.080278,10,2705
MG,MARIPA DE MINAS,56,58,2,3.57,291,263,-28,-9.62,2,2,0,0.0,103,97,-6,-5.83,339,211,-128,-37.76,791,631,-160,-20.23,MARIPA DE MINAS MG,-21.6975,-42.959167,10,2707
MG,MARMELOPOLIS,23,24,1,4.35,59,49,-10,-16.95,0,0,0,0.0,36,43,7,19.44,175,173,-2,-1.14,293,289,-4,-1.37,MARMELOPOLIS MG,-22.448889,-45.165278,10,2709
MG,MARTINHO CAMPOS,1031,998,-33,-3.2,308,316,8,2.6,60,85,25,41.67,546,574,28,5.13,2019,1970,-49,-2.43,3964,3943,-21,-0.53,MARTINHO CAMPOS MG,-19.331945,-45.236666,10,2710
MG,MARTINS SOARES,39,19,-20,-51.28,101,106,5,4.95,0,0,0,0.0,123,142,19,15.45,232,219,-13,-5.6,495,486,-9,-1.82,MARTINS SOARES MG,-20.2583778,-41.8761462,10,2711
MG,MATA VERDE,13,9,-4,-30.77,22,22,0,0.0,0,0,0,0.0,62,49,-13,-20.97,375,235,-140,-37.33,472,315,-157,-33.26,MATA VERDE MG,-15.6882799,-40.7401058,10,2712
MG,MATERLANDIA,77,62,-15,-19.48,4,3,-1,-25.0,4,4,0,0.0,48,38,-10,-20.83,266,176,-90,-33.83,399,283,-116,-29.07,MATERLANDIA MG,-18.473889,-43.06,10,2713
MG,MATEUS LEME,406,357,-49,-12.07,2369,3010,641,27.06,220,177,-43,-19.55,941,938,-3,-0.32,1908,1882,-26,-1.36,5844,6364,520,8.9,MATEUS LEME MG,-19.986666,-44.428056,10,2714
MG,MATIAS CARDOSO,788,607,-181,-22.97,11,11,0,0.0,0,0,0,0.0,65,78,13,20.0,544,506,-38,-6.99,1408,1202,-206,-14.63,MATIAS CARDOSO MG,-14.8603106,-43.9212441,10,2716
MG,MATIPO,158,161,3,1.9,173,183,10,5.78,76,71,-5,-6.58,806,882,76,9.43,905,448,-457,-50.5,2118,1745,-373,-17.61,MATIPO MG,-20.2896695,-42.3426599,10,2717
MG,MATO VERDE,7,6,-1,-14.29,90,107,17,18.89,136,64,-72,-52.94,225,262,37,16.44,633,515,-118,-18.64,1091,954,-137,-12.56,MATO VERDE MG,-16.499274,-44.2279588,10,2718
MG,MATOZINHOS,238,213,-25,-10.5,4004,4011,7,0.17,2006,2958,952,47.46,1445,1226,-219,-15.16,2762,2782,20,0.72,10455,11190,735,7.03,MATOZINHOS MG,-19.5576547,-44.0816035,10,2719
MG,MATUTINA,92,89,-3,-3.26,79,81,2,2.53,0,0,0,0.0,52,57,5,9.62,300,195,-105,-35.0,523,422,-101,-19.31,MATUTINA MG,-19.221956,-45.9701654,10,2720
MG,MEDEIROS,318,371,53,16.67,9,15,6,66.67,6,7,1,16.67,118,117,-1,-0.85,246,271,25,10.16,697,781,84,12.05,MEDEIROS MG,-19.9954552,-46.2210801,10,2721
MG,MEDINA,76,66,-10,-13.16,314,284,-30,-9.55,1,1,0,0.0,356,358,2,0.56,907,758,-149,-16.43,1654,1467,-187,-11.31,MEDINA MG,-16.2270466,-41.4763373,10,2722
MG,MENDES PIMENTEL,22,22,0,0.0,27,28,1,3.7,1,26,25,2500.0,92,92,0,0.0,301,281,-20,-6.64,443,449,6,1.35,MENDES PIMENTEL MG,-18.6611641,-41.4020716,10,2723
MG,MERCES,101,80,-21,-20.79,149,165,16,10.74,17,13,-4,-23.53,246,194,-52,-21.14,471,428,-43,-9.13,984,880,-104,-10.57,MERCES MG,-21.1947265,-43.3407272,10,2724
MG,MESQUITA,22,9,-13,-59.09,0,0,0,0.0,0,0,0,0.0,38,38,0,0.0,386,343,-43,-11.14,446,390,-56,-12.56,MESQUITA MG,-19.221667,-42.607222,10,2725
MG,MINAS NOVAS,216,223,7,3.24,116,122,6,5.17,85,50,-35,-41.18,399,390,-9,-2.26,1185,937,-248,-20.93,2001,1722,-279,-13.94,MINAS NOVAS MG,-17.2175833,-42.5943681,10,2726
MG,MINDURI,164,158,-6,-3.66,219,218,-1,-0.46,5,0,-5,-100.0,70,94,24,34.29,259,231,-28,-10.81,717,701,-16,-2.23,MINDURI MG,-21.6817218,-44.6036995,10,2727
MG,MIRABELA,39,46,7,17.95,13,24,11,84.62,6,3,-3,-50.0,240,238,-2,-0.83,714,765,51,7.14,1012,1076,64,6.32,MIRABELA MG,-16.2547215,-44.1639075,10,2728
MG,MIRADOURO,122,118,-4,-3.28,34,16,-18,-52.94,23,28,5,21.74,310,309,-1,-0.32,615,488,-127,-20.65,1104,959,-145,-13.13,MIRADOURO MG,-20.890277,-42.3425,10,2729
MG,MIRAI,87,88,1,1.15,1189,1247,58,4.88,17,28,11,64.71,338,325,-13,-3.85,789,339,-450,-57.03,2420,2027,-393,-16.24,MIRAI MG,-21.1957417,-42.6125153,10,2730
MG,MIRAVANIA,4,5,1,25.0,0,0,0,0.0,0,0,0,0.0,27,30,3,11.11,326,252,-74,-22.7,357,287,-70,-19.61,MIRAVANIA MG,-14.7492867,-44.4108445,10,2731
MG,MOEDA,43,30,-13,-30.23,84,88,4,4.76,0,4,4,0.0,141,136,-5,-3.55,380,280,-100,-26.32,648,538,-110,-16.98,MOEDA MG,-20.333056,-44.0525,10,2732
MG,MOEMA,130,129,-1,-0.77,240,202,-38,-15.83,4,3,-1,-25.0,247,267,20,8.1,381,352,-29,-7.61,1002,953,-49,-4.89,MOEMA MG,-19.8435409,-45.4106241,10,2733
MG,MONJOLOS,76,62,-14,-18.42,47,64,17,36.17,2,0,-2,-100.0,32,35,3,9.38,186,179,-7,-3.76,343,340,-3,-0.87,MONJOLOS MG,-18.3242667,-44.1187729,10,2734
MG,MONSENHOR PAULO,246,226,-20,-8.13,522,471,-51,-9.77,26,7,-19,-73.08,166,170,4,2.41,531,524,-7,-1.32,1491,1398,-93,-6.24,MONSENHOR PAULO MG,-21.757778,-45.541111,10,2735
MG,MONTALVANIA,83,83,0,0.0,26,27,1,3.85,2,3,1,50.0,274,286,12,4.38,814,665,-149,-18.3,1199,1064,-135,-11.26,MONTALVANIA MG,-14.4230168,-44.3701782,10,2736
MG,MONTE ALEGRE DE MINAS,1073,1123,50,4.66,246,249,3,1.22,30,37,7,23.33,608,606,-2,-0.33,1436,1414,-22,-1.53,3393,3429,36,1.06,MONTE ALEGRE DE MINAS MG,-18.870278,-48.880556,10,2737
MG,MONTE AZUL,35,21,-14,-40.0,144,109,-35,-24.31,1,5,4,400.0,396,365,-31,-7.83,1049,1106,57,5.43,1625,1606,-19,-1.17,MONTE AZUL MG,-15.1531999,-42.8711742,10,2738
MG,MONTE BELO,557,546,-11,-1.97,1548,1685,137,8.85,62,54,-8,-12.9,529,558,29,5.48,1168,1340,172,14.73,3864,4183,319,8.26,MONTE BELO MG,-21.3225052,-46.3649768,10,2739
MG,MONTE CARMELO,1637,1597,-40,-2.44,1422,1433,11,0.77,122,150,28,22.95,2892,2898,6,0.21,3462,3461,-1,-0.03,9535,9539,4,0.04,MONTE CARMELO MG,-18.7260939,-47.4958859,10,2740
MG,MONTE FORMOSO,10,9,-1,-10.0,1,1,0,0.0,3,0,-3,-100.0,37,28,-9,-24.32,197,148,-49,-24.87,248,186,-62,-25.0,MONTE FORMOSO MG,-16.8669394,-41.2543539,10,2741
MG,MONTE SANTO DE MINAS,1048,1131,83,7.92,559,654,95,16.99,141,173,32,22.7,820,806,-14,-1.71,1310,918,-392,-29.92,3878,3682,-196,-5.05,MONTE SANTO DE MINAS MG,-21.189722,-46.98,10,2742
MG,MONTES CLAROS,2153,1886,-267,-12.4,12214,13127,913,7.48,3870,4154,284,7.34,22158,21545,-613,-2.77,47043,47364,321,0.68,87438,88076,638,0.73,MONTES CLAROS MG,-16.7273538,-43.8717676,10,2743
MG,MONTE SIAO,193,189,-4,-2.07,1870,1703,-167,-8.93,22,16,-6,-27.27,1109,1033,-76,-6.85,1521,1529,8,0.53,4715,4470,-245,-5.2,MONTE SIAO MG,-22.432778,-46.572778,10,2744
MG,MONTEZUMA,154,153,-1,-0.65,8,5,-3,-37.5,0,0,0,0.0,33,25,-8,-24.24,479,375,-104,-21.71,674,558,-116,-17.21,MONTEZUMA MG,-15.1715121,-42.4987703,10,2745
MG,MORADA NOVA DE MINAS,872,861,-11,-1.26,185,246,61,32.97,31,42,11,35.48,228,219,-9,-3.95,863,764,-99,-11.47,2179,2132,-47,-2.16,MORADA NOVA DE MINAS MG,-18.6024892,-45.3513867,10,2746
MG,MORRO DA GARCA,154,157,3,1.95,1,2,1,100.0,2,2,0,0.0,23,24,1,4.35,285,174,-111,-38.95,465,359,-106,-22.8,MORRO DA GARCA MG,-18.5435188,-44.6030199,10,2747
MG,MORRO DO PILAR,21,16,-5,-23.81,4,4,0,0.0,1,3,2,200.0,52,41,-11,-21.15,265,260,-5,-1.89,343,324,-19,-5.54,MORRO DO PILAR MG,-19.216389,-43.376667,10,2748
MG,MUNHOZ,399,341,-58,-14.54,198,195,-3,-1.52,0,5,5,0.0,136,126,-10,-7.35,305,225,-80,-26.23,1038,892,-146,-14.07,MUNHOZ MG,-22.613056,-46.360556,10,2749
MG,MURIAE,655,553,-102,-15.57,4359,4386,27,0.62,1228,1181,-47,-3.83,6597,6696,99,1.5,11338,10892,-446,-3.93,24177,23708,-469,-1.94,MURIAE MG,-21.130556,-42.366389,10,2750
MG,MUTUM,168,149,-19,-11.31,488,468,-20,-4.1,17,21,4,23.53,687,675,-12,-1.75,1886,1070,-816,-43.27,3246,2383,-863,-26.59,MUTUM MG,-19.817223,-41.438333,10,2751
MG,MUZAMBINHO,349,319,-30,-8.6,372,394,22,5.91,531,684,153,28.81,784,775,-9,-1.15,1493,1344,-149,-9.98,3529,3516,-13,-0.37,MUZAMBINHO MG,-21.3684325,-46.522317,10,2752
MG,NACIP RAYDAN,7,13,6,85.71,0,0,0,0.0,0,0,0,0.0,13,13,0,0.0,216,132,-84,-38.89,236,158,-78,-33.05,NACIP RAYDAN MG,-18.4575634,-42.2496073,10,2753
MG,NANUQUE,478,532,54,11.3,1223,1295,72,5.89,33,69,36,109.09,1449,1139,-310,-21.39,2404,2397,-7,-0.29,5587,5432,-155,-2.77,NANUQUE MG,-17.8391113,-40.3537221,10,2754
MG,NATALANDIA,177,235,58,32.77,2,1,-1,-50.0,0,0,0,0.0,37,33,-4,-10.81,282,293,11,3.9,498,562,64,12.85,NATALANDIA MG,-16.5042,-46.4933,10,2756
MG,NATERCIA,70,63,-7,-10.0,45,36,-9,-20.0,1,0,-1,-100.0,91,102,11,12.09,320,273,-47,-14.69,527,474,-53,-10.06,NATERCIA MG,-22.12,-45.511389,10,2757
MG,NAZARENO,223,272,49,21.97,511,483,-28,-5.48,43,179,136,316.28,167,149,-18,-10.78,561,553,-8,-1.43,1505,1636,131,8.7,NAZARENO MG,-21.2189807,-44.6151354,10,2758
MG,NEPOMUCENO,1221,1155,-66,-5.41,268,269,1,0.37,48,46,-2,-4.17,873,895,22,2.52,1354,1336,-18,-1.33,3764,3701,-63,-1.67,NEPOMUCENO MG,-21.232744,-45.2352276,10,2759
MG,NINHEIRA,230,198,-32,-13.91,22,24,2,9.09,3,3,0,0.0,67,58,-9,-13.43,506,507,1,0.2,828,790,-38,-4.59,NINHEIRA MG,-15.3188725,-41.7535577,10,2760
MG,NOVA BELEM,17,15,-2,-11.76,0,0,0,0.0,1,1,0,0.0,14,15,1,7.14,223,127,-96,-43.05,255,158,-97,-38.04,NOVA BELEM MG,-18.4914334,-41.1050052,10,2761
MG,NOVA ERA,1433,1355,-78,-5.44,401,398,-3,-0.75,69,97,28,40.58,633,593,-40,-6.32,1645,1541,-104,-6.32,4181,3984,-197,-4.71,NOVA ERA MG,-20.7426124,-42.8807584,10,2762
MG,NOVA MODICA,101,101,0,0.0,8,7,-1,-12.5,3,5,2,66.67,42,53,11,26.19,202,206,4,1.98,356,372,16,4.49,NOVA MODICA MG,-18.4389859,-41.4973651,10,2764
MG,NOVA PONTE,880,1184,304,34.55,510,578,68,13.33,44,32,-12,-27.27,393,384,-9,-2.29,1317,1175,-142,-10.78,3144,3353,209,6.65,NOVA PONTE MG,-19.1692213,-47.6717642,10,2765
MG,NOVA RESENDE,161,152,-9,-5.59,172,144,-28,-16.28,44,39,-5,-11.36,582,643,61,10.48,693,707,14,2.02,1652,1685,33,2.0,NOVA RESENDE MG,-21.1263862,-46.424537,10,2767
MG,NOVA SERRANA,215,244,29,13.49,16521,12750,-3771,-22.83,283,309,26,9.19,3810,3626,-184,-4.83,5617,5787,170,3.03,26446,22716,-3730,-14.1,NOVA SERRANA MG,-19.875834,-44.984166,10,2768
MG,NOVO CRUZEIRO,100,100,0,0.0,107,128,21,19.63,53,45,-8,-15.09,415,416,1,0.24,1137,937,-200,-17.59,1812,1626,-186,-10.26,NOVO CRUZEIRO MG,-19.4730937,-42.537897,10,2769
MG,NOVO ORIENTE DE MINAS,49,49,0,0.0,52,27,-25,-48.08,0,0,0,0.0,109,92,-17,-15.6,413,313,-100,-24.21,623,481,-142,-22.79,NOVO ORIENTE DE MINAS MG,-17.4153913,-41.2190225,10,2770
MG,NOVORIZONTE,2,3,1,50.0,31,40,9,29.03,9,9,0,0.0,30,36,6,20.0,210,177,-33,-15.71,282,265,-17,-6.03,NOVORIZONTE MG,-16.0178,-42.4072,10,2771
MG,OLARIA,26,26,0,0.0,0,0,0,0.0,17,19,2,11.76,25,24,-1,-4.0,225,263,38,16.89,293,332,39,13.31,OLARIA MG,-21.8607194,-43.9370942,10,2772
MG,OLIMPIO NORONHA,109,108,-1,-0.92,46,30,-16,-34.78,1,0,-1,-100.0,33,35,2,6.06,196,177,-19,-9.69,385,350,-35,-9.09,OLIMPIO NORONHA MG,-22.067778,-45.263889,10,2774
MG,OLIVEIRA,1401,1479,78,5.57,1993,2353,360,18.06,430,463,33,7.67,1944,1880,-64,-3.29,3422,3311,-111,-3.24,9190,9486,296,3.22,OLIVEIRA MG,-20.6971953,-44.8273969,10,2775
MG,OLIVEIRA FORTES,42,46,4,9.52,14,15,1,7.14,0,0,0,0.0,25,23,-2,-8.0,179,148,-31,-17.32,260,232,-28,-10.77,OLIVEIRA FORTES MG,-21.3391156,-43.4577139,10,2776
MG,ONCA DE PITANGUI,166,214,48,28.92,10,10,0,0.0,0,0,0,0.0,8,8,0,0.0,207,179,-28,-13.53,391,411,20,5.12,ONCA DE PITANGUI MG,-19.73,-44.807222,10,2777
MG,ORIZANIA,3,4,1,33.33,14,5,-9,-64.29,0,4,4,0.0,57,70,13,22.81,390,288,-102,-26.15,464,371,-93,-20.04,ORIZANIA MG,-20.5057698,-42.2087072,10,2779
MG,OURO FINO,454,421,-33,-7.27,1772,1711,-61,-3.44,50,63,13,26.0,1581,1709,128,8.1,2094,1904,-190,-9.07,5951,5808,-143,-2.4,OURO FINO MG,-22.283056,-46.369167,10,2781
MG,OURO PRETO,163,156,-7,-4.29,4410,4954,544,12.34,732,1176,444,60.66,2666,2490,-176,-6.6,9408,8594,-814,-8.65,17379,17370,-9,-0.05,OURO PRETO MG,-20.385527,-43.5035214,10,2782
MG,OURO VERDE DE MINAS,31,29,-2,-6.45,0,0,0,0.0,3,8,5,166.67,63,56,-7,-11.11,222,203,-19,-8.56,319,296,-23,-7.21,OURO VERDE DE MINAS MG,-18.0687218,-41.2710619,10,2783
MG,PADRE CARVALHO,2,82,80,4000.0,25,22,-3,-12.0,4,3,-1,-25.0,54,56,2,3.7,310,305,-5,-1.61,395,468,73,18.48,PADRE CARVALHO MG,-16.3647,-42.515,10,2784
MG,PADRE PARAISO,38,26,-12,-31.58,43,33,-10,-23.26,10,8,-2,-20.0,333,328,-5,-1.5,1127,1092,-35,-3.11,1551,1487,-64,-4.13,PADRE PARAISO MG,-17.0750322,-41.4850334,10,2785
MG,PAINEIRAS,72,73,1,1.39,24,28,4,16.67,1,0,-1,-100.0,81,79,-2,-2.47,307,294,-13,-4.23,485,474,-11,-2.27,PAINEIRAS MG,-18.904167,-45.534722,10,2786
MG,PAINS,115,113,-2,-1.74,1248,1300,52,4.17,6,5,-1,-16.67,295,300,5,1.69,810,795,-15,-1.85,2474,2513,39,1.58,PAINS MG,-20.3672648,-45.6633353,10,2787
MG,PAI PEDRO,24,23,-1,-4.17,8,6,-2,-25.0,7,3,-4,-57.14,18,15,-3,-16.67,422,408,-14,-3.32,479,455,-24,-5.01,PAI PEDRO MG,-15.5311251,-43.0667102,10,2788
MG,PAIVA,13,13,0,0.0,1,1,0,0.0,0,7,7,0.0,33,30,-3,-9.09,197,85,-112,-56.85,244,136,-108,-44.26,PAIVA MG,-21.289441,-43.4175347,10,2789
MG,PALMA,92,97,5,5.43,33,30,-3,-9.09,7,4,-3,-42.86,122,108,-14,-11.48,396,433,37,9.34,650,672,22,3.38,PALMA MG,-19.4364967,-43.9331557,10,2790
MG,PALMOPOLIS,24,26,2,8.33,0,1,1,0.0,1,1,0,0.0,35,35,0,0.0,333,303,-30,-9.01,393,366,-27,-6.87,PALMOPOLIS MG,-16.7383864,-40.4216514,10,2791
MG,PAPAGAIOS,355,357,2,0.56,1489,1532,43,2.89,16,20,4,25.0,651,631,-20,-3.07,772,782,10,1.3,3283,3322,39,1.19,PAPAGAIOS MG,-19.4487775,-44.7478694,10,2792
MG,PARACATU,4230,4576,346,8.18,4115,4266,151,3.67,1377,1374,-3,-0.22,4288,4310,22,0.51,8319,8465,146,1.76,22329,22991,662,2.96,PARACATU MG,-17.2174056,-46.8707514,10,2793
MG,PARA DE MINAS,2532,2447,-85,-3.36,8040,8638,598,7.44,1557,1311,-246,-15.8,6459,6325,-134,-2.07,9290,9236,-54,-0.58,27878,27957,79,0.28,PARA DE MINAS MG,-19.8599637,-44.6075313,10,2794
MG,PARAGUACU,480,556,76,15.83,1808,1457,-351,-19.41,80,84,4,5.0,964,1251,287,29.77,1346,1274,-72,-5.35,4678,4622,-56,-1.2,PARAGUACU MG,-21.547222,-45.7375,10,2795
MG,PARAISOPOLIS,200,186,-14,-7.0,1799,2097,298,16.56,44,50,6,13.64,675,692,17,2.52,1633,1597,-36,-2.2,4351,4622,271,6.23,PARAISOPOLIS MG,-22.5541683,-45.7800024,10,2796
MG,PARAOPEBA,727,753,26,3.58,1317,1335,18,1.37,157,111,-46,-29.3,1211,1147,-64,-5.28,4201,4227,26,0.62,7613,7573,-40,-0.53,PARAOPEBA MG,-19.2756823,-44.4034123,10,2797
MG,PASSABEM,20,15,-5,-25.0,1,0,-1,-100.0,0,0,0,0.0,12,9,-3,-25.0,174,176,2,1.15,207,200,-7,-3.38,PASSABEM MG,-19.3521707,-43.1374619,10,2798
MG,PASSA QUATRO,405,431,26,6.42,1071,1000,-71,-6.63,102,100,-2,-1.96,406,397,-9,-2.22,1277,1252,-25,-1.96,3261,3180,-81,-2.48,PASSA QUATRO MG,-22.3893803,-44.9666039,10,2799
MG,PASSA TEMPO,231,227,-4,-1.73,479,514,35,7.31,2,2,0,0.0,328,305,-23,-7.01,597,586,-11,-1.84,1637,1634,-3,-0.18,PASSA TEMPO MG,-20.650556,-44.495833,10,2800
MG,PASSOS,990,884,-106,-10.71,4264,3364,-900,-21.11,1310,1586,276,21.07,6825,6852,27,0.4,10018,9490,-528,-5.27,23407,22176,-1231,-5.26,PASSOS MG,-20.7167803,-46.6156864,10,2802
MG,PATIS,14,17,3,21.43,2,0,-2,-100.0,0,2,2,0.0,20,18,-2,-10.0,285,244,-41,-14.39,321,281,-40,-12.46,PATIS MG,-16.0806266,-44.0805727,10,2803
MG,PATOS DE MINAS,4199,4132,-67,-1.6,7517,7703,186,2.47,2134,2078,-56,-2.62,11300,11253,-47,-0.42,17282,17031,-251,-1.45,42432,42197,-235,-0.55,PATOS DE MINAS MG,-18.6041453,-46.5096698,10,2804
MG,PATROCINIO,3874,3695,-179,-4.62,3031,3071,40,1.32,880,932,52,5.91,5756,5692,-64,-1.11,8752,8537,-215,-2.46,22293,21927,-366,-1.64,PATROCINIO MG,-18.9408294,-46.9926624,10,2805
MG,PATROCINIO DO MURIAE,54,58,4,7.41,250,274,24,9.6,10,9,-1,-10.0,117,109,-8,-6.84,311,170,-141,-45.34,742,620,-122,-16.44,PATROCINIO DO MURIAE MG,-21.153333,-42.214444,10,2806
MG,PAULA CANDIDO,252,198,-54,-21.43,78,67,-11,-14.1,14,18,4,28.57,141,134,-7,-4.96,342,268,-74,-21.64,827,685,-142,-17.17,PAULA CANDIDO MG,-20.8737735,-42.9862733,10,2807
MG,PAULISTAS,32,33,1,3.12,52,56,4,7.69,0,0,0,0.0,82,93,11,13.41,260,263,3,1.15,426,445,19,4.46,PAULISTAS MG,-18.4268235,-42.8689535,10,2808
MG,PAVAO,145,152,7,4.83,25,31,6,24.0,5,5,0,0.0,54,56,2,3.7,373,299,-74,-19.84,602,543,-59,-9.8,PAVAO MG,-17.430699,-40.9991361,10,2809
MG,PECANHA,172,153,-19,-11.05,20,31,11,55.0,0,0,0,0.0,328,335,7,2.13,822,784,-38,-4.62,1342,1303,-39,-2.91,PECANHA MG,-18.5478786,-42.5608947,10,2810
MG,PEDRA AZUL,179,157,-22,-12.29,343,358,15,4.37,1,5,4,400.0,368,367,-1,-0.27,1273,1297,24,1.89,2164,2184,20,0.92,PEDRA AZUL MG,-16.005556,-41.28,10,2811
MG,PEDRA BONITA,8,7,-1,-12.5,3,17,14,466.67,1,1,0,0.0,15,13,-2,-13.33,237,213,-24,-10.13,264,251,-13,-4.92,PEDRA BONITA MG,-22.7565159,-45.8426019,10,2812
MG,PEDRA DO ANTA,28,28,0,0.0,9,18,9,100.0,11,15,4,36.36,29,31,2,6.9,272,204,-68,-25.0,349,296,-53,-15.19,PEDRA DO ANTA MG,-20.5962822,-42.7179792,10,2813
MG,PEDRA DO INDAIA,66,73,7,10.61,388,319,-69,-17.78,54,46,-8,-14.81,76,70,-6,-7.89,600,617,17,2.83,1184,1125,-59,-4.98,PEDRA DO INDAIA MG,-20.258333,-45.208611,10,2814
MG,PEDRA DOURADA,6,4,-2,-33.33,15,9,-6,-40.0,0,0,0,0.0,18,20,2,11.11,250,161,-89,-35.6,289,194,-95,-32.87,PEDRA DOURADA MG,-20.8317801,-42.1554636,10,2815
MG,PEDRALVA,336,340,4,1.19,249,297,48,19.28,11,9,-2,-18.18,197,202,5,2.54,515,487,-28,-5.44,1308,1335,27,2.06,PEDRALVA MG,-22.2428119,-45.4659922,10,2816
MG,PEDRAS DE MARIA DA CRUZ,115,126,11,9.57,1,3,2,200.0,0,0,0,0.0,94,69,-25,-26.6,368,334,-34,-9.24,578,532,-46,-7.96,PEDRAS DE MARIA DA CRUZ MG,-15.605833,-44.391944,10,2817
MG,PEDRINOPOLIS,211,174,-37,-17.54,1,3,2,200.0,3,4,1,33.33,94,102,8,8.51,395,335,-60,-15.19,704,618,-86,-12.22,PEDRINOPOLIS MG,-19.2275,-47.461944,10,2818
MG,PEDRO TEIXEIRA,18,20,2,11.11,0,0,0,0.0,0,0,0,0.0,16,16,0,0.0,198,127,-71,-35.86,232,163,-69,-29.74,PEDRO TEIXEIRA MG,-21.7056637,-43.7492357,10,2820
MG,PEQUERI,92,99,7,7.61,220,254,34,15.45,1,1,0,0.0,62,53,-9,-14.52,346,282,-64,-18.5,721,689,-32,-4.44,PEQUERI MG,-21.8369971,-43.1207799,10,2821
MG,PEQUI,189,188,-1,-0.53,39,159,120,307.69,11,29,18,163.64,42,54,12,28.57,250,200,-50,-20.0,531,630,99,18.64,PEQUI MG,-19.6315163,-44.6597262,10,2822
MG,PERDIGAO,125,101,-24,-19.2,1591,1282,-309,-19.42,14,12,-2,-14.29,286,248,-38,-13.29,611,618,7,1.15,2627,2261,-366,-13.93,PERDIGAO MG,-19.953056,-45.084166,10,2823
MG,PERDIZES,2058,2230,172,8.36,627,795,168,26.79,25,54,29,116.0,445,463,18,4.04,1393,940,-453,-32.52,4548,4482,-66,-1.45,PERDIZES MG,-19.3503361,-47.2938235,10,2824
MG,PERDOES,301,263,-38,-12.62,888,814,-74,-8.33,136,206,70,51.47,1307,1308,1,0.08,1891,1610,-281,-14.86,4523,4201,-322,-7.12,PERDOES MG,-21.0919737,-45.0903543,10,2825
MG,PERIQUITO,63,75,12,19.05,38,32,-6,-15.79,5,4,-1,-20.0,78,80,2,2.56,502,248,-254,-50.6,686,439,-247,-36.01,PERIQUITO MG,-19.1559319,-42.2412259,10,2826
MG,PESCADOR,49,49,0,0.0,4,0,-4,-100.0,0,1,1,0.0,39,60,21,53.85,294,197,-97,-32.99,386,307,-79,-20.47,PESCADOR MG,-18.3563609,-41.5981451,10,2827
MG,PIAU,105,93,-12,-11.43,34,41,7,20.59,0,0,0,0.0,34,28,-6,-17.65,205,195,-10,-4.88,378,357,-21,-5.56,PIAU MG,-21.5074738,-43.320587,10,2828
MG,PIEDADE DE CARATINGA,105,92,-13,-12.38,19,21,2,10.53,31,25,-6,-19.35,187,174,-13,-6.95,290,228,-62,-21.38,632,540,-92,-14.56,PIEDADE DE CARATINGA MG,-19.7601211,-42.0767321,10,2829
MG,PIEDADE DE PONTE NOVA,234,233,-1,-0.43,12,18,6,50.0,0,0,0,0.0,70,71,1,1.43,244,271,27,11.07,560,593,33,5.89,PIEDADE DE PONTE NOVA MG,-20.2452955,-42.7343995,10,2830
MG,PIEDADE DO RIO GRANDE,175,161,-14,-8.0,220,218,-2,-0.91,2,1,-1,-50.0,75,70,-5,-6.67,257,243,-14,-5.45,729,693,-36,-4.94,PIEDADE DO RIO GRANDE MG,-21.4679371,-44.1939394,10,2831
MG,PIEDADE DOS GERAIS,41,37,-4,-9.76,15,13,-2,-13.33,5,5,0,0.0,68,75,7,10.29,264,193,-71,-26.89,393,323,-70,-17.81,PIEDADE DOS GERAIS MG,-20.471111,-44.226945,10,2832
MG,PIMENTA,472,497,25,5.3,84,63,-21,-25.0,11,11,0,0.0,630,677,47,7.46,523,443,-80,-15.3,1720,1691,-29,-1.69,PIMENTA MG,-20.4827995,-45.7985894,10,2833
MG,PINTOPOLIS,22,29,7,31.82,6,12,6,100.0,0,0,0,0.0,57,60,3,5.26,384,357,-27,-7.03,469,458,-11,-2.35,PINTOPOLIS MG,-16.0572809,-45.1466972,10,2835
MG,PIRACEMA,164,147,-17,-10.37,86,119,33,38.37,29,14,-15,-51.72,146,151,5,3.42,334,308,-26,-7.78,759,739,-20,-2.64,PIRACEMA MG,-20.5091579,-44.4754464,10,2836
MG,PIRAJUBA,545,541,-4,-0.73,1583,1664,81,5.12,4,1,-3,-75.0,64,84,20,31.25,467,508,41,8.78,2663,2798,135,5.07,PIRAJUBA MG,-19.9090891,-48.701683,10,2837
MG,PIRANGA,237,251,14,5.91,107,91,-16,-14.95,12,7,-5,-41.67,258,292,34,13.18,688,632,-56,-8.14,1302,1273,-29,-2.23,PIRANGA MG,-20.685,-43.3,10,2838
MG,PIRAUBA,141,114,-27,-19.15,910,762,-148,-16.26,70,71,1,1.43,281,292,11,3.91,647,580,-67,-10.36,2049,1819,-230,-11.22,PIRAUBA MG,-21.276945,-43.025834,10,2843
MG,PITANGUI,702,680,-22,-3.13,740,774,34,4.59,139,106,-33,-23.74,982,956,-26,-2.65,1858,1921,63,3.39,4421,4437,16,0.36,PITANGUI MG,-19.682223,-44.890555,10,2844
MG,PIUMHI,1199,1054,-145,-12.09,1126,1022,-104,-9.24,206,182,-24,-11.65,2556,2623,67,2.62,3425,3235,-190,-5.55,8512,8116,-396,-4.65,PIUMHI MG,-20.4675258,-45.9576125,10,2845
MG,POCO FUNDO,148,147,-1,-0.68,359,346,-13,-3.62,2,15,13,650.0,479,540,61,12.73,853,716,-137,-16.06,1841,1764,-77,-4.18,POCO FUNDO MG,-21.780834,-45.965,10,2847
MG,POCOS DE CALDAS,881,828,-53,-6.02,9484,9392,-92,-0.97,2541,2152,-389,-15.31,11193,10538,-655,-5.85,25065,23869,-1196,-4.77,49164,46779,-2385,-4.85,POCOS DE CALDAS MG,-21.7900318,-46.5647928,10,2848
MG,POCRANE,44,66,22,50.0,17,11,-6,-35.29,1,1,0,0.0,148,147,-1,-0.68,191,166,-25,-13.09,401,391,-10,-2.49,POCRANE MG,-19.6192747,-41.6365314,10,2849
MG,POMPEU,973,970,-3,-0.31,1378,1418,40,2.9,46,39,-7,-15.22,1093,1159,66,6.04,2079,2064,-15,-0.72,5569,5650,81,1.45,POMPEU MG,-19.218611,-45.002778,10,2850
MG,PONTE NOVA,676,722,46,6.8,3232,3168,-64,-1.98,835,963,128,15.33,4817,4660,-157,-3.26,7041,6886,-155,-2.2,16601,16399,-202,-1.22,PONTE NOVA MG,-20.4164353,-42.90878,10,2851
MG,PONTO CHIQUE,29,34,5,17.24,0,1,1,0.0,12,24,12,100.0,45,44,-1,-2.22,341,310,-31,-9.09,427,413,-14,-3.28,PONTO CHIQUE MG,-16.6328913,-45.0637456,10,2852
MG,PONTO DOS VOLANTES,42,45,3,7.14,7,6,-1,-14.29,3,2,-1,-33.33,109,107,-2,-1.83,624,554,-70,-11.22,785,714,-71,-9.04,PONTO DOS VOLANTES MG,-16.7532049,-41.5044548,10,2853
MG,PORTEIRINHA,119,119,0,0.0,150,142,-8,-5.33,74,71,-3,-4.05,731,728,-3,-0.41,1441,1460,19,1.32,2515,2520,5,0.2,PORTEIRINHA MG,-15.7420889,-43.0286046,10,2854
MG,PORTO FIRME,56,60,4,7.14,26,23,-3,-11.54,23,37,14,60.87,183,176,-7,-3.83,307,217,-90,-29.32,595,513,-82,-13.78,PORTO FIRME MG,-20.672778,-43.084444,10,2855
MG,POTE,100,91,-9,-9.0,52,36,-16,-30.77,16,64,48,300.0,161,160,-1,-0.62,700,714,14,2.0,1029,1065,36,3.5,POTE MG,-17.8074949,-41.7892455,10,2856
MG,POUSO ALEGRE,612,607,-5,-0.82,12730,12713,-17,-0.13,1819,1697,-122,-6.71,11069,10923,-146,-1.32,24186,24472,286,1.18,50416,50412,-4,-0.01,POUSO ALEGRE MG,-22.2343858,-45.9327241,10,2857
MG,POUSO ALTO,330,298,-32,-9.7,700,720,20,2.86,5,5,0,0.0,140,131,-9,-6.43,457,410,-47,-10.28,1632,1564,-68,-4.17,POUSO ALTO MG,-22.193889,-44.972778,10,2858
MG,PRADOS,61,63,2,3.28,993,1072,79,7.96,2,0,-2,-100.0,216,206,-10,-4.63,445,442,-3,-0.67,1717,1783,66,3.84,PRADOS MG,-21.0572943,-44.0788784,10,2859
MG,PRATA,3,2,-1,-33.33,6,6,0,0.0,0,9,9,0.0,21,22,1,4.76,352,216,-136,-38.64,382,255,-127,-33.25,PRATA MG,-19.307222,-48.923889,10,2860
MG,PRATAPOLIS,95,96,1,1.05,206,182,-24,-11.65,8,8,0,0.0,213,174,-39,-18.31,588,604,16,2.72,1110,1064,-46,-4.14,PRATAPOLIS MG,-20.744722,-46.861111,10,2861
MG,PRATINHA,178,183,5,2.81,21,14,-7,-33.33,22,18,-4,-18.18,76,81,5,6.58,196,182,-14,-7.14,493,478,-15,-3.04,PRATINHA MG,-19.7530422,-46.3824103,10,2862
MG,PRESIDENTE BERNARDES,61,67,6,9.84,27,20,-7,-25.93,0,1,1,0.0,67,69,2,2.99,418,241,-177,-42.34,573,398,-175,-30.54,PRESIDENTE BERNARDES MG,-20.7685467,-43.1877237,10,2863
MG,PRESIDENTE JUSCELINO,0,0,0,0.0,0,3,3,0.0,0,0,0,0.0,24,30,6,25.0,452,420,-32,-7.08,476,453,-23,-4.83,PRESIDENTE JUSCELINO MG,-18.6388028,-44.0604419,10,2864
MG,PRESIDENTE KUBITSCHEK,17,14,-3,-17.65,18,12,-6,-33.33,0,0,0,0.0,23,24,1,4.35,287,259,-28,-9.76,345,309,-36,-10.43,PRESIDENTE KUBITSCHEK MG,-18.614167,-43.561667,10,2865
MG,PRESIDENTE OLEGARIO,1235,1465,230,18.62,202,191,-11,-5.45,6,6,0,0.0,505,492,-13,-2.57,1273,987,-286,-22.47,3221,3141,-80,-2.48,PRESIDENTE OLEGARIO MG,-18.415,-46.419723,10,2866
MG,ALTO JEQUITIBA,23,19,-4,-17.39,65,49,-16,-24.62,4,8,4,100.0,202,221,19,9.41,359,261,-98,-27.3,653,558,-95,-14.55,ALTO JEQUITIBA MG,-20.423611,-41.966111,10,2867
MG,QUARTEL GERAL,95,98,3,3.16,31,13,-18,-58.06,5,4,-1,-20.0,61,47,-14,-22.95,264,175,-89,-33.71,456,337,-119,-26.1,QUARTEL GERAL MG,-19.2730674,-45.5570007,10,2869
MG,RAUL SOARES,325,310,-15,-4.62,214,222,8,3.74,72,55,-17,-23.61,672,627,-45,-6.7,1342,1224,-118,-8.79,2625,2438,-187,-7.12,RAUL SOARES MG,-20.102222,-42.451944,10,2872
MG,RECREIO,92,82,-10,-10.87,123,101,-22,-17.89,8,12,4,50.0,218,217,-1,-0.46,576,571,-5,-0.87,1017,983,-34,-3.34,RECREIO MG,-21.5248205,-42.4689256,10,2873
MG,REDUTO,70,89,19,27.14,63,78,15,23.81,29,185,156,537.93,52,74,22,42.31,258,231,-27,-10.47,472,657,185,39.19,REDUTO MG,-20.2442531,-41.9839974,10,2874
MG,RESENDE COSTA,130,109,-21,-16.15,223,210,-13,-5.83,21,19,-2,-9.52,386,378,-8,-2.07,580,571,-9,-1.55,1340,1287,-53,-3.96,RESENDE COSTA MG,-20.921945,-44.237777,10,2875
MG,RESPLENDOR,133,81,-52,-39.1,78,77,-1,-1.28,26,29,3,11.54,470,483,13,2.77,1185,1075,-110,-9.28,1892,1745,-147,-7.77,RESPLENDOR MG,-19.3254413,-41.2554622,10,2876
MG,RESSAQUINHA,137,137,0,0.0,132,153,21,15.91,0,0,0,0.0,60,57,-3,-5.0,337,312,-25,-7.42,666,659,-7,-1.05,RESSAQUINHA MG,-21.063056,-43.762778,10,2877
MG,RIACHINHO,30,33,3,10.0,0,0,0,0.0,0,14,14,0.0,11,11,0,0.0,263,205,-58,-22.05,304,263,-41,-13.49,RIACHINHO MG,-16.2212448,-45.9997305,10,2878
MG,RIACHO DOS MACHADOS,132,155,23,17.42,358,370,12,3.35,255,357,102,40.0,22,22,0,0.0,561,437,-124,-22.1,1328,1341,13,0.98,RIACHO DOS MACHADOS MG,-16.006667,-43.049166,10,2879
MG,RIO CASCA,427,419,-8,-1.87,108,137,29,26.85,50,24,-26,-52.0,498,505,7,1.41,902,1049,147,16.3,1985,2134,149,7.51,RIO CASCA MG,-20.2049635,-42.6556993,10,2883
MG,RIO DOCE,29,29,0,0.0,25,27,2,8.0,167,98,-69,-41.32,27,36,9,33.33,311,317,6,1.93,559,507,-52,-9.3,RIO DOCE MG,-20.2447972,-42.8970432,10,2884
MG,RIO DO PRADO,46,50,4,8.7,0,0,0,0.0,0,0,0,0.0,67,51,-16,-23.88,202,193,-9,-4.46,315,294,-21,-6.67,RIO DO PRADO MG,-16.608385,-40.5715827,10,2885
MG,RIO ESPERA,11,9,-2,-18.18,6,9,3,50.0,0,0,0,0.0,35,32,-3,-8.57,268,258,-10,-3.73,320,308,-12,-3.75,RIO ESPERA MG,-20.9060615,-43.3764832,10,2886
MG,RIO MANSO,48,33,-15,-31.25,122,104,-18,-14.75,27,27,0,0.0,127,116,-11,-8.66,261,236,-25,-9.58,585,516,-69,-11.79,RIO MANSO MG,-20.1912278,-44.2756505,10,2887
MG,RIO NOVO,154,116,-38,-24.68,102,168,66,64.71,46,30,-16,-34.78,180,167,-13,-7.22,476,524,48,10.08,958,1005,47,4.91,RIO NOVO MG,-21.4753189,-43.1250813,10,2888
MG,RIO PARANAIBA,3831,4228,397,10.36,178,216,38,21.35,54,17,-37,-68.52,428,459,31,7.24,1012,928,-84,-8.3,5503,5848,345,6.27,RIO PARANAIBA MG,-19.196447,-46.2410263,10,2889
MG,RIO PARDO DE MINAS,204,209,5,2.45,80,58,-22,-27.5,4,6,2,50.0,354,403,49,13.84,1213,1163,-50,-4.12,1855,1839,-16,-0.86,RIO PARDO DE MINAS MG,-15.6155637,-42.5461866,10,2890
MG,RIO PIRACICABA,174,186,12,6.9,1148,1269,121,10.54,12,12,0,0.0,298,314,16,5.37,844,714,-130,-15.4,2476,2495,19,0.77,RIO PIRACICABA MG,-19.982333,-43.2322858,10,2891
MG,RIO POMBA,170,147,-23,-13.53,929,849,-80,-8.61,111,93,-18,-16.22,803,756,-47,-5.85,1381,1417,36,2.61,3394,3262,-132,-3.89,RIO POMBA MG,-21.275,-43.178889,10,2892
MG,RIO VERMELHO,41,34,-7,-17.07,14,13,-1,-7.14,1,1,0,0.0,208,196,-12,-5.77,571,476,-95,-16.64,835,720,-115,-13.77,RIO VERMELHO MG,-18.3559733,-43.1445436,10,2894
MG,RITAPOLIS,174,179,5,2.87,80,68,-12,-15.0,64,50,-14,-21.88,62,59,-3,-4.84,247,240,-7,-2.83,627,596,-31,-4.94,RITAPOLIS MG,-21.0250052,-44.3186566,10,2895
MG,ROCHEDO DE MINAS,53,53,0,0.0,251,223,-28,-11.16,0,0,0,0.0,36,37,1,2.78,199,131,-68,-34.17,539,444,-95,-17.63,ROCHEDO DE MINAS MG,-21.6295358,-43.0195125,10,2896
MG,ROMARIA,525,464,-61,-11.62,122,22,-100,-81.97,1,2,1,100.0,49,148,99,202.04,236,228,-8,-3.39,933,864,-69,-7.4,ROMARIA MG,-18.8823522,-47.5854354,10,2898
MG,ROSARIO DA LIMEIRA,18,13,-5,-27.78,162,157,-5,-3.09,5,4,-1,-20.0,74,70,-4,-5.41,345,342,-3,-0.87,604,586,-18,-2.98,ROSARIO DA LIMEIRA MG,-20.9786,-42.5119,10,2899
MG,RUBELITA,65,82,17,26.15,43,37,-6,-13.95,0,0,0,0.0,31,28,-3,-9.68,446,311,-135,-30.27,585,458,-127,-21.71,RUBELITA MG,-16.4067495,-42.2623615,10,2900
MG,RUBIM,151,148,-3,-1.99,10,11,1,10.0,0,0,0,0.0,114,118,4,3.51,495,368,-127,-25.66,770,645,-125,-16.23,RUBIM MG,-16.3754471,-40.5382424,10,2901
MG,SABINOPOLIS,204,155,-49,-24.02,131,215,84,64.12,1,6,5,500.0,286,228,-58,-20.28,712,626,-86,-12.08,1334,1230,-104,-7.8,SABINOPOLIS MG,-18.6656839,-43.0830439,10,2903
MG,SACRAMENTO,1306,1400,94,7.2,1732,1766,34,1.96,59,105,46,77.97,1006,1024,18,1.79,2634,2560,-74,-2.81,6737,6855,118,1.75,SACRAMENTO MG,-19.8652854,-47.4402746,10,2904
MG,SALINAS,133,144,11,8.27,625,619,-6,-0.96,209,266,57,27.27,1627,1648,21,1.29,2731,2669,-62,-2.27,5325,5346,21,0.39,SALINAS MG,-16.1699073,-42.2910368,10,2905
MG,SALTO DA DIVISA,145,188,43,29.66,164,152,-12,-7.32,0,0,0,0.0,51,57,6,11.76,223,255,32,14.35,583,652,69,11.84,SALTO DA DIVISA MG,-15.9984236,-39.9487981,10,2906
MG,SANTA BARBARA,12,8,-4,-33.33,8,8,0,0.0,3,3,0,0.0,200,175,-25,-12.5,981,689,-292,-29.77,1204,883,-321,-26.66,SANTA BARBARA MG,-19.959444,-43.415278,10,2907
MG,SANTA BARBARA DO LESTE,31,33,2,6.45,20,20,0,0.0,8,7,-1,-12.5,159,172,13,8.18,373,267,-106,-28.42,591,499,-92,-15.57,SANTA BARBARA DO LESTE MG,-19.978334,-42.140555,10,2908
MG,SANTA BARBARA DO MONTE VERDE,90,90,0,0.0,11,7,-4,-36.36,7,2,-5,-71.43,47,58,11,23.4,221,219,-2,-0.9,376,376,0,0.0,SANTA BARBARA DO MONTE VERDE MG,-21.9578146,-43.7024953,10,2909
MG,SANTA BARBARA DO TUGURIO,35,31,-4,-11.43,27,27,0,0.0,8,6,-2,-25.0,98,98,0,0.0,265,226,-39,-14.72,433,388,-45,-10.39,SANTA BARBARA DO TUGURIO MG,-21.245833,-43.559444,10,2910
MG,SANTA CRUZ DE SALINAS,4,2,-2,-50.0,0,0,0,0.0,0,0,0,0.0,28,37,9,32.14,271,240,-31,-11.44,303,279,-24,-7.92,SANTA CRUZ DE SALINAS MG,-16.0972405,-41.7474332,10,2912
MG,SANTA CRUZ DO ESCALVADO,174,170,-4,-2.3,0,1,1,0.0,86,33,-53,-61.63,25,26,1,4.0,323,314,-9,-2.79,608,544,-64,-10.53,SANTA CRUZ DO ESCALVADO MG,-20.2355745,-42.8142315,10,2913
MG,SANTA EFIGENIA DE MINAS,10,6,-4,-40.0,0,0,0,0.0,1,2,1,100.0,51,61,10,19.61,338,238,-100,-29.59,400,307,-93,-23.25,SANTA EFIGENIA DE MINAS MG,-18.8275746,-42.4400734,10,2914
MG,SANTA FE DE MINAS,121,148,27,22.31,0,0,0,0.0,0,1,1,0.0,17,22,5,29.41,261,201,-60,-22.99,399,372,-27,-6.77,SANTA FE DE MINAS MG,-16.689174,-45.4139828,10,2915
MG,SANTA HELENA DE MINAS,6,4,-2,-33.33,0,0,0,0.0,0,0,0,0.0,35,34,-1,-2.86,216,211,-5,-2.31,257,249,-8,-3.11,SANTA HELENA DE MINAS MG,-16.93939185,-40.68257584542541,10,2916
MG,SANTA JULIANA,852,929,77,9.04,1175,1167,-8,-0.68,10,2,-8,-80.0,491,520,29,5.91,1139,1141,2,0.18,3667,3759,92,2.51,SANTA JULIANA MG,-19.308611,-47.525,10,2917
MG,SANTA MARGARIDA,52,35,-17,-32.69,2,15,13,650.0,1,3,2,200.0,222,208,-14,-6.31,823,505,-318,-38.64,1100,766,-334,-30.36,SANTA MARGARIDA MG,-20.3817696,-42.2522123,10,2919
MG,SANTA MARIA DE ITABIRA,235,214,-21,-8.94,365,299,-66,-18.08,21,45,24,114.29,333,340,7,2.1,699,569,-130,-18.6,1653,1467,-186,-11.25,SANTA MARIA DE ITABIRA MG,-19.4483453,-43.1167817,10,2920
MG,SANTA MARIA DO SALTO,19,23,4,21.05,0,0,0,0.0,0,0,0,0.0,13,16,3,23.08,322,306,-16,-4.97,354,345,-9,-2.54,SANTA MARIA DO SALTO MG,-16.2493553,-40.1484503,10,2921
MG,SANTA MARIA DO SUACUI,57,59,2,3.51,40,46,6,15.0,0,0,0,0.0,346,332,-14,-4.05,898,536,-362,-40.31,1341,973,-368,-27.44,SANTA MARIA DO SUACUI MG,-18.1894783,-42.4188445,10,2922
MG,SANTANA DA VARGEM,639,592,-47,-7.36,63,173,110,174.6,20,35,15,75.0,238,222,-16,-6.72,611,477,-134,-21.93,1571,1499,-72,-4.58,SANTANA DA VARGEM MG,-21.2491719,-45.5068185,10,2923
MG,SANTANA DE CATAGUASES,31,25,-6,-19.35,65,70,5,7.69,2,0,-2,-100.0,41,34,-7,-17.07,282,230,-52,-18.44,421,359,-62,-14.73,SANTANA DE CATAGUASES MG,-21.2871462,-42.5569749,10,2924
MG,SANTANA DE PIRAPAMA,90,95,5,5.56,29,29,0,0.0,0,0,0,0.0,84,82,-2,-2.38,260,352,92,35.38,463,558,95,20.52,SANTANA DE PIRAPAMA MG,-19.0075,-44.040833,10,2925
MG,SANTANA DO GARAMBEU,33,41,8,24.24,0,0,0,0.0,1,0,-1,-100.0,22,22,0,0.0,161,150,-11,-6.83,217,213,-4,-1.84,SANTANA DO GARAMBEU MG,-21.601389,-44.104167,10,2927
MG,SANTANA DO JACARE,29,27,-2,-6.9,254,271,17,6.69,4,3,-1,-25.0,75,65,-10,-13.33,246,236,-10,-4.07,608,602,-6,-0.99,SANTANA DO JACARE MG,-20.9023708,-45.1274193,10,2928
MG,SANTANA DO MANHUACU,105,83,-22,-20.95,7,8,1,14.29,6,3,-3,-50.0,197,121,-76,-38.58,360,450,90,25.0,675,665,-10,-1.48,SANTANA DO MANHUACU MG,-20.1075,-41.925556,10,2929
MG,SANTANA DO RIACHO,17,20,3,17.65,9,14,5,55.56,13,15,2,15.38,166,187,21,12.65,569,405,-164,-28.82,774,641,-133,-17.18,SANTANA DO RIACHO MG,-19.168611,-43.714444,10,2931
MG,SANTANA DOS MONTES,69,50,-19,-27.54,33,27,-6,-18.18,15,14,-1,-6.67,17,15,-2,-11.76,279,190,-89,-31.9,413,296,-117,-28.33,SANTANA DOS MONTES MG,-20.7875735,-43.6910376,10,2932
MG,SANTA RITA DE CALDAS,119,130,11,9.24,268,274,6,2.24,2,2,0,0.0,208,231,23,11.06,491,484,-7,-1.43,1088,1121,33,3.03,SANTA RITA DE CALDAS MG,-22.028889,-46.336944,10,2933
MG,SANTA RITA DE JACUTINGA,88,66,-22,-25.0,46,43,-3,-6.52,0,0,0,0.0,98,99,1,1.02,424,331,-93,-21.93,656,539,-117,-17.84,SANTA RITA DE JACUTINGA MG,-22.149166,-44.094444,10,2934
MG,SANTA RITA DE MINAS,102,93,-9,-8.82,275,241,-34,-12.36,1,10,9,900.0,176,204,28,15.91,334,336,2,0.6,888,884,-4,-0.45,SANTA RITA DE MINAS MG,-19.8745404,-42.1325122,10,2935
MG,SANTA RITA DE IBITIPOCA,115,109,-6,-5.22,127,124,-3,-2.36,0,0,0,0.0,29,28,-1,-3.45,182,124,-58,-31.87,453,385,-68,-15.01,SANTA RITA DE IBITIPOCA MG,-21.5625,-43.914722,10,2936
MG,SANTA RITA DO ITUETO,54,51,-3,-5.56,113,145,32,28.32,9,13,4,44.44,56,60,4,7.14,289,211,-78,-26.99,521,480,-41,-7.87,SANTA RITA DO ITUETO MG,-19.3576722,-41.3801488,10,2937
MG,SANTA RITA DO SAPUCAI,687,627,-60,-8.73,5705,5684,-21,-0.37,327,329,2,0.61,1722,1652,-70,-4.07,3927,3799,-128,-3.26,12368,12091,-277,-2.24,SANTA RITA DO SAPUCAI MG,-22.2486968,-45.7064507,10,2938
MG,SANTA ROSA DA SERRA,86,81,-5,-5.81,13,15,2,15.38,0,0,0,0.0,23,11,-12,-52.17,251,275,24,9.56,373,382,9,2.41,SANTA ROSA DA SERRA MG,-19.5271986,-45.9659869,10,2939
MG,SANTA VITORIA,763,724,-39,-5.11,1261,1286,25,1.98,45,38,-7,-15.56,662,638,-24,-3.63,2012,1111,-901,-44.78,4743,3797,-946,-19.95,SANTA VITORIA MG,-18.8465718,-50.1292823,10,2940
MG,SANTO ANTONIO DO AMPARO,883,1037,154,17.44,308,307,-1,-0.32,24,12,-12,-50.0,421,462,41,9.74,1066,1016,-50,-4.69,2702,2834,132,4.89,SANTO ANTONIO DO AMPARO MG,-20.9413389,-44.9187397,10,2941
MG,SANTO ANTONIO DO AVENTUREIRO,66,66,0,0.0,38,21,-17,-44.74,3,4,1,33.33,40,43,3,7.5,342,275,-67,-19.59,489,409,-80,-16.36,SANTO ANTONIO DO AVENTUREIRO MG,-21.7579052,-42.815566,10,2942
MG,SANTO ANTONIO DO GRAMA,99,106,7,7.07,16,12,-4,-25.0,3,1,-2,-66.67,73,74,1,1.37,272,246,-26,-9.56,463,439,-24,-5.18,SANTO ANTONIO DO GRAMA MG,-20.314444,-42.608611,10,2943
MG,SANTO ANTONIO DO ITAMBE,61,59,-2,-3.28,0,0,0,0.0,0,0,0,0.0,36,32,-4,-11.11,231,194,-37,-16.02,328,285,-43,-13.11,SANTO ANTONIO DO ITAMBE MG,-18.4656416,-43.305993,10,2944
MG,SANTO ANTONIO DO JACINTO,20,19,-1,-5.0,1,1,0,0.0,11,11,0,0.0,59,42,-17,-28.81,546,442,-104,-19.05,637,515,-122,-19.15,SANTO ANTONIO DO JACINTO MG,-16.533611,-40.176111,10,2945
MG,SANTO ANTONIO DO MONTE,498,503,5,1.0,1681,1653,-28,-1.67,116,74,-42,-36.21,1044,1058,14,1.34,1987,1966,-21,-1.06,5326,5254,-72,-1.35,SANTO ANTONIO DO MONTE MG,-20.086944,-45.290555,10,2946
MG,SANTO ANTONIO DO RETIRO,14,4,-10,-71.43,4,18,14,350.0,1,0,-1,-100.0,28,29,1,3.57,282,225,-57,-20.21,329,276,-53,-16.11,SANTO ANTONIO DO RETIRO MG,-15.3426419,-42.6223938,10,2947
MG,SANTO ANTONIO DO RIO ABAIXO,4,4,0,0.0,0,0,0,0.0,0,0,0,0.0,25,22,-3,-12.0,167,130,-37,-22.16,196,156,-40,-20.41,SANTO ANTONIO DO RIO ABAIXO MG,-19.2280364,-43.2532149,10,2948
MG,SANTO HIPOLITO,146,167,21,14.38,9,12,3,33.33,2,2,0,0.0,21,21,0,0.0,180,160,-20,-11.11,358,362,4,1.12,SANTO HIPOLITO MG,-18.2965683,-44.2214292,10,2949
MG,SANTOS DUMONT,203,151,-52,-25.62,1015,975,-40,-3.94,219,198,-21,-9.59,1830,1601,-229,-12.51,2971,3183,212,7.14,6238,6108,-130,-2.08,SANTOS DUMONT MG,-21.455867,-43.5522107,10,2950
MG,SAO BENTO ABADE,114,111,-3,-2.63,13,14,1,7.69,1,9,8,800.0,61,66,5,8.2,188,157,-31,-16.49,377,357,-20,-5.31,SAO BENTO ABADE MG,-21.5816076,-45.0759227,10,2951
MG,SAO DOMINGOS DAS DORES,58,161,103,177.59,3,2,-1,-33.33,0,6,6,0.0,80,83,3,3.75,289,629,340,117.65,430,881,451,104.88,SAO DOMINGOS DAS DORES MG,-19.5281943,-42.0132239,10,2953
MG,SAO DOMINGOS DO PRATA,206,170,-36,-17.48,315,333,18,5.71,19,41,22,115.79,546,542,-4,-0.73,1028,890,-138,-13.42,2114,1976,-138,-6.53,SAO DOMINGOS DO PRATA MG,-19.8671078,-42.9658318,10,2954
MG,SAO FELIX DE MINAS,19,15,-4,-21.05,6,8,2,33.33,14,15,1,7.14,54,51,-3,-5.56,289,216,-73,-25.26,382,305,-77,-20.16,SAO FELIX DE MINAS MG,-18.5910792,-41.4863145,10,2955
MG,SAO FRANCISCO,0,0,0,0.0,6,0,-6,-100.0,0,0,0,0.0,27,24,-3,-11.11,230,185,-45,-19.57,263,209,-54,-20.53,SAO FRANCISCO MG,-15.948889,-44.864444,10,2956
MG,SAO FRANCISCO DE PAULA,216,226,10,4.63,105,129,24,22.86,4,7,3,75.0,171,199,28,16.37,412,302,-110,-26.7,908,863,-45,-4.96,SAO FRANCISCO DE PAULA MG,-20.7098288,-44.9817485,10,2957
MG,SAO FRANCISCO DE SALES,225,210,-15,-6.67,194,101,-93,-47.94,13,21,8,61.54,138,140,2,1.45,414,321,-93,-22.46,984,793,-191,-19.41,SAO FRANCISCO DE SALES MG,-19.863056,-49.773889,10,2958
MG,SAO FRANCISCO DO GLORIA,82,86,4,4.88,7,10,3,42.86,2,9,7,350.0,82,82,0,0.0,282,307,25,8.87,455,494,39,8.57,SAO FRANCISCO DO GLORIA MG,-20.790069,-42.2679636,10,2959
MG,SAO GERALDO,77,82,5,6.49,1715,1774,59,3.44,10,18,8,80.0,200,183,-17,-8.5,469,398,-71,-15.14,2471,2455,-16,-0.65,SAO GERALDO MG,-20.9221894,-42.8343489,10,2960
MG,SAO GERALDO DA PIEDADE,12,18,6,50.0,0,0,0,0.0,0,0,0,0.0,32,33,1,3.12,263,174,-89,-33.84,307,225,-82,-26.71,SAO GERALDO DA PIEDADE MG,-18.8449508,-42.2886336,10,2961
MG,SAO GERALDO DO BAIXIO,34,37,3,8.82,19,16,-3,-15.79,5,19,14,280.0,30,28,-2,-6.67,287,144,-143,-49.83,375,244,-131,-34.93,SAO GERALDO DO BAIXIO MG,-18.9167012,-41.3613816,10,2962
MG,SAO GONCALO DO ABAETE,374,343,-31,-8.29,76,48,-28,-36.84,76,98,22,28.95,202,182,-20,-9.9,770,735,-35,-4.55,1498,1406,-92,-6.14,SAO GONCALO DO ABAETE MG,-18.3420302,-45.834112,10,2963
MG,SAO GONCALO DO PARA,154,149,-5,-3.25,1217,1164,-53,-4.35,3,5,2,66.67,280,284,4,1.43,479,334,-145,-30.27,2133,1936,-197,-9.24,SAO GONCALO DO PARA MG,-19.982778,-44.859167,10,2964
MG,SAO GONCALO DO RIO ABAIXO,132,145,13,9.85,1864,1917,53,2.84,690,1115,425,61.59,597,749,152,25.46,2111,1724,-387,-18.33,5394,5650,256,4.75,SAO GONCALO DO RIO ABAIXO MG,-19.8252042,-43.362126,10,2965
MG,SAO GONCALO DO SAPUCAI,881,903,22,2.5,1172,1165,-7,-0.6,21,24,3,14.29,929,944,15,1.61,1908,1880,-28,-1.47,4911,4916,5,0.1,SAO GONCALO DO SAPUCAI MG,-21.8905238,-45.5935943,10,2966
MG,SAO GOTARDO,2267,2800,533,23.51,494,523,29,5.87,164,181,17,10.37,2018,2070,52,2.58,2638,2177,-461,-17.48,7581,7751,170,2.24,SAO GOTARDO MG,-19.3168844,-46.0476596,10,2967
MG,SAO JOAO BATISTA DO GLORIA,446,415,-31,-6.95,81,116,35,43.21,33,34,1,3.03,169,180,11,6.51,559,525,-34,-6.08,1288,1270,-18,-1.4,SAO JOAO BATISTA DO GLORIA MG,-20.6413912,-46.5052866,10,2968
MG,SAO JOAO DA LAGOA,58,65,7,12.07,20,12,-8,-40.0,0,0,0,0.0,18,10,-8,-44.44,310,218,-92,-29.68,406,305,-101,-24.88,SAO JOAO DA LAGOA MG,-16.851502,-44.3460615,10,2969
MG,SAO JOAO DA MATA,38,43,5,13.16,18,6,-12,-66.67,2,2,0,0.0,48,54,6,12.5,227,205,-22,-9.69,333,310,-23,-6.91,SAO JOAO DA MATA MG,-21.9311736,-45.9287155,10,2970
MG,SAO JOAO DA PONTE,452,668,216,47.79,65,100,35,53.85,7,10,3,42.86,174,163,-11,-6.32,893,650,-243,-27.21,1591,1591,0,0.0,SAO JOAO DA PONTE MG,-15.9283299,-44.0078035,10,2971
MG,SAO JOAO DAS MISSOES,2,0,-2,-100.0,0,0,0,0.0,0,0,0,0.0,41,37,-4,-9.76,449,368,-81,-18.04,492,405,-87,-17.68,SAO JOAO DAS MISSOES MG,-14.8808771,-44.0829518,10,2972
MG,SAO JOAO DO MANHUACU,85,87,2,2.35,48,56,8,16.67,4,0,-4,-100.0,205,195,-10,-4.88,597,616,19,3.18,939,954,15,1.6,SAO JOAO DO MANHUACU MG,-20.3938555,-42.1499705,10,2974
MG,SAO JOAO DO MANTENINHA,26,19,-7,-26.92,494,514,20,4.05,11,12,1,9.09,145,152,7,4.83,279,271,-8,-2.87,955,968,13,1.36,SAO JOAO DO MANTENINHA MG,-18.7229295,-41.1615277,10,2975
MG,SAO JOAO DO ORIENTE,29,19,-10,-34.48,117,147,30,25.64,5,14,9,180.0,119,113,-6,-5.04,376,399,23,6.12,646,692,46,7.12,SAO JOAO DO ORIENTE MG,-19.3408771,-42.1550791,10,2976
MG,SAO JOAO DO PACUI,6,7,1,16.67,0,0,0,0.0,0,0,0,0.0,10,10,0,0.0,280,258,-22,-7.86,296,275,-21,-7.09,SAO JOAO DO PACUI MG,-16.5374481,-44.5309375,10,2977
MG,SAO JOAO DO PARAISO,49,40,-9,-18.37,6,0,-6,-100.0,0,0,0,0.0,64,63,-1,-1.56,597,580,-17,-2.85,716,683,-33,-4.61,SAO JOAO DO PARAISO MG,-15.3171214,-42.01678,10,2978
MG,SAO JOAO EVANGELISTA,108,94,-14,-12.96,96,91,-5,-5.21,44,75,31,70.45,409,441,32,7.82,600,516,-84,-14.0,1257,1217,-40,-3.18,SAO JOAO EVANGELISTA MG,-18.548023,-42.7652888,10,2979
MG,SAO JOAO NEPOMUCENO,177,179,2,1.13,2476,2285,-191,-7.71,39,40,1,2.56,938,823,-115,-12.26,1667,1698,31,1.86,5297,5025,-272,-5.13,SAO JOAO NEPOMUCENO MG,-21.5359158,-43.0151428,10,2980
MG,SAO JOSE DA BARRA,453,423,-30,-6.62,202,208,6,2.97,19,24,5,26.32,240,220,-20,-8.33,484,498,14,2.89,1398,1373,-25,-1.79,SAO JOSE DA BARRA MG,-20.7180697,-46.3125073,10,2982
MG,SAO JOSE DA SAFIRA,15,30,15,100.0,76,76,0,0.0,0,0,0,0.0,43,62,19,44.19,218,216,-2,-0.92,352,384,32,9.09,SAO JOSE DA SAFIRA MG,-18.324167,-42.143333,10,2984
MG,SAO JOSE DA VARGINHA,332,420,88,26.51,9,3,-6,-66.67,0,0,0,0.0,40,44,4,10.0,299,285,-14,-4.68,680,752,72,10.59,SAO JOSE DA VARGINHA MG,-19.7087286,-44.5577812,10,2985
MG,SAO JOSE DO DIVINO,0,0,0,0.0,7,0,-7,-100.0,0,0,0,0.0,27,26,-1,-3.7,282,266,-16,-5.67,316,292,-24,-7.59,SAO JOSE DO DIVINO MG,-18.4794444,-41.3885671,10,2987
MG,SAO JOSE DO GOIABAL,85,80,-5,-5.88,8,8,0,0.0,2,1,-1,-50.0,100,105,5,5.0,356,375,19,5.34,551,569,18,3.27,SAO JOSE DO GOIABAL MG,-19.925098,-42.7083162,10,2988
MG,SAO JOSE DO JACURI,4,7,3,75.0,134,159,25,18.66,3,5,2,66.67,57,60,3,5.26,251,225,-26,-10.36,449,456,7,1.56,SAO JOSE DO JACURI MG,-18.2773091,-42.6714372,10,2989
MG,SAO JOSE DO MANTIMENTO,0,0,0,0.0,1,0,-1,-100.0,0,0,0,0.0,42,34,-8,-19.05,192,139,-53,-27.6,235,173,-62,-26.38,SAO JOSE DO MANTIMENTO MG,-20.003958,-41.7458061,10,2990
MG,SAO LOURENCO,50,56,6,12.0,680,658,-22,-3.24,299,316,17,5.69,3623,3400,-223,-6.16,6103,6018,-85,-1.39,10755,10448,-307,-2.85,SAO LOURENCO MG,-22.116389,-45.054167,10,2991
MG,SAO MIGUEL DO ANTA,30,26,-4,-13.33,27,17,-10,-37.04,10,13,3,30.0,99,97,-2,-2.02,359,212,-147,-40.95,525,365,-160,-30.48,SAO MIGUEL DO ANTA MG,-20.7065375,-42.7195395,10,2992
MG,SAO PEDRO DA UNIAO,111,114,3,2.7,42,24,-18,-42.86,0,11,11,0.0,93,99,6,6.45,313,280,-33,-10.54,559,528,-31,-5.55,SAO PEDRO DA UNIAO MG,-21.1316402,-46.6175338,10,2993
MG,SAO PEDRO DOS FERROS,160,163,3,1.88,386,418,32,8.29,2,0,-2,-100.0,211,203,-8,-3.79,374,336,-38,-10.16,1133,1120,-13,-1.15,SAO PEDRO DOS FERROS MG,-20.1706687,-42.522901,10,2994
MG,SAO PEDRO DO SUACUI,27,30,3,11.11,66,73,7,10.61,10,10,0,0.0,73,75,2,2.74,189,170,-19,-10.05,365,358,-7,-1.92,SAO PEDRO DO SUACUI MG,-18.365556,-42.602778,10,2995
MG,SAO ROMAO,246,240,-6,-2.44,3,5,2,66.67,7,3,-4,-57.14,108,106,-2,-1.85,606,330,-276,-45.54,970,684,-286,-29.48,SAO ROMAO MG,-16.3687716,-45.0678597,10,2996
MG,SAO ROQUE DE MINAS,296,290,-6,-2.03,236,275,39,16.53,1,1,0,0.0,246,248,2,0.81,562,412,-150,-26.69,1341,1226,-115,-8.58,SAO ROQUE DE MINAS MG,-20.245277,-46.365833,10,2997
MG,SAO SEBASTIAO DA BELA VISTA,216,238,22,10.19,373,306,-67,-17.96,119,297,178,149.58,326,318,-8,-2.45,580,530,-50,-8.62,1614,1689,75,4.65,SAO SEBASTIAO DA BELA VISTA MG,-22.159167,-45.754167,10,2998
MG,SAO SEBASTIAO DA VARGEM ALEGRE,5,6,1,20.0,2,1,-1,-50.0,3,4,1,33.33,38,35,-3,-7.89,283,236,-47,-16.61,331,282,-49,-14.8,SAO SEBASTIAO DA VARGEM ALEGRE MG,-21.0716128,-42.6371378,10,2999
MG,SAO SEBASTIAO DO ANTA,61,55,-6,-9.84,4,1,-3,-75.0,10,17,7,70.0,76,67,-9,-11.84,376,342,-34,-9.04,527,482,-45,-8.54,SAO SEBASTIAO DO ANTA MG,-19.4972592,-41.983428,10,3000
MG,SAO SEBASTIAO DO MARANHAO,6,6,0,0.0,10,8,-2,-20.0,0,5,5,0.0,100,105,5,5.0,378,255,-123,-32.54,494,379,-115,-23.28,SAO SEBASTIAO DO MARANHAO MG,-18.0874457,-42.569608,10,3001
MG,SAO SEBASTIAO DO OESTE,470,435,-35,-7.45,2817,2964,147,5.22,4,5,1,25.0,142,149,7,4.93,450,368,-82,-18.22,3883,3921,38,0.98,SAO SEBASTIAO DO OESTE MG,-20.274723,-45.003611,10,3002
MG,SAO SEBASTIAO DO PARAISO,1721,1660,-61,-3.54,4416,4791,375,8.49,373,463,90,24.13,3947,3885,-62,-1.57,6812,6585,-227,-3.33,17269,17384,115,0.67,SAO SEBASTIAO DO PARAISO MG,-20.9124331,-46.9823296,10,3003
MG,SAO SEBASTIAO DO RIO PRETO,8,7,-1,-12.5,2,2,0,0.0,0,0,0,0.0,18,15,-3,-16.67,190,184,-6,-3.16,218,208,-10,-4.59,SAO SEBASTIAO DO RIO PRETO MG,-19.2923414,-43.1758535,10,3004
MG,SAO TIAGO,168,144,-24,-14.29,623,515,-108,-17.34,47,38,-9,-19.15,311,301,-10,-3.22,698,687,-11,-1.58,1847,1685,-162,-8.77,SAO TIAGO MG,-20.913056,-44.509167,10,3006
MG,SAO TOMAS DE AQUINO,502,471,-31,-6.18,275,317,42,15.27,64,24,-40,-62.5,150,148,-2,-1.33,396,326,-70,-17.68,1387,1286,-101,-7.28,SAO TOMAS DE AQUINO MG,-20.7844139,-47.097717,10,3007
MG,SAO THOME DAS LETRAS,103,114,11,10.68,610,613,3,0.49,1,1,0,0.0,140,93,-47,-33.57,520,303,-217,-41.73,1374,1124,-250,-18.2,SAO THOME DAS LETRAS MG,-21.7218272,-44.9849435,10,3008
MG,SAO VICENTE DE MINAS,468,511,43,9.19,510,508,-2,-0.39,26,22,-4,-15.38,188,211,23,12.23,432,411,-21,-4.86,1624,1663,39,2.4,SAO VICENTE DE MINAS MG,-21.703333,-44.443889,10,3009
MG,SAPUCAI-MIRIM,194,194,0,0.0,340,380,40,11.76,0,0,0,0.0,163,156,-7,-4.29,684,559,-125,-18.27,1381,1289,-92,-6.66,SAPUCAI-MIRIM MG,-22.7480012,-45.7427651,10,3010
MG,SARDOA,21,19,-2,-9.52,15,23,8,53.33,0,5,5,0.0,152,154,2,1.32,143,121,-22,-15.38,331,322,-9,-2.72,SARDOA MG,-18.781716,-42.3652762,10,3011
MG,SETUBINHA,23,21,-2,-8.7,3,4,1,33.33,1,0,-1,-100.0,53,51,-2,-3.77,330,258,-72,-21.82,410,334,-76,-18.54,SETUBINHA MG,-17.6001378,-42.1620269,10,3013
MG,SEM-PEIXE,8,4,-4,-50.0,5,4,-1,-20.0,13,20,7,53.85,21,23,2,9.52,217,214,-3,-1.38,264,265,1,0.38,SEM-PEIXE MG,-20.1015407,-42.8408301,10,3014
MG,SENADOR AMARAL,376,439,63,16.76,4,3,-1,-25.0,1,1,0,0.0,83,93,10,12.05,357,334,-23,-6.44,821,870,49,5.97,SENADOR AMARAL MG,-22.5654695,-46.17769167394954,10,3015
MG,SENADOR CORTES,73,52,-21,-28.77,114,105,-9,-7.89,0,0,0,0.0,21,25,4,19.05,235,160,-75,-31.91,443,342,-101,-22.8,SENADOR CORTES MG,-21.8009734,-42.9450985,10,3016
MG,SENADOR FIRMINO,49,36,-13,-26.53,152,156,4,2.63,6,16,10,166.67,201,209,8,3.98,273,357,84,30.77,681,774,93,13.66,SENADOR FIRMINO MG,-20.9169703,-43.1001236,10,3017
MG,SENADOR JOSE BENTO,8,6,-2,-25.0,18,15,-3,-16.67,0,0,0,0.0,3,5,2,66.67,208,209,1,0.48,237,235,-2,-0.84,SENADOR JOSE BENTO MG,-22.1641985,-46.1785855,10,3018
MG,SENADOR MODESTINO GONCALVES,22,28,6,27.27,51,52,1,1.96,0,0,0,0.0,40,39,-1,-2.5,277,264,-13,-4.69,390,383,-7,-1.79,SENADOR MODESTINO GONCALVES MG,-17.9496602,-43.2257678,10,3019
MG,SENHORA DE OLIVEIRA,69,69,0,0.0,37,49,12,32.43,1,0,-1,-100.0,97,81,-16,-16.49,71,244,173,243.66,275,443,168,61.09,SENHORA DE OLIVEIRA MG,-20.793889,-43.344166,10,3020
MG,SENHORA DO PORTO,59,49,-10,-16.95,20,22,2,10.0,0,0,0,0.0,9,14,5,55.56,238,194,-44,-18.49,326,279,-47,-14.42,SENHORA DO PORTO MG,-18.8905778,-43.0844887,10,3021
MG,SENHORA DOS REMEDIOS,12,12,0,0.0,16,18,2,12.5,53,110,57,107.55,222,197,-25,-11.26,391,367,-24,-6.14,694,704,10,1.44,SENHORA DOS REMEDIOS MG,-21.028056,-43.582778,10,3022
MG,SERICITA,3,4,1,33.33,1,1,0,0.0,23,45,22,95.65,80,85,5,6.25,504,363,-141,-27.98,611,498,-113,-18.49,SERICITA MG,-20.4738307,-42.4821683,10,3023
MG,SERRA AZUL DE MINAS,21,20,-1,-4.76,0,0,0,0.0,0,0,0,0.0,21,21,0,0.0,250,295,45,18.0,292,336,44,15.07,SERRA AZUL DE MINAS MG,-18.3622042,-43.1702095,10,3025
MG,SERRA DA SAUDADE,63,54,-9,-14.29,0,0,0,0.0,0,0,0,0.0,2,1,-1,-50.0,195,123,-72,-36.92,260,178,-82,-31.54,SERRA DA SAUDADE MG,-19.4404288,-45.7931291,10,3026
MG,SERRA DOS AIMORES,125,173,48,38.4,125,225,100,80.0,3,0,-3,-100.0,72,74,2,2.78,403,395,-8,-1.99,728,867,139,19.09,SERRA DOS AIMORES MG,-17.6441053,-40.370218,10,3027
MG,SERRA DO SALITRE,1360,1314,-46,-3.38,398,434,36,9.05,1126,246,-880,-78.15,418,411,-7,-1.67,916,783,-133,-14.52,4218,3188,-1030,-24.42,SERRA DO SALITRE MG,-19.1101839,-46.6809858,10,3028
MG,SERRANIA,329,300,-29,-8.81,214,170,-44,-20.56,12,7,-5,-41.67,139,151,12,8.63,450,437,-13,-2.89,1144,1065,-79,-6.91,SERRANIA MG,-21.547906,-46.0404553,10,3029
MG,SERRANOPOLIS DE MINAS,21,18,-3,-14.29,1,1,0,0.0,2,0,-2,-100.0,21,20,-1,-4.76,244,206,-38,-15.57,289,245,-44,-15.22,SERRANOPOLIS DE MINAS MG,-15.810935,-42.871182,10,3030
MG,SERRO,299,279,-20,-6.69,104,104,0,0.0,9,9,0,0.0,600,561,-39,-6.5,1152,1030,-122,-10.59,2164,1983,-181,-8.36,SERRO MG,-18.604444,-43.379445,10,3032
MG,SETE LAGOAS,641,690,49,7.64,17541,18921,1380,7.87,1911,2329,418,21.87,12712,12347,-365,-2.87,25918,23649,-2269,-8.75,58723,57936,-787,-1.34,SETE LAGOAS MG,-19.466111,-44.246944,10,3033
MG,SILVEIRANIA,54,56,2,3.7,24,22,-2,-8.33,1,1,0,0.0,16,16,0,0.0,171,213,42,24.56,266,308,42,15.79,SILVEIRANIA MG,-21.158611,-43.215556,10,3034
MG,SILVIANOPOLIS,301,305,4,1.33,310,303,-7,-2.26,0,0,0,0.0,74,74,0,0.0,371,339,-32,-8.63,1056,1021,-35,-3.31,SILVIANOPOLIS MG,-22.029723,-45.835277,10,3035
MG,SIMONESIA,29,20,-9,-31.03,23,40,17,73.91,13,10,-3,-23.08,274,255,-19,-6.93,801,579,-222,-27.72,1140,904,-236,-20.7,SIMONESIA MG,-20.1233838,-42.0024294,10,3037
MG,SOBRALIA,29,29,0,0.0,33,34,1,3.03,0,0,0,0.0,70,83,13,18.57,333,268,-65,-19.52,465,414,-51,-10.97,SOBRALIA MG,-19.2345745,-42.0978033,10,3038
MG,TABULEIRO,62,73,11,17.74,120,130,10,8.33,0,1,1,0.0,75,60,-15,-20.0,271,233,-38,-14.02,528,497,-31,-5.87,TABULEIRO MG,-21.3592212,-43.2479134,10,3040
MG,TAIOBEIRAS,506,598,92,18.18,455,440,-15,-3.3,58,76,18,31.03,1244,1290,46,3.7,2029,1895,-134,-6.6,4292,4299,7,0.16,TAIOBEIRAS MG,-15.8080842,-42.2270207,10,3041
MG,TAPARUBA,41,44,3,7.32,52,51,-1,-1.92,2,0,-2,-100.0,26,24,-2,-7.69,226,302,76,33.63,347,421,74,21.33,TAPARUBA MG,-19.7621023,-41.614796,10,3042
MG,TAPIRAI,118,131,13,11.02,0,0,0,0.0,0,0,0,0.0,5,4,-1,-20.0,4,120,116,2900.0,127,255,128,100.79,TAPIRAI MG,-19.8882788,-46.0202739,10,3044
MG,TAQUARACU DE MINAS,102,100,-2,-1.96,46,41,-5,-10.87,21,21,0,0.0,30,29,-1,-3.33,313,224,-89,-28.43,512,415,-97,-18.95,TAQUARACU DE MINAS MG,-19.669445,-43.687777,10,3045
MG,TARUMIRIM,95,88,-7,-7.37,102,101,-1,-0.98,19,23,4,21.05,215,235,20,9.3,881,946,65,7.38,1312,1393,81,6.17,TARUMIRIM MG,-19.2818607,-42.0070412,10,3046
MG,TEIXEIRAS,150,164,14,9.33,120,118,-2,-1.67,50,42,-8,-16.0,279,317,38,13.62,676,584,-92,-13.61,1275,1225,-50,-3.92,TEIXEIRAS MG,-20.6517875,-42.8563275,10,3047
MG,TEOFILO OTONI,764,737,-27,-3.53,1639,1434,-205,-12.51,2347,3009,662,28.21,7841,6970,-871,-11.11,13745,13976,231,1.68,26336,26126,-210,-0.8,TEOFILO OTONI MG,-17.8579267,-41.5081533,10,3048
MG,TIROS,414,320,-94,-22.71,258,349,91,35.27,0,0,0,0.0,114,110,-4,-3.51,398,265,-133,-33.42,1184,1044,-140,-11.82,TIROS MG,-19.003889,-45.963611,10,3051
MG,TOCANTINS,163,126,-37,-22.7,1029,1007,-22,-2.14,33,18,-15,-45.45,577,564,-13,-2.25,957,948,-9,-0.94,2759,2663,-96,-3.48,TOCANTINS MG,-21.1738872,-43.0207206,10,3052
MG,TOCOS DO MOJI,18,19,1,5.56,17,18,1,5.88,3,2,-1,-33.33,41,43,2,4.88,214,220,6,2.8,293,302,9,3.07,TOCOS DO MOJI MG,-22.3706152,-46.0964763,10,3053
MG,TOLEDO,21,11,-10,-47.62,94,96,2,2.13,7,16,9,128.57,138,131,-7,-5.07,350,461,111,31.71,610,715,105,17.21,TOLEDO MG,-22.7433969,-46.3735044,10,3054
MG,TOMBOS,140,133,-7,-5.0,35,37,2,5.71,6,8,2,33.33,185,188,3,1.62,638,453,-185,-29.0,1004,819,-185,-18.43,TOMBOS MG,-20.9105042,-42.0260716,10,3055
MG,TRES CORACOES,1405,1246,-159,-11.32,4628,4663,35,0.76,361,350,-11,-3.05,3791,3734,-57,-1.5,6268,5804,-464,-7.4,16453,15797,-656,-3.99,TRES CORACOES MG,-21.695625,-45.2543675,10,3056
MG,TRES MARIAS,666,842,176,26.43,1295,1250,-45,-3.47,443,488,45,10.16,1163,1140,-23,-1.98,2690,2726,36,1.34,6257,6446,189,3.02,TRES MARIAS MG,-18.204795,-45.247289,10,3057
MG,TRES PONTAS,2722,2690,-32,-1.18,3336,3749,413,12.38,337,335,-2,-0.59,3403,3378,-25,-0.73,3887,3849,-38,-0.98,13685,14001,316,2.31,TRES PONTAS MG,-21.3686224,-45.5122937,10,3058
MG,TUMIRITINGA,68,69,1,1.47,4,27,23,575.0,23,0,-23,-100.0,50,49,-1,-2.0,270,271,1,0.37,415,416,1,0.24,TUMIRITINGA MG,-18.976946,-41.645851,10,3059
MG,TUPACIGUARA,1216,1280,64,5.26,1165,1292,127,10.9,36,41,5,13.89,933,935,2,0.21,1800,1500,-300,-16.67,5150,5048,-102,-1.98,TUPACIGUARA MG,-18.5932122,-48.6999014,10,3060
MG,TURMALINA,549,723,174,31.69,469,449,-20,-4.26,16,22,6,37.5,618,618,0,0.0,1352,1356,4,0.3,3004,3168,164,5.46,TURMALINA MG,-17.286102,-42.7312574,10,3061
MG,TURVOLANDIA,253,226,-27,-10.67,209,183,-26,-12.44,2,1,-1,-50.0,114,114,0,0.0,304,295,-9,-2.96,882,819,-63,-7.14,TURVOLANDIA MG,-21.875556,-45.786944,10,3062
MG,UBA,201,214,13,6.47,12224,12681,457,3.74,588,578,-10,-1.7,5393,5341,-52,-0.96,7921,7678,-243,-3.07,26327,26492,165,0.63,UBA MG,-21.12,-42.942777,10,3063
MG,UBAI,13,18,5,38.46,0,0,0,0.0,3,6,3,100.0,109,104,-5,-4.59,573,517,-56,-9.77,698,645,-53,-7.59,UBAI MG,-16.2925001,-44.7823835,10,3064
MG,UBAPORANGA,78,80,2,2.56,131,109,-22,-16.79,9,8,-1,-11.11,244,258,14,5.74,602,548,-54,-8.97,1064,1003,-61,-5.73,UBAPORANGA MG,-19.6344637,-42.1073048,10,3065
MG,UBERABA,3020,3043,23,0.76,16050,17410,1360,8.47,5614,5099,-515,-9.17,19109,18518,-591,-3.09,45869,44731,-1138,-2.48,89662,88801,-861,-0.96,UBERABA MG,-19.750833,-47.936666,10,3066
MG,UBERLANDIA,5630,5860,230,4.09,26696,28843,2147,8.04,11007,11302,295,2.68,47562,46474,-1088,-2.29,123704,122964,-740,-0.6,214599,215443,844,0.39,UBERLANDIA MG,-18.9188041,-48.2767837,10,3067
MG,UMBURATIBA,57,45,-12,-21.05,16,17,1,6.25,0,0,0,0.0,9,11,2,22.22,210,207,-3,-1.43,292,280,-12,-4.11,UMBURATIBA MG,-17.2548062,-40.5708064,10,3068
MG,UNAI,2836,2869,33,1.16,1394,1435,41,2.94,584,519,-65,-11.13,5380,5394,14,0.26,6689,6728,39,0.58,16883,16945,62,0.37,UNAI MG,-16.3628767,-46.892413,10,3069
MG,UNIAO DE MINAS,308,279,-29,-9.42,4,3,-1,-25.0,3,3,0,0.0,50,58,8,16.0,269,216,-53,-19.7,634,559,-75,-11.83,UNIAO DE MINAS MG,-19.5296289,-50.3317301,10,3070
MG,URUANA DE MINAS,56,51,-5,-8.93,9,5,-4,-44.44,0,0,0,0.0,57,63,6,10.53,274,219,-55,-20.07,396,338,-58,-14.65,URUANA DE MINAS MG,-16.0628,-46.2556,10,3071
MG,URUCANIA,633,665,32,5.06,1915,1947,32,1.67,23,26,3,13.04,184,171,-13,-7.07,520,446,-74,-14.23,3275,3255,-20,-0.61,URUCANIA MG,-20.350833,-42.739444,10,3072
MG,URUCUIA,146,101,-45,-30.82,0,0,0,0.0,3,0,-3,-100.0,105,111,6,5.71,635,552,-83,-13.07,889,764,-125,-14.06,URUCUIA MG,-16.1266994,-45.7393046,10,3073
MG,VARGEM ALEGRE,27,27,0,0.0,131,124,-7,-5.34,3,1,-2,-66.67,132,119,-13,-9.85,323,276,-47,-14.55,616,547,-69,-11.2,VARGEM ALEGRE MG,-19.6070413,-42.2997922,10,3074
MG,VARGEM BONITA,92,117,25,27.17,10,10,0,0.0,3,5,2,66.67,36,38,2,5.56,198,183,-15,-7.58,339,353,14,4.13,VARGEM BONITA MG,-20.3282116,-46.3668419,10,3075
MG,VARGEM GRANDE DO RIO PARDO,25,6,-19,-76.0,45,41,-4,-8.89,0,0,0,0.0,26,23,-3,-11.54,360,271,-89,-24.72,456,341,-115,-25.22,VARGEM GRANDE DO RIO PARDO MG,-15.4027415,-42.311441,10,3076
MG,VARGINHA,1062,1241,179,16.85,7093,7107,14,0.2,2030,2069,39,1.92,10187,9679,-508,-4.99,20322,21219,897,4.41,40694,41315,621,1.53,VARGINHA MG,-21.5565914,-45.4340674,10,3077
MG,VARJAO DE MINAS,568,557,-11,-1.94,68,73,5,7.35,22,8,-14,-63.64,152,168,16,10.53,429,374,-55,-12.82,1239,1180,-59,-4.76,VARJAO DE MINAS MG,-18.3791473,-46.030627,10,3078
MG,VARZEA DA PALMA,922,994,72,7.81,1888,1897,9,0.48,57,63,6,10.53,981,938,-43,-4.38,1959,1727,-232,-11.84,5807,5619,-188,-3.24,VARZEA DA PALMA MG,-17.5983328,-44.7317086,10,3079
MG,VARZELANDIA,12,12,0,0.0,19,1,-18,-94.74,3,4,1,33.33,229,220,-9,-3.93,804,686,-118,-14.68,1067,923,-144,-13.5,VARZELANDIA MG,-15.701667,-44.027223,10,3080
MG,VAZANTE,637,518,-119,-18.68,1715,1729,14,0.82,203,200,-3,-1.48,901,896,-5,-0.55,1310,1303,-7,-0.53,4766,4646,-120,-2.52,VAZANTE MG,-17.9896107,-46.9003899,10,3081
MG,VERDELANDIA,341,467,126,36.95,0,0,0,0.0,0,0,0,0.0,73,55,-18,-24.66,356,407,51,14.33,770,929,159,20.65,VERDELANDIA MG,-15.5926259,-43.6084698,10,3082
MG,VEREDINHA,293,321,28,9.56,35,39,4,11.43,166,182,16,9.64,93,83,-10,-10.75,332,317,-15,-4.52,919,942,23,2.5,VEREDINHA MG,-17.3945837,-42.7383934,10,3083
MG,VERISSIMO,226,225,-1,-0.44,40,54,14,35.0,0,0,0,0.0,32,32,0,0.0,253,187,-66,-26.09,551,498,-53,-9.62,VERISSIMO MG,-19.6680818,-48.308771,10,3084
MG,VERMELHO NOVO,12,10,-2,-16.67,12,15,3,25.0,1,0,-1,-100.0,54,59,5,9.26,233,220,-13,-5.58,312,304,-8,-2.56,VERMELHO NOVO MG,-20.0356065,-42.2671476,10,3085
MG,VICOSA,0,4,4,0.0,1,1,0,0.0,0,0,0,0.0,2,2,0,0.0,153,106,-47,-30.72,156,113,-43,-27.56,VICOSA MG,-20.7538586,-42.8815888,10,3087
MG,VIEIRAS,52,51,-1,-1.92,3,10,7,233.33,1,3,2,200.0,38,40,2,5.26,230,223,-7,-3.04,324,327,3,0.93,VIEIRAS MG,-20.8651165,-42.2448518,10,3088
MG,MATHIAS LOBATO,71,62,-9,-12.68,0,0,0,0.0,0,3,3,0.0,7,13,6,85.71,563,513,-50,-8.88,641,591,-50,-7.8,MATHIAS LOBATO MG,-18.5760459,-41.9155448,10,3089
MG,VIRGEM DA LAPA,11,18,7,63.64,37,28,-9,-24.32,19,13,-6,-31.58,118,102,-16,-13.56,626,440,-186,-29.71,811,601,-210,-25.89,VIRGEM DA LAPA MG,-16.8071554,-42.3376458,10,3090
MG,VIRGINIA,101,96,-5,-4.95,369,289,-80,-21.68,3,6,3,100.0,187,162,-25,-13.37,577,573,-4,-0.69,1237,1126,-111,-8.97,VIRGINIA MG,-22.333333,-45.091666,10,3091
MG,VIRGINOPOLIS,88,78,-10,-11.36,46,56,10,21.74,10,1,-9,-90.0,328,304,-24,-7.32,542,411,-131,-24.17,1014,850,-164,-16.17,VIRGINOPOLIS MG,-18.8226124,-42.7053967,10,3092
MG,VIRGOLANDIA,7,9,2,28.57,0,0,0,0.0,0,0,0,0.0,39,33,-6,-15.38,290,212,-78,-26.9,336,254,-82,-24.4,VIRGOLANDIA MG,-18.4759665,-42.308628,10,3093
MG,VISCONDE DO RIO BRANCO,178,182,4,2.25,5679,5388,-291,-5.12,212,262,50,23.58,1532,1483,-49,-3.2,3683,3458,-225,-6.11,11284,10773,-511,-4.53,VISCONDE DO RIO BRANCO MG,-21.01,-42.840833,10,3094
MG,VOLTA GRANDE,115,132,17,14.78,60,93,33,55.0,5,0,-5,-100.0,82,66,-16,-19.51,506,425,-81,-16.01,768,716,-52,-6.77,VOLTA GRANDE MG,-21.770834,-42.539166,10,3095
ES,AFONSO CLAUDIO,308,236,-72,-23.38,554,571,17,3.07,100,96,-4,-4.0,893,841,-52,-5.82,1798,1828,30,1.67,3653,3572,-81,-2.22,AFONSO CLAUDIO ES,-20.077841,-41.12606,7,3097
ES,AGUIA BRANCA,43,39,-4,-9.3,169,166,-3,-1.78,2,11,9,450.0,188,211,23,12.23,776,764,-12,-1.55,1178,1191,13,1.1,AGUIA BRANCA ES,-18.9847265,-40.7391844,7,3098
ES,AGUA DOCE DO NORTE,26,25,-1,-3.85,193,191,-2,-1.04,29,19,-10,-34.48,158,166,8,5.06,572,437,-135,-23.6,978,838,-140,-14.31,AGUA DOCE DO NORTE ES,-18.54822,-40.979012,7,3099
ES,ALEGRE,173,141,-32,-18.5,224,202,-22,-9.82,42,43,1,2.38,941,909,-32,-3.4,2242,2319,77,3.43,3622,3614,-8,-0.22,ALEGRE ES,-20.7053862,-41.5865473,7,3100
ES,ALFREDO CHAVES,193,209,16,8.29,242,242,0,0.0,107,82,-25,-23.36,596,560,-36,-6.04,1887,1828,-59,-3.13,3025,2921,-104,-3.44,ALFREDO CHAVES ES,-20.6249704,-40.75006690147988,7,3101
ES,ALTO RIO NOVO,30,22,-8,-26.67,12,3,-9,-75.0,4,4,0,0.0,136,129,-7,-5.15,446,428,-18,-4.04,628,586,-42,-6.69,ALTO RIO NOVO ES,-19.0577208,-41.0171518,7,3102
ES,ANCHIETA,125,122,-3,-2.4,1593,1450,-143,-8.98,396,427,31,7.83,886,926,40,4.51,3406,2679,-727,-21.34,6406,5604,-802,-12.52,ANCHIETA ES,-20.8057672,-40.6454564,7,3103
ES,APIACA,78,77,-1,-1.28,26,25,-1,-3.85,28,8,-20,-71.43,123,127,4,3.25,510,511,1,0.2,765,748,-17,-2.22,APIACA ES,-21.152272,-41.569297,7,3104
ES,ARACRUZ,1541,1505,-36,-2.34,7385,7743,358,4.85,2749,3387,638,23.21,3911,3740,-171,-4.37,11587,10503,-1084,-9.36,27173,26878,-295,-1.09,ARACRUZ ES,-19.8245218,-40.2735025,7,3105
ES,BAIXO GUANDU,194,201,7,3.61,855,959,104,12.16,86,50,-36,-41.86,1135,1127,-8,-0.7,2371,2135,-236,-9.95,4641,4472,-169,-3.64,BAIXO GUANDU ES,-19.5138322,-41.0182089,7,3107
ES,BARRA DE SAO FRANCISCO,113,112,-1,-0.88,2339,2299,-40,-1.71,67,77,10,14.93,1851,2018,167,9.02,2183,2074,-109,-4.99,6553,6580,27,0.41,BARRA DE SAO FRANCISCO ES,-18.7570902,-40.8916119,7,3108
ES,BOA ESPERANCA,1555,1551,-4,-0.26,937,901,-36,-3.84,130,181,51,39.23,1956,1962,6,0.31,2711,2701,-10,-0.37,7289,7296,7,0.1,BOA ESPERANCA ES,-18.5395472,-40.2904088,7,3109
ES,BREJETUBA,328,203,-125,-38.11,19,20,1,5.26,97,104,7,7.22,241,225,-16,-6.64,669,647,-22,-3.29,1354,1199,-155,-11.45,BREJETUBA ES,-20.1465817,-41.2902303,7,3111
ES,CACHOEIRO DE ITAPEMIRIM,469,449,-20,-4.26,11684,12034,350,3.0,761,859,98,12.88,11110,11327,217,1.95,20215,18924,-1291,-6.39,44239,43593,-646,-1.46,CACHOEIRO DE ITAPEMIRIM ES,-20.848084,-41.11129,7,3112
ES,CASTELO,199,185,-14,-7.04,2474,2703,229,9.26,198,240,42,21.21,1712,1703,-9,-0.53,2773,2763,-10,-0.36,7356,7594,238,3.24,CASTELO ES,-20.6034476,-41.2033505,7,3114
ES,COLATINA,522,456,-66,-12.64,8884,8796,-88,-0.99,610,686,76,12.46,7895,7960,65,0.82,14256,14120,-136,-0.95,32167,32018,-149,-0.46,COLATINA ES,-19.5346732,-40.6287836,7,3115
ES,CONCEICAO DA BARRA,1686,816,-870,-51.6,453,449,-4,-0.88,5,0,-5,-100.0,428,451,23,5.37,1715,3023,1308,76.27,4287,4739,452,10.54,CONCEICAO DA BARRA ES,-18.5841421,-39.7371844,7,3116
ES,CONCEICAO DO CASTELO,270,250,-20,-7.41,197,221,24,12.18,31,33,2,6.45,415,356,-59,-14.22,536,488,-48,-8.96,1449,1348,-101,-6.97,CONCEICAO DO CASTELO ES,-20.3601311,-41.2470343,7,3117
ES,DIVINO DE SAO LOURENCO,30,25,-5,-16.67,50,29,-21,-42.0,25,8,-17,-68.0,59,59,0,0.0,241,211,-30,-12.45,405,332,-73,-18.02,DIVINO DE SAO LOURENCO ES,-20.6224575,-41.6853124,7,3118
ES,DOMINGOS MARTINS,847,713,-134,-15.82,712,787,75,10.53,246,143,-103,-41.87,1167,1135,-32,-2.74,3153,2747,-406,-12.88,6125,5525,-600,-9.8,DOMINGOS MARTINS ES,-20.3646483,-40.6585797,7,3119
ES,DORES DO RIO PRETO,38,37,-1,-2.63,128,104,-24,-18.75,16,14,-2,-12.5,196,205,9,4.59,307,276,-31,-10.1,685,636,-49,-7.15,DORES DO RIO PRETO ES,-20.6907113,-41.846385,7,3120
ES,ECOPORANGA,491,443,-48,-9.78,314,322,8,2.55,44,32,-12,-27.27,536,458,-78,-14.55,1165,921,-244,-20.94,2550,2176,-374,-14.67,ECOPORANGA ES,-18.3720918,-40.8321351,7,3121
ES,GOVERNADOR LINDENBERG,55,51,-4,-7.27,129,168,39,30.23,9,20,11,122.22,288,275,-13,-4.51,580,510,-70,-12.07,1061,1024,-37,-3.49,GOVERNADOR LINDENBERG ES,-19.25076,-40.462888,7,3123
ES,GUACUI,223,206,-17,-7.62,362,320,-42,-11.6,63,54,-9,-14.29,1393,1367,-26,-1.87,2278,2082,-196,-8.6,4319,4029,-290,-6.71,GUACUI ES,-20.7726679,-41.6750657,7,3124
ES,GUARAPARI,285,272,-13,-4.56,1398,1337,-61,-4.36,1241,1372,131,10.56,6298,6124,-174,-2.76,11529,11771,242,2.1,20751,20876,125,0.6,GUARAPARI ES,-20.6718755,-40.4984617,7,3125
ES,IBATIBA,56,61,5,8.93,160,155,-5,-3.12,12,13,1,8.33,773,752,-21,-2.72,1365,1301,-64,-4.69,2366,2282,-84,-3.55,IBATIBA ES,-20.2342792,-41.5082981,7,3126
ES,IBIRACU,130,97,-33,-25.38,404,532,128,31.68,263,235,-28,-10.65,592,609,17,2.87,2948,3055,107,3.63,4337,4528,191,4.4,IBIRACU ES,-19.8309496,-40.3686594,7,3127
ES,IBITIRAMA,23,21,-2,-8.7,40,42,2,5.0,0,0,0,0.0,129,122,-7,-5.43,497,426,-71,-14.29,689,611,-78,-11.32,IBITIRAMA ES,-20.5394377,-41.6644451,7,3128
ES,ICONHA,29,28,-1,-3.45,290,276,-14,-4.83,36,25,-11,-30.56,715,653,-62,-8.67,2690,2760,70,2.6,3760,3742,-18,-0.48,ICONHA ES,-20.7935003,-40.8108852,7,3129
ES,IRUPI,39,40,1,2.56,34,30,-4,-11.76,5,8,3,60.0,305,300,-5,-1.64,747,704,-43,-5.76,1130,1082,-48,-4.25,IRUPI ES,-20.346479,-41.6392581,7,3130
ES,ITAGUACU,96,92,-4,-4.17,243,154,-89,-36.63,10,30,20,200.0,391,396,5,1.28,809,664,-145,-17.92,1549,1336,-213,-13.75,ITAGUACU ES,-19.8015463,-40.8564646,7,3131
ES,ITAPEMIRIM,342,303,-39,-11.4,1141,1211,70,6.13,60,61,1,1.67,850,816,-34,-4.0,4003,2597,-1406,-35.12,6396,4988,-1408,-22.01,ITAPEMIRIM ES,-21.0105534,-40.8351239,7,3132
ES,ITARANA,27,34,7,25.93,68,84,16,23.53,331,354,23,6.95,289,270,-19,-6.57,525,523,-2,-0.38,1240,1265,25,2.02,ITARANA ES,-19.8707305,-40.8749826,7,3133
ES,IUNA,85,108,23,27.06,156,173,17,10.9,54,44,-10,-18.52,946,923,-23,-2.43,1451,1372,-79,-5.44,2692,2620,-72,-2.67,IUNA ES,-20.3427029,-41.5360386,7,3134
ES,JAGUARE,951,894,-57,-5.99,163,129,-34,-20.86,35,44,9,25.71,923,924,1,0.11,1710,1477,-233,-13.63,3782,3468,-314,-8.3,JAGUARE ES,-18.9029244,-40.0712037,7,3135
ES,JERONIMO MONTEIRO,36,36,0,0.0,41,33,-8,-19.51,24,11,-13,-54.17,368,315,-53,-14.4,645,521,-124,-19.22,1114,916,-198,-17.77,JERONIMO MONTEIRO ES,-20.7882214,-41.3921464,7,3136
ES,JOAO NEIVA,96,92,-4,-4.17,900,1151,251,27.89,114,134,20,17.54,569,521,-48,-8.44,1881,1614,-267,-14.19,3560,3512,-48,-1.35,JOAO NEIVA ES,-19.756346,-40.3848345,7,3137
ES,LARANJA DA TERRA,37,38,1,2.7,72,81,9,12.5,7,9,2,28.57,223,228,5,2.24,627,445,-182,-29.03,966,801,-165,-17.08,LARANJA DA TERRA ES,-19.8989653,-41.0584617,7,3138
ES,LINHARES,4578,4594,16,0.35,11720,12632,912,7.78,1274,1428,154,12.09,9498,10144,646,6.8,18149,17569,-580,-3.2,45219,46367,1148,2.54,LINHARES ES,-19.3816944,-40.0612213,7,3139
ES,MANTENOPOLIS,19,21,2,10.53,16,12,-4,-25.0,3,5,2,66.67,198,217,19,9.6,609,545,-64,-10.51,845,800,-45,-5.33,MANTENOPOLIS ES,-18.8626177,-41.1224012,7,3140
ES,MARATAIZES,19,35,16,84.21,168,240,72,42.86,145,264,119,82.07,1651,1609,-42,-2.54,4073,4181,108,2.65,6056,6329,273,4.51,MARATAIZES ES,-21.0443673,-40.8272204,7,3141
ES,MARECHAL FLORIANO,704,664,-40,-5.68,839,903,64,7.63,90,113,23,25.56,711,669,-42,-5.91,2306,2075,-231,-10.02,4650,4424,-226,-4.86,MARECHAL FLORIANO ES,-20.4124966,-40.6749858,7,3142
ES,MARILANDIA,239,279,40,16.74,626,633,7,1.12,40,38,-2,-5.0,479,442,-37,-7.72,897,791,-106,-11.82,2281,2183,-98,-4.3,MARILANDIA ES,-19.4117824,-40.5442916,7,3143
ES,MIMOSO DO SUL,270,211,-59,-21.85,398,386,-12,-3.02,27,31,4,14.81,719,757,38,5.29,1491,1392,-99,-6.64,2905,2777,-128,-4.41,MIMOSO DO SUL ES,-21.0628724,-41.3640478,7,3144
ES,MONTANHA,820,892,72,8.78,346,395,49,14.16,14,16,2,14.29,571,572,1,0.18,1387,1153,-234,-16.87,3138,3028,-110,-3.51,MONTANHA ES,-18.1256742,-40.366795,7,3145
ES,MUNIZ FREIRE,105,85,-20,-19.05,231,291,60,25.97,11,2,-9,-81.82,548,526,-22,-4.01,787,817,30,3.81,1682,1721,39,2.32,MUNIZ FREIRE ES,-20.4636068,-41.4137007,7,3147
ES,MUQUI,81,80,-1,-1.23,57,51,-6,-10.53,28,31,3,10.71,366,352,-14,-3.83,729,882,153,20.99,1261,1396,135,10.71,MUQUI ES,-20.9509368,-41.3444285,7,3148
ES,NOVA VENECIA,492,462,-30,-6.1,1508,1616,108,7.16,560,815,255,45.54,2544,2510,-34,-1.34,3976,3322,-654,-16.45,9080,8725,-355,-3.91,NOVA VENECIA ES,-18.7063456,-40.3969786,7,3149
ES,PANCAS,145,134,-11,-7.59,31,51,20,64.52,19,29,10,52.63,377,364,-13,-3.45,1085,934,-151,-13.92,1657,1512,-145,-8.75,PANCAS ES,-19.2239225,-40.8502555,7,3150
ES,PEDRO CANARIO,446,444,-2,-0.45,151,296,145,96.03,285,570,285,100.0,503,544,41,8.15,1281,1125,-156,-12.18,2666,2979,313,11.74,PEDRO CANARIO ES,-18.2998272,-39.9558844,7,3151
ES,PINHEIROS,1803,1453,-350,-19.41,430,404,-26,-6.05,20,35,15,75.0,889,900,11,1.24,1558,1499,-59,-3.79,4700,4291,-409,-8.7,PINHEIROS ES,-18.4127047,-40.217534,7,3152
ES,PIUMA,94,91,-3,-3.19,329,328,-1,-0.3,51,52,1,1.96,733,761,28,3.82,1587,1290,-297,-18.71,2794,2522,-272,-9.74,PIUMA ES,-20.8375312,-40.7271589,7,3153
ES,PRESIDENTE KENNEDY,44,42,-2,-4.55,13,13,0,0.0,0,0,0,0.0,51,52,1,1.96,184,182,-2,-1.09,292,289,-3,-1.03,PRESIDENTE KENNEDY ES,-21.1000137,-41.0436113,7,3155
ES,RIO BANANAL,347,283,-64,-18.44,226,233,7,3.1,49,63,14,28.57,753,827,74,9.83,1087,1059,-28,-2.58,2462,2465,3,0.12,RIO BANANAL ES,-19.2614413,-40.3353272,7,3156
ES,RIO NOVO DO SUL,47,54,7,14.89,372,379,7,1.88,6,2,-4,-66.67,332,298,-34,-10.24,762,732,-30,-3.94,1519,1465,-54,-3.55,RIO NOVO DO SUL ES,-20.8641487,-40.9384378,7,3157
ES,SANTA LEOPOLDINA,256,228,-28,-10.94,44,33,-11,-25.0,7,3,-4,-57.14,187,173,-14,-7.49,662,604,-58,-8.76,1156,1041,-115,-9.95,SANTA LEOPOLDINA ES,-20.0987046,-40.5269434,7,3158
ES,SANTA MARIA DE JETIBA,2218,2094,-124,-5.59,838,814,-24,-2.86,109,98,-11,-10.09,2376,2380,4,0.17,2677,2766,89,3.32,8218,8152,-66,-0.8,SANTA MARIA DE JETIBA ES,-20.025296,-40.743931,7,3159
ES,SANTA TERESA,304,269,-35,-11.51,740,731,-9,-1.22,217,167,-50,-23.04,959,941,-18,-1.88,2406,2436,30,1.25,4626,4544,-82,-1.77,SANTA TERESA ES,-19.936339,-40.597945,7,3160
ES,SAO DOMINGOS DO NORTE,92,82,-10,-10.87,714,623,-91,-12.75,6,5,-1,-16.67,149,162,13,8.72,403,349,-54,-13.4,1364,1221,-143,-10.48,SAO DOMINGOS DO NORTE ES,-19.1461276,-40.6214803,7,3161
ES,SAO GABRIEL DA PALHA,101,82,-19,-18.81,2576,2351,-225,-8.73,298,300,2,0.67,1641,1651,10,0.61,2223,1899,-324,-14.57,6839,6283,-556,-8.13,SAO GABRIEL DA PALHA ES,-19.0148349,-40.539464,7,3162
ES,SAO JOSE DO CALCADO,110,94,-16,-14.55,68,130,62,91.18,5,13,8,160.0,294,293,-1,-0.34,592,508,-84,-14.19,1069,1038,-31,-2.9,SAO JOSE DO CALCADO ES,-21.0271161,-41.654069,7,3163
ES,SAO MATEUS,2968,2468,-500,-16.85,2450,2897,447,18.24,612,587,-25,-4.08,5089,5079,-10,-0.2,9538,9210,-328,-3.44,20657,20241,-416,-2.01,SAO MATEUS ES,-18.7156342,-39.8482555,7,3164
ES,SAO ROQUE DO CANAA,138,161,23,16.67,857,876,19,2.22,11,15,4,36.36,388,400,12,3.09,546,478,-68,-12.45,1940,1930,-10,-0.52,SAO ROQUE DO CANAA ES,-19.7385942,-40.6598575,7,3165
ES,SOORETAMA,1276,1285,9,0.71,675,1021,346,51.26,113,47,-66,-58.41,650,706,56,8.62,1338,1626,288,21.52,4052,4685,633,15.62,SOORETAMA ES,-19.1918129,-40.1037067,7,3167
ES,VARGEM ALTA,164,157,-7,-4.27,1290,1337,47,3.64,89,90,1,1.12,530,481,-49,-9.25,1351,1234,-117,-8.66,3424,3299,-125,-3.65,VARGEM ALTA ES,-20.6742303,-41.010615,7,3168
ES,VENDA NOVA DO IMIGRANTE,554,508,-46,-8.3,793,872,79,9.96,250,289,39,15.6,1664,1643,-21,-1.26,2585,2414,-171,-6.62,5846,5726,-120,-2.05,VENDA NOVA DO IMIGRANTE ES,-20.3325787,-41.1295842,7,3169
ES,VILA PAVAO,43,32,-11,-25.58,186,161,-25,-13.44,8,12,4,50.0,223,213,-10,-4.48,361,471,110,30.47,821,889,68,8.28,VILA PAVAO ES,-18.6191731,-40.6043622,7,3171
ES,VILA VALERIO,444,389,-55,-12.39,46,60,14,30.43,35,26,-9,-25.71,441,456,15,3.4,924,663,-261,-28.25,1890,1594,-296,-15.66,VILA VALERIO ES,-18.9984033,-40.3894342,7,3172
ES,VITORIA,655,700,45,6.87,10668,11438,770,7.22,6858,7152,294,4.29,23977,21627,-2350,-9.8,172177,168492,-3685,-2.14,214335,209409,-4926,-2.3,VITORIA ES,-20.3200917,-40.3376682,7,3174
RJ,ANGRA DOS REIS,227,237,10,4.41,5393,5176,-217,-4.02,827,790,-37,-4.47,7559,7171,-388,-5.13,20076,19481,-595,-2.96,34082,32855,-1227,-3.6,ANGRA DOS REIS RJ,-23.0063966,-44.316326,18,3175
RJ,ARARUAMA,418,372,-46,-11.0,1280,1302,22,1.72,817,1501,684,83.72,5882,5928,46,0.78,9115,10520,1405,15.41,17512,19623,2111,12.05,ARARUAMA RJ,-22.8733203,-42.3428897,18,3177
RJ,BARRA DO PIRAI,463,451,-12,-2.59,2230,2775,545,24.44,663,695,32,4.83,4517,4531,14,0.31,7876,7861,-15,-0.19,15749,16313,564,3.58,BARRA DO PIRAI RJ,-22.4703403,-43.8263256,18,3181
RJ,BOM JARDIM,189,157,-32,-16.93,0,1,1,0.0,13,14,1,7.69,162,155,-7,-4.32,1402,1511,109,7.77,1766,1838,72,4.08,BOM JARDIM RJ,-22.1515328,-42.4186683,18,3184
RJ,BOM JESUS DO ITABAPOANA,261,226,-35,-13.41,547,521,-26,-4.75,55,33,-22,-40.0,1390,1427,37,2.66,2756,3239,483,17.53,5009,5446,437,8.72,BOM JESUS DO ITABAPOANA RJ,-21.1341025,-41.680095,18,3185
RJ,CABO FRIO,128,137,9,7.03,1622,1611,-11,-0.68,860,782,-78,-9.07,11506,10771,-735,-6.39,29091,25894,-3197,-10.99,43207,39195,-4012,-9.29,CABO FRIO RJ,-22.8804369,-42.0189227,18,3186
RJ,CACHOEIRAS DE MACACU,561,536,-25,-4.46,1281,1393,112,8.74,125,194,69,55.2,1381,1363,-18,-1.3,3633,3323,-310,-8.53,6981,6809,-172,-2.46,CACHOEIRAS DE MACACU RJ,-22.4626861,-42.6534414,18,3187
RJ,CAMBUCI,117,103,-14,-11.97,168,154,-14,-8.33,8,10,2,25.0,221,223,2,0.9,872,811,-61,-7.0,1386,1301,-85,-6.13,CAMBUCI RJ,-21.5749919,-41.9107833,18,3188
RJ,CAMPOS DOS GOYTACAZES,1768,1811,43,2.43,6779,6985,206,3.04,3303,3035,-268,-8.11,22582,22971,389,1.72,51182,49295,-1887,-3.69,85614,84097,-1517,-1.77,CAMPOS DOS GOYTACAZES RJ,-21.7558619,-41.3326895,18,3191
RJ,CARDOSO MOREIRA,172,152,-20,-11.63,91,93,2,2.2,9,20,11,122.22,314,329,15,4.78,1071,837,-234,-21.85,1657,1431,-226,-13.64,CARDOSO MOREIRA RJ,-21.4894916,-41.6152776,18,3193
RJ,CARMO,120,105,-15,-12.5,468,442,-26,-5.56,82,105,23,28.05,508,505,-3,-0.59,2392,2069,-323,-13.5,3570,3226,-344,-9.64,CARMO RJ,-21.9341749,-42.6091737,18,3194
RJ,DUAS BARRAS,234,226,-8,-3.42,209,175,-34,-16.27,36,41,5,13.89,222,216,-6,-2.7,776,686,-90,-11.6,1477,1344,-133,-9.0,DUAS BARRAS RJ,-22.0522519,-42.5194705,18,3198
RJ,ITALVA,47,47,0,0.0,214,304,90,42.06,93,254,161,173.12,519,574,55,10.6,987,813,-174,-17.63,1860,1992,132,7.1,ITALVA RJ,-21.4214056,-41.6907956,18,3205
RJ,ITAOCARA,115,79,-36,-31.3,355,332,-23,-6.48,44,62,18,40.91,913,881,-32,-3.5,1794,1800,6,0.33,3221,3154,-67,-2.08,ITAOCARA RJ,-21.6725236,-42.0798658,18,3206
RJ,ITAPERUNA,578,511,-67,-11.59,3852,3462,-390,-10.12,1089,1397,308,28.28,5716,5474,-242,-4.23,10784,9894,-890,-8.25,22019,20738,-1281,-5.82,ITAPERUNA RJ,-21.2048,-41.88801,18,3207
RJ,LAJE DO MURIAE,102,102,0,0.0,162,170,8,4.94,0,1,1,0.0,69,69,0,0.0,797,864,67,8.41,1130,1206,76,6.73,LAJE DO MURIAE RJ,-21.2082595,-42.1226959,18,3210
RJ,MACUCO,40,34,-6,-15.0,300,311,11,3.67,48,75,27,56.25,299,249,-50,-16.72,920,871,-49,-5.33,1607,1540,-67,-4.17,MACUCO RJ,-21.9849747,-42.2539464,18,3212
RJ,MIRACEMA,194,180,-14,-7.22,584,595,11,1.88,159,182,23,14.47,939,900,-39,-4.15,2100,2135,35,1.67,3976,3992,16,0.4,MIRACEMA RJ,-21.4123651,-42.1965147,18,3219
RJ,NATIVIDADE,134,123,-11,-8.21,170,214,44,25.88,8,9,1,12.5,152,151,-1,-0.66,407,338,-69,-16.95,871,835,-36,-4.13,NATIVIDADE RJ,-21.040694,-41.9817534,18,3220
RJ,NOVA FRIBURGO,217,217,0,0.0,15432,14951,-481,-3.12,1069,882,-187,-17.49,12625,12637,12,0.1,21364,20253,-1111,-5.2,50707,48940,-1767,-3.48,NOVA FRIBURGO RJ,-22.3256726,-42.4773836,18,3223
RJ,PARATY,57,56,-1,-1.75,235,259,24,10.21,54,93,39,72.22,2025,1971,-54,-2.67,5974,5862,-112,-1.87,8345,8241,-104,-1.25,PARATY RJ,-23.2196461,-44.7154196,18,3227
RJ,PETROPOLIS,435,411,-24,-5.52,11583,11487,-96,-0.83,1803,1775,-28,-1.55,16483,15909,-574,-3.48,37862,34724,-3138,-8.29,68166,64306,-3860,-5.66,PETROPOLIS RJ,-22.5075743,-43.1785356,18,3229
RJ,PIRAI,239,192,-47,-19.67,2600,2561,-39,-1.5,122,102,-20,-16.39,1159,1194,35,3.02,4457,4476,19,0.43,8577,8525,-52,-0.61,PIRAI RJ,-22.6287489,-43.8981758,18,3231
RJ,PORCIUNCULA,112,97,-15,-13.39,261,221,-40,-15.33,2,2,0,0.0,400,398,-2,-0.5,1124,1186,62,5.52,1899,1904,5,0.26,PORCIUNCULA RJ,-20.9627278,-42.0405703,18,3232
RJ,QUISSAMA,126,122,-4,-3.17,204,233,29,14.22,39,38,-1,-2.56,363,373,10,2.75,2875,2265,-610,-21.22,3607,3031,-576,-15.97,QUISSAMA RJ,-22.107205,-41.4723411,18,3236
RJ,RESENDE,323,156,-167,-51.7,8469,8196,-273,-3.22,1640,1727,87,5.3,6299,6062,-237,-3.76,21267,20917,-350,-1.65,37998,37058,-940,-2.47,RESENDE RJ,-22.4683626,-44.4463494,18,3237
RJ,RIO BONITO,296,287,-9,-3.04,1627,1505,-122,-7.5,1526,157,-1369,-89.71,3225,2841,-384,-11.91,10323,9370,-953,-9.23,16997,14160,-2837,-16.69,RIO BONITO RJ,-22.7108378,-42.6271864,18,3238
RJ,RIO CLARO,419,384,-35,-8.35,53,52,-1,-1.89,6,15,9,150.0,335,331,-4,-1.19,1486,1458,-28,-1.88,2299,2240,-59,-2.57,RIO CLARO RJ,-22.7229997,-44.1359986,18,3239
RJ,RIO DAS FLORES,150,168,18,12.0,551,596,45,8.17,744,821,77,10.35,116,105,-11,-9.48,1027,989,-38,-3.7,2588,2679,91,3.52,RIO DAS FLORES RJ,-22.1683478,-43.5858689,18,3240
RJ,RIO DE JANEIRO,944,1287,343,36.33,161878,154504,-7374,-4.56,87166,84174,-2992,-3.43,373695,350714,-22981,-6.15,1574177,1483536,-90641,-5.76,2197860,2074215,-123645,-5.63,RIO DE JANEIRO RJ,-22.9110137,-43.2093727,18,3242
RJ,SANTA MARIA MADALENA,209,203,-6,-2.87,92,102,10,10.87,6,2,-4,-66.67,116,116,0,0.0,1060,800,-260,-24.53,1483,1223,-260,-17.53,SANTA MARIA MADALENA RJ,-21.9557957,-42.008283,18,3243
RJ,SANTO ANTONIO DE PADUA,185,168,-17,-9.19,1957,2044,87,4.45,112,125,13,11.61,1963,1846,-117,-5.96,3974,3737,-237,-5.96,8191,7920,-271,-3.31,SANTO ANTONIO DE PADUA RJ,-21.5389992,-42.1799978,18,3244
RJ,SAO FRANCISCO DE ITABAPOANA,656,569,-87,-13.26,158,120,-38,-24.05,25,11,-14,-56.0,957,899,-58,-6.06,1925,1827,-98,-5.09,3721,3426,-295,-7.93,SAO FRANCISCO DE ITABAPOANA RJ,-21.4743369,-41.1118362,18,3245
RJ,SAO FIDELIS,262,244,-18,-6.87,306,323,17,5.56,67,31,-36,-53.73,1196,1206,10,0.84,3068,3107,39,1.27,4899,4911,12,0.24,SAO FIDELIS RJ,-21.6482101,-41.7480548,18,3246
RJ,SAO JOSE DE UBA,50,77,27,54.0,54,45,-9,-16.67,79,10,-69,-87.34,123,145,22,17.89,779,953,174,22.34,1085,1230,145,13.36,SAO JOSE DE UBA RJ,-21.3595365,-41.9389905,18,3250
RJ,SAO JOSE DO VALE DO RIO PRETO,559,513,-46,-8.23,765,1053,288,37.65,67,30,-37,-55.22,1258,1079,-179,-14.23,1302,1266,-36,-2.76,3951,3941,-10,-0.25,SAO JOSE DO VALE DO RIO PRETO RJ,-22.1509994,-42.9239986,18,3251
RJ,SAO SEBASTIAO DO ALTO,131,131,0,0.0,34,9,-25,-73.53,0,0,0,0.0,118,114,-4,-3.39,957,786,-171,-17.87,1240,1040,-200,-16.13,SAO SEBASTIAO DO ALTO RJ,-21.9568272,-42.134815,18,3253
RJ,SILVA JARDIM,549,487,-62,-11.29,108,127,19,17.59,832,897,65,7.81,563,539,-24,-4.26,2015,2132,117,5.81,4067,4182,115,2.83,SILVA JARDIM RJ,-22.6509706,-42.3947353,18,3257
RJ,SUMIDOURO,210,202,-8,-3.81,540,476,-64,-11.85,0,0,0,0.0,379,393,14,3.69,890,858,-32,-3.6,2019,1929,-90,-4.46,SUMIDOURO RJ,-22.0498059,-42.6742601,18,3258
RJ,TERESOPOLIS,1651,1679,28,1.7,2909,2849,-60,-2.06,830,926,96,11.57,9530,9304,-226,-2.37,20568,20098,-470,-2.29,35488,34856,-632,-1.78,TERESOPOLIS RJ,-22.4164578,-42.975194,18,3260
RJ,TRAJANO DE MORAES,81,75,-6,-7.41,35,40,5,14.29,15,5,-10,-66.67,147,156,9,6.12,1241,860,-381,-30.7,1519,1136,-383,-25.21,TRAJANO DE MORAES RJ,-22.0637911,-42.0644414,18,3261
RJ,VALENCA,927,700,-227,-24.49,1339,1338,-1,-0.07,260,90,-170,-65.38,3193,3051,-142,-4.45,6170,5184,-986,-15.98,11889,10363,-1526,-12.84,VALENCA RJ,-22.2461028,-43.6996917,18,3263
RJ,VARRE-SAI,49,42,-7,-14.29,44,53,9,20.45,20,17,-3,-15.0,214,181,-33,-15.42,841,813,-28,-3.33,1168,1106,-62,-5.31,VARRE-SAI RJ,-20.9311337,-41.8677946,18,3264
RJ,VASSOURAS,400,343,-57,-14.25,559,569,10,1.79,69,112,43,62.32,1506,1505,-1,-0.07,5399,5461,62,1.15,7933,7990,57,0.72,VASSOURAS RJ,-22.4093928,-43.6609318,18,3265
SP,ADOLFO,313,276,-37,-11.82,39,42,3,7.69,102,137,35,34.31,85,102,17,20.0,408,418,10,2.45,947,975,28,2.96,ADOLFO SP,-21.2356597,-49.6441918,25,3268
SP,AGUAI,1401,1202,-199,-14.2,1904,1946,42,2.21,100,102,2,2.0,1405,1429,24,1.71,1963,2120,157,8.0,6773,6799,26,0.38,AGUAI SP,-22.0592036,-46.979384,25,3269
SP,AGUAS DE LINDOIA,53,53,0,0.0,709,654,-55,-7.76,31,39,8,25.81,856,833,-23,-2.69,2975,3304,329,11.06,4624,4883,259,5.6,AGUAS DE LINDOIA SP,-22.4718855,-46.6291034,25,3271
SP,AGUAS DE SANTA BARBARA,793,788,-5,-0.63,69,82,13,18.84,22,7,-15,-68.18,129,139,10,7.75,498,551,53,10.64,1511,1567,56,3.71,AGUAS DE SANTA BARBARA SP,-22.8821912,-49.2383956,25,3272
SP,AGUDOS,903,867,-36,-3.99,2100,2262,162,7.71,212,222,10,4.72,1416,1427,11,0.78,4403,4358,-45,-1.02,9034,9136,102,1.13,AGUDOS SP,-22.4719836,-48.9884476,25,3274
SP,ALTAIR,429,445,16,3.73,21,23,2,9.52,0,1,1,0.0,38,39,1,2.63,241,266,25,10.37,729,774,45,6.17,ALTAIR SP,-20.5238955,-49.0606135,25,3277
SP,ALTINOPOLIS,1509,1549,40,2.65,69,73,4,5.8,40,35,-5,-12.5,706,669,-37,-5.24,1405,1480,75,5.34,3729,3806,77,2.06,ALTINOPOLIS SP,-21.021364,-47.3712,25,3278
SP,ALTO ALEGRE,101,104,3,2.97,0,0,0,0.0,0,1,1,0.0,38,46,8,21.05,709,640,-69,-9.73,848,791,-57,-6.72,ALTO ALEGRE SP,-21.5820592,-50.1661976,25,3279
SP,ALVARO DE CARVALHO,99,86,-13,-13.13,5,2,-3,-60.0,0,0,0,0.0,43,43,0,0.0,219,208,-11,-5.02,366,339,-27,-7.38,ALVARO DE CARVALHO SP,-22.0787992,-49.7194861,25,3283
SP,ALVINLANDIA,81,70,-11,-13.58,20,18,-2,-10.0,11,0,-11,-100.0,22,22,0,0.0,200,188,-12,-6.0,334,298,-36,-10.78,ALVINLANDIA SP,-22.4431852,-49.7643596,25,3284
SP,AMERICO DE CAMPOS,78,65,-13,-16.67,35,30,-5,-14.29,0,1,1,0.0,102,73,-29,-28.43,386,372,-14,-3.63,601,541,-60,-9.98,AMERICO DE CAMPOS SP,-20.298476,-49.735904,25,3287
SP,AMPARO,1,1,0,0.0,0,0,0,0.0,3,4,1,33.33,12,11,-1,-8.33,316,314,-2,-0.63,332,330,-2,-0.6,AMPARO SP,-22.70111,-46.76444,25,3288
SP,ANALANDIA,305,297,-8,-2.62,191,209,18,9.42,4,3,-1,-25.0,154,172,18,11.69,385,357,-28,-7.27,1039,1038,-1,-0.1,ANALANDIA SP,-22.128917,-47.661939,25,3289
SP,ANDRADINA,515,666,151,29.32,4881,4880,-1,-0.02,556,593,37,6.65,3437,3421,-16,-0.47,6476,6536,60,0.93,15865,16096,231,1.46,ANDRADINA SP,-20.896505,-51.3742765,25,3290
SP,ANGATUBA,1568,2029,461,29.4,999,973,-26,-2.6,355,288,-67,-18.87,907,835,-72,-7.94,1434,1526,92,6.42,5263,5651,388,7.37,ANGATUBA SP,-23.4938938,-48.4110675,25,3291
SP,ANHEMBI,511,435,-76,-14.87,110,89,-21,-19.09,9,7,-2,-22.22,64,63,-1,-1.56,375,364,-11,-2.93,1069,958,-111,-10.38,ANHEMBI SP,-22.7891096,-48.1316776,25,3292
SP,APIAI,1112,1139,27,2.43,901,937,36,4.0,148,240,92,62.16,1030,1015,-15,-1.46,1577,1592,15,0.95,4768,4923,155,3.25,APIAI SP,-24.5076527,-48.8461582,25,3296
SP,ARACARIGUAMA,9,10,1,11.11,3834,3928,94,2.45,590,188,-402,-68.14,1782,1814,32,1.8,3478,4035,557,16.01,9693,9975,282,2.91,ARACARIGUAMA SP,-23.4388277,-47.0613084,25,3297
SP,ARACATUBA,801,792,-9,-1.12,7996,8663,667,8.34,2139,1881,-258,-12.06,14254,14671,417,2.93,26515,25888,-627,-2.36,51705,51895,190,0.37,ARACATUBA SP,-21.207992,-50.4390225,25,3298
SP,ARANDU,785,786,1,0.13,6,64,58,966.67,5,12,7,140.0,111,106,-5,-4.5,462,461,-1,-0.22,1369,1429,60,4.38,ARANDU SP,-23.1345103,-49.0545651,25,3301
SP,ARAPEI,60,57,-3,-5.0,4,3,-1,-25.0,0,0,0,0.0,56,44,-12,-21.43,267,249,-18,-6.74,387,353,-34,-8.79,ARAPEI SP,-22.6738889,-44.4477778,25,3302
SP,ARARAQUARA,1146,1000,-146,-12.74,15582,16707,1125,7.22,3279,3373,94,2.87,15975,15658,-317,-1.98,38426,37098,-1328,-3.46,74408,73836,-572,-0.77,ARARAQUARA SP,-21.7886713,-48.1773096,25,3303
SP,ARARAS,1384,1196,-188,-13.58,11951,12503,552,4.62,1229,1215,-14,-1.14,7077,6884,-193,-2.73,16861,15543,-1318,-7.82,38502,37341,-1161,-3.02,ARARAS SP,-22.3569477,-47.3838889,25,3304
SP,AREALVA,348,336,-12,-3.45,363,470,107,29.48,22,23,1,4.55,177,192,15,8.47,611,551,-60,-9.82,1521,1572,51,3.35,AREALVA SP,-22.0301906,-48.9111936,25,3306
SP,AREIAS,204,185,-19,-9.31,5,5,0,0.0,0,0,0,0.0,53,58,5,9.43,343,370,27,7.87,605,618,13,2.15,AREIAS SP,-22.5800929,-44.6975127,25,3307
SP,AREIOPOLIS,344,372,28,8.14,107,78,-29,-27.1,13,7,-6,-46.15,239,252,13,5.44,539,509,-30,-5.57,1242,1218,-24,-1.93,AREIOPOLIS SP,-22.6758064,-48.6673653,25,3308
SP,ARTUR NOGUEIRA,800,837,37,4.62,2932,3024,92,3.14,220,179,-41,-18.64,2122,2294,172,8.11,3015,3069,54,1.79,9089,9403,314,3.45,ARTUR NOGUEIRA SP,-22.572737,-47.172679,25,3310
SP,ASPASIA,21,17,-4,-19.05,2,2,0,0.0,0,0,0,0.0,13,16,3,23.08,183,170,-13,-7.1,219,205,-14,-6.39,ASPASIA SP,-20.1596604,-50.7279226,25,3312
SP,ASSIS,279,267,-12,-4.3,1870,1897,27,1.44,880,1493,613,69.66,7876,7601,-275,-3.49,10755,10580,-175,-1.63,21660,21838,178,0.82,ASSIS SP,-22.6620892,-50.420623,25,3313
SP,ATIBAIA,1785,1626,-159,-8.91,10172,10350,178,1.75,1175,1220,45,3.83,9377,9479,102,1.09,18316,17005,-1311,-7.16,40825,39680,-1145,-2.8,ATIBAIA SP,-23.1177393,-46.5547861,25,3314
SP,AURIFLAMA,161,177,16,9.94,755,613,-142,-18.81,83,113,30,36.14,743,730,-13,-1.75,833,791,-42,-5.04,2575,2424,-151,-5.86,AURIFLAMA SP,-20.6840418,-50.5554616,25,3315
SP,AVAI,487,355,-132,-27.1,75,118,43,57.33,0,0,0,0.0,121,157,36,29.75,576,581,5,0.87,1259,1211,-48,-3.81,AVAI SP,-22.1564662,-49.3316395,25,3316
SP,AVANHANDAVA,93,56,-37,-39.78,899,969,70,7.79,10,10,0,0.0,256,273,17,6.64,505,496,-9,-1.78,1763,1804,41,2.33,AVANHANDAVA SP,-21.4603331,-49.9465156,25,3317
SP,AVARE,2181,2170,-11,-0.5,4183,4655,472,11.28,919,434,-485,-52.77,6044,6048,4,0.07,8771,8343,-428,-4.88,22098,21650,-448,-2.03,AVARE SP,-23.1045215,-48.9259103,25,3318
SP,BANANAL,220,192,-28,-12.73,333,327,-6,-1.8,124,116,-8,-6.45,190,198,8,4.21,785,728,-57,-7.26,1652,1561,-91,-5.51,BANANAL SP,-22.6828195,-44.3221095,25,3322
SP,BARAO DE ANTONINA,53,46,-7,-13.21,203,152,-51,-25.12,0,0,0,0.0,68,64,-4,-5.88,260,277,17,6.54,584,539,-45,-7.71,BARAO DE ANTONINA SP,-23.6295651,-49.5632104,25,3323
SP,BARBOSA,51,64,13,25.49,81,94,13,16.05,65,8,-57,-87.69,55,62,7,12.73,376,373,-3,-0.8,628,601,-27,-4.3,BARBOSA SP,-21.265661,-49.951816,25,3324
SP,BARIRI,828,811,-17,-2.05,3340,3241,-99,-2.96,87,170,83,95.4,1963,1942,-21,-1.07,2604,2493,-111,-4.26,8822,8657,-165,-1.87,BARIRI SP,-22.0746355,-48.7394852,25,3325
SP,BARRA DO CHAPEU,467,420,-47,-10.06,5,7,2,40.0,3,4,1,33.33,43,35,-8,-18.6,219,218,-1,-0.46,737,684,-53,-7.19,BARRA DO CHAPEU SP,-24.472203,-49.023784,25,3327
SP,BARRA DO TURVO,46,44,-2,-4.35,16,20,4,25.0,21,15,-6,-28.57,110,123,13,11.82,496,477,-19,-3.83,689,679,-10,-1.45,BARRA DO TURVO SP,-24.756421,-48.5056942,25,3328
SP,BARRETOS,1874,1895,21,1.12,6156,6475,319,5.18,1292,1208,-84,-6.5,7044,6921,-123,-1.75,15867,17026,1159,7.3,32233,33525,1292,4.01,BARRETOS SP,-20.5531437,-48.5697509,25,3329
SP,BARRINHA,63,70,7,11.11,185,392,207,111.89,845,975,130,15.38,1191,1215,24,2.02,1610,1516,-94,-5.84,3894,4168,274,7.04,BARRINHA SP,-21.1898849,-48.1550642,25,3330
SP,BASTOS,2840,2753,-87,-3.06,1357,1273,-84,-6.19,92,67,-25,-27.17,1058,1047,-11,-1.04,1865,1820,-45,-2.41,7212,6960,-252,-3.49,BASTOS SP,-21.9222474,-50.7317727,25,3332
SP,BATATAIS,754,735,-19,-2.52,5409,5540,131,2.42,408,438,30,7.35,3492,3463,-29,-0.83,5569,5359,-210,-3.77,15632,15535,-97,-0.62,BATATAIS SP,-20.892867,-47.592149,25,3333
SP,BAURU,766,710,-56,-7.31,14333,14048,-285,-1.99,14657,15466,809,5.52,27844,27514,-330,-1.19,66343,66560,217,0.33,123943,124298,355,0.29,BAURU SP,-22.3218102,-49.0705863,25,3334
SP,BEBEDOURO,8299,6116,-2183,-26.3,2842,2542,-300,-10.56,737,762,25,3.39,7100,7333,233,3.28,9590,9587,-3,-0.03,28568,26340,-2228,-7.8,BEBEDOURO SP,-20.949077,-48.479083,25,3335
SP,BERNARDINO DE CAMPOS,199,254,55,27.64,916,1016,100,10.92,10,11,1,10.0,290,303,13,4.48,1151,874,-277,-24.07,2566,2458,-108,-4.21,BERNARDINO DE CAMPOS SP,-23.0140216,-49.4760724,25,3337
SP,BERTIOGA,18,17,-1,-5.56,174,173,-1,-0.57,441,479,38,8.62,3720,3920,200,5.38,9126,8797,-329,-3.61,13479,13386,-93,-0.69,BERTIOGA SP,-23.848568,-46.139586,25,3338
SP,BILAC,66,60,-6,-9.09,414,472,58,14.01,9,12,3,33.33,412,413,1,0.24,556,532,-24,-4.32,1457,1489,32,2.2,BILAC SP,-21.403962,-50.47464,25,3339
SP,BIRIGUI,523,503,-20,-3.82,11913,11171,-742,-6.23,440,485,45,10.23,7018,6865,-153,-2.18,9945,9830,-115,-1.16,29839,28854,-985,-3.3,BIRIGUI SP,-21.2908491,-50.34144,25,3340
SP,BOA ESPERANCA DO SUL,872,936,64,7.34,356,362,6,1.69,38,28,-10,-26.32,328,333,5,1.52,1037,1015,-22,-2.12,2631,2674,43,1.63,BOA ESPERANCA DO SUL SP,-21.9930206,-48.3917372,25,3342
SP,BOCAINA,0,0,0,0.0,0,1,1,0.0,0,0,0,0.0,10,10,0,0.0,321,158,-163,-50.78,331,169,-162,-48.94,BOCAINA SP,-22.1421831,-48.522276,25,3343
SP,BOFETE,661,787,126,19.06,193,182,-11,-5.7,19,6,-13,-68.42,230,225,-5,-2.17,828,974,146,17.63,1931,2174,243,12.58,BOFETE SP,-23.1019554,-48.2610535,25,3344
SP,BOM SUCESSO DE ITARARE,215,127,-88,-40.93,73,71,-2,-2.74,6,4,-2,-33.33,56,70,14,25.0,295,262,-33,-11.19,645,534,-111,-17.21,BOM SUCESSO DE ITARARE SP,-24.3190016,-49.1446207,25,3347
SP,BORACEIA,244,245,1,0.41,572,529,-43,-7.52,6,5,-1,-16.67,309,342,33,10.68,281,332,51,18.15,1412,1453,41,2.9,BORACEIA SP,-22.195355,-48.7801925,25,3349
SP,BORBOREMA,6,2,-4,-66.67,0,0,0,0.0,9,10,1,11.11,8,4,-4,-50.0,276,300,24,8.7,299,316,17,5.69,BORBOREMA SP,-21.6212706,-49.074135,25,3350
SP,BOREBI,375,350,-25,-6.67,117,111,-6,-5.13,3,0,-3,-100.0,58,36,-22,-37.93,214,206,-8,-3.74,767,703,-64,-8.34,BOREBI SP,-22.5700178,-48.9714871,25,3351
SP,BOTUCATU,2981,2810,-171,-5.74,10662,9857,-805,-7.55,1062,1140,78,7.34,8072,8082,10,0.12,19127,19027,-100,-0.52,41904,40916,-988,-2.36,BOTUCATU SP,-22.8879628,-48.4410712,25,3352
SP,BRAGANCA PAULISTA,1702,1575,-127,-7.46,11969,12124,155,1.3,969,1227,258,26.63,10346,10091,-255,-2.46,19751,20037,286,1.45,44737,45054,317,0.71,BRAGANCA PAULISTA SP,-22.9520235,-46.5418586,25,3353
SP,BROTAS,1380,1324,-56,-4.06,1414,1367,-47,-3.32,173,112,-61,-35.26,1344,1324,-20,-1.49,2730,2659,-71,-2.6,7041,6786,-255,-3.62,BROTAS SP,-22.2840884,-48.1267265,25,3357
SP,BURI,2139,2066,-73,-3.41,405,401,-4,-0.99,82,79,-3,-3.66,720,771,51,7.08,1593,1558,-35,-2.2,4939,4875,-64,-1.3,BURI SP,-23.79849,-48.598924,25,3358
SP,BURITAMA,124,121,-3,-2.42,1595,1625,30,1.88,71,76,5,7.04,639,615,-24,-3.76,1289,1182,-107,-8.3,3718,3619,-99,-2.66,BURITAMA SP,-21.0664017,-50.1448077,25,3359
SP,BURITIZAL,135,135,0,0.0,1209,1105,-104,-8.6,7,12,5,71.43,101,97,-4,-3.96,335,306,-29,-8.66,1787,1655,-132,-7.39,BURITIZAL SP,-20.1933264,-47.7097165,25,3360
SP,CABRALIA PAULISTA,220,308,88,40.0,177,170,-7,-3.95,5,8,3,60.0,131,112,-19,-14.5,278,272,-6,-2.16,811,870,59,7.27,CABRALIA PAULISTA SP,-22.4562909,-49.3385645,25,3361
SP,CACHOEIRA PAULISTA,208,176,-32,-15.38,350,327,-23,-6.57,282,234,-48,-17.02,901,881,-20,-2.22,3475,3293,-182,-5.24,5216,4911,-305,-5.85,CACHOEIRA PAULISTA SP,-22.666498,-45.015384,25,3364
SP,CACONDE,410,481,71,17.32,103,97,-6,-5.83,21,20,-1,-4.76,416,461,45,10.82,1052,1011,-41,-3.9,2002,2070,68,3.4,CACONDE SP,-21.5281123,-46.6434015,25,3365
SP,CAFELANDIA,445,436,-9,-2.02,1660,1606,-54,-3.25,46,34,-12,-26.09,569,537,-32,-5.62,1192,1121,-71,-5.96,3912,3734,-178,-4.55,CAFELANDIA SP,-21.8054355,-49.6030627,25,3366
SP,CAJATI,801,830,29,3.62,1218,1275,57,4.68,955,978,23,2.41,817,864,47,5.75,2866,2481,-385,-13.43,6657,6428,-229,-3.44,CAJATI SP,-24.7272376,-48.1077914,25,3371
SP,CAJOBI,353,369,16,4.53,101,89,-12,-11.88,2,3,1,50.0,260,238,-22,-8.46,777,798,21,2.7,1493,1497,4,0.27,CAJOBI SP,-20.8776238,-48.8106972,25,3372
SP,CAJURU,608,623,15,2.47,1333,1257,-76,-5.7,255,222,-33,-12.94,985,982,-3,-0.3,1897,1940,43,2.27,5078,5024,-54,-1.06,CAJURU SP,-21.2759978,-47.3046035,25,3373
SP,CAMPINA DO MONTE ALEGRE,192,196,4,2.08,124,118,-6,-4.84,1,2,1,100.0,101,121,20,19.8,420,306,-114,-27.14,838,743,-95,-11.34,CAMPINA DO MONTE ALEGRE SP,-23.5935653,-48.4801876,25,3374
SP,CAMPINAS,1403,1356,-47,-3.35,42920,42550,-370,-0.86,18309,18276,-33,-0.18,87997,84118,-3879,-4.41,251266,244037,-7229,-2.88,401895,390337,-11558,-2.88,CAMPINAS SP,-22.90556,-47.06083,25,3375
SP,CAMPOS DO JORDAO,25,23,-2,-8.0,732,708,-24,-3.28,242,223,-19,-7.85,2899,2738,-161,-5.55,9076,8485,-591,-6.51,12974,12177,-797,-6.14,CAMPOS DO JORDAO SP,-22.7395263,-45.5912829,25,3377
SP,CAMPOS NOVOS PAULISTA,215,210,-5,-2.33,78,96,18,23.08,2,11,9,450.0,105,120,15,14.29,311,298,-13,-4.18,711,735,24,3.38,CAMPOS NOVOS PAULISTA SP,-22.601952,-49.998726,25,3378
SP,CANANEIA,165,108,-57,-34.55,91,77,-14,-15.38,22,6,-16,-72.73,318,245,-73,-22.96,1002,1049,47,4.69,1598,1485,-113,-7.07,CANANEIA SP,-25.0104609,-47.9315628,25,3379
SP,CANDIDO MOTA,329,333,4,1.22,1658,1916,258,15.56,136,123,-13,-9.56,1738,1626,-112,-6.44,1928,1901,-27,-1.4,5789,5899,110,1.9,CANDIDO MOTA SP,-22.7434964,-50.38924,25,3381
SP,CANDIDO RODRIGUES,150,170,20,13.33,198,319,121,61.11,1,0,-1,-100.0,95,92,-3,-3.16,242,272,30,12.4,686,853,167,24.34,CANDIDO RODRIGUES SP,-21.3255615,-48.6308798,25,3382
SP,CAPAO BONITO,1705,1865,160,9.38,746,813,67,8.98,116,104,-12,-10.34,2179,2174,-5,-0.23,3381,3223,-158,-4.67,8127,8179,52,0.64,CAPAO BONITO SP,-24.0048759,-48.3489848,25,3384
SP,CAPELA DO ALTO,1395,1683,288,20.65,233,405,172,73.82,69,127,58,84.06,751,762,11,1.46,939,1000,61,6.5,3387,3977,590,17.42,CAPELA DO ALTO SP,-23.4704798,-47.7352309,25,3385
SP,CAPIVARI,365,396,31,8.49,6093,6087,-6,-0.1,217,243,26,11.98,2785,2720,-65,-2.33,5557,5158,-399,-7.18,15017,14604,-413,-2.75,CAPIVARI SP,-22.9999295,-47.5031066,25,3386
SP,CARDOSO,336,320,-16,-4.76,66,65,-1,-1.52,12,23,11,91.67,272,261,-11,-4.04,710,718,8,1.13,1396,1387,-9,-0.64,CARDOSO SP,-20.080447,-49.9139767,25,3389
SP,CASA BRANCA,2171,2198,27,1.24,918,1028,110,11.98,64,59,-5,-7.81,1406,1434,28,1.99,2162,2080,-82,-3.79,6721,6799,78,1.16,CASA BRANCA SP,-21.7743137,-47.0852175,25,3390
SP,CASSIA DOS COQUEIROS,179,185,6,3.35,4,10,6,150.0,1,1,0,0.0,38,45,7,18.42,251,258,7,2.79,473,499,26,5.5,CASSIA DOS COQUEIROS SP,-21.280082,-47.164327,25,3391
SP,CASTILHO,221,217,-4,-1.81,1118,1132,14,1.25,32,31,-1,-3.12,468,522,54,11.54,1159,1162,3,0.26,2998,3064,66,2.2,CASTILHO SP,-20.8695636,-51.4877792,25,3392
SP,CATANDUVA,822,635,-187,-22.75,9063,9168,105,1.16,1380,2584,1204,87.25,9027,9075,48,0.53,15766,18442,2676,16.97,36058,39904,3846,10.67,CATANDUVA SP,-21.1331035,-48.9712817,25,3393
SP,CERQUEIRA CESAR,766,899,133,17.36,1222,1272,50,4.09,14,8,-6,-42.86,818,796,-22,-2.69,1653,1684,31,1.88,4473,4659,186,4.16,CERQUEIRA CESAR SP,-23.0353135,-49.1650519,25,3396
SP,CESARIO LANGE,403,386,-17,-4.22,1008,1119,111,11.01,28,33,5,17.86,628,706,78,12.42,1540,1363,-177,-11.49,3607,3607,0,0.0,CESARIO LANGE SP,-23.226035,-47.954453,25,3398
SP,CLEMENTINA,68,52,-16,-23.53,67,256,189,282.09,2,1,-1,-50.0,213,138,-75,-35.21,551,438,-113,-20.51,901,885,-16,-1.78,CLEMENTINA SP,-21.5594631,-50.448624,25,3400
SP,COLINA,567,570,3,0.53,2451,2506,55,2.24,46,58,12,26.09,671,583,-88,-13.11,1735,2191,456,26.28,5470,5908,438,8.01,COLINA SP,-20.711443,-48.53867,25,3401
SP,CONCHAL,785,730,-55,-7.01,1805,2259,454,25.15,44,54,10,22.73,1586,1378,-208,-13.11,1651,1649,-2,-0.12,5871,6070,199,3.39,CONCHAL SP,-22.337512,-47.172927,25,3403
SP,CONCHAS,358,396,38,10.61,845,716,-129,-15.27,19,21,2,10.53,587,591,4,0.68,1534,1418,-116,-7.56,3343,3142,-201,-6.01,CONCHAS SP,-23.0133538,-48.0077595,25,3404
SP,CORDEIROPOLIS,322,291,-31,-9.63,4974,5266,292,5.87,103,103,0,0.0,1551,1686,135,8.7,3098,3012,-86,-2.78,10048,10358,310,3.09,CORDEIROPOLIS SP,-22.4768324,-47.4550551,25,3405
SP,CORONEL MACEDO,164,164,0,0.0,196,204,8,4.08,107,127,20,18.69,54,53,-1,-1.85,317,311,-6,-1.89,838,859,21,2.51,CORONEL MACEDO SP,-23.6304001,-49.313234,25,3407
SP,CORUMBATAI,235,219,-16,-6.81,148,227,79,53.38,6,9,3,50.0,313,319,6,1.92,395,394,-1,-0.25,1097,1168,71,6.47,CORUMBATAI SP,-22.2210521,-47.6249638,25,3408
SP,COSMORAMA,183,175,-8,-4.37,1396,1698,302,21.63,20,28,8,40.0,134,158,24,17.91,461,516,55,11.93,2194,2575,381,17.37,COSMORAMA SP,-20.4782664,-49.7765649,25,3410
SP,CRUZALIA,73,65,-8,-10.96,29,30,1,3.45,4,11,7,175.0,64,65,1,1.56,216,205,-11,-5.09,386,376,-10,-2.59,CRUZALIA SP,-22.7434438,-50.7911037,25,3414
SP,CRUZEIRO,128,115,-13,-10.16,6887,7332,445,6.46,380,408,28,7.37,3316,3322,6,0.18,5679,6162,483,8.51,16390,17339,949,5.79,CRUZEIRO SP,-22.5783685,-44.9642044,25,3415
SP,CUNHA,492,463,-29,-5.89,172,172,0,0.0,31,25,-6,-19.35,489,478,-11,-2.25,1101,1064,-37,-3.36,2285,2202,-83,-3.63,CUNHA SP,-23.07753,-44.9567436,25,3417
SP,DESCALVADO,1222,1298,76,6.22,3044,3161,117,3.84,657,893,236,35.92,1712,1706,-6,-0.35,2953,2983,30,1.02,9588,10041,453,4.72,DESCALVADO SP,-21.9090404,-47.6203241,25,3418
SP,DIVINOLANDIA,165,175,10,6.06,143,104,-39,-27.27,16,18,2,12.5,681,656,-25,-3.67,1261,1283,22,1.74,2266,2236,-30,-1.32,DIVINOLANDIA SP,-21.6604584,-46.7371151,25,3421
SP,DOIS CORREGOS,488,512,24,4.92,1442,1493,51,3.54,47,57,10,21.28,957,962,5,0.52,2200,2146,-54,-2.45,5134,5170,36,0.7,DOIS CORREGOS SP,-22.3697554,-48.3845315,25,3423
SP,DOLCINOPOLIS,17,17,0,0.0,48,44,-4,-8.33,0,0,0,0.0,22,19,-3,-13.64,179,177,-2,-1.12,266,257,-9,-3.38,DOLCINOPOLIS SP,-20.1230736,-50.513261,25,3424
SP,DOURADO,296,324,28,9.46,1079,1329,250,23.17,13,22,9,69.23,275,299,24,8.73,1097,1035,-62,-5.65,2760,3009,249,9.02,DOURADO SP,-22.1124638,-48.3151079,25,3425
SP,DRACENA,203,200,-3,-1.48,1434,1440,6,0.42,782,859,77,9.85,3526,3429,-97,-2.75,5881,6672,791,13.45,11826,12600,774,6.54,DRACENA SP,-21.4835523,-51.5334408,25,3426
SP,DUARTINA,225,233,8,3.56,530,377,-153,-28.87,131,149,18,13.74,490,471,-19,-3.88,955,964,9,0.94,2331,2194,-137,-5.88,DUARTINA SP,-22.414562,-49.408355,25,3427
SP,DUMONT,323,503,180,55.73,910,768,-142,-15.6,42,46,4,9.52,283,263,-20,-7.07,528,482,-46,-8.71,2086,2062,-24,-1.15,DUMONT SP,-21.2391417,-47.9747665,25,3428
SP,ECHAPORA,234,215,-19,-8.12,78,79,1,1.28,7,10,3,42.86,169,202,33,19.53,334,371,37,11.08,822,877,55,6.69,ECHAPORA SP,-22.4325855,-50.2037693,25,3429
SP,ELDORADO,854,1042,188,22.01,109,102,-7,-6.42,9,9,0,0.0,246,241,-5,-2.03,803,826,23,2.86,2021,2220,199,9.85,ELDORADO SP,-24.522583,-48.1093489,25,3430
SP,ELIAS FAUSTO,260,260,0,0.0,3047,3368,321,10.53,92,297,205,222.83,582,548,-34,-5.84,1110,1119,9,0.81,5091,5592,501,9.84,ELIAS FAUSTO SP,-23.0416538,-47.3718002,25,3431
SP,ENGENHEIRO COELHO,617,481,-136,-22.04,1104,1223,119,10.78,7,10,3,42.86,689,647,-42,-6.1,2353,2153,-200,-8.5,4770,4514,-256,-5.37,ENGENHEIRO COELHO SP,-22.4896659,-47.2119005,25,3437
SP,ESPIRITO SANTO DO PINHAL,1180,1114,-66,-5.59,4795,5421,626,13.06,193,230,37,19.17,1907,2014,107,5.61,3534,3486,-48,-1.36,11609,12265,656,5.65,ESPIRITO SANTO DO PINHAL SP,-22.190871,-46.74767,25,3438
SP,ESPIRITO SANTO DO TURVO,184,230,46,25.0,2,2,0,0.0,4,0,-4,-100.0,67,82,15,22.39,290,268,-22,-7.59,547,582,35,6.4,ESPIRITO SANTO DO TURVO SP,-22.6939723,-49.4295067,25,3439
SP,EUCLIDES DA CUNHA PAULISTA,100,125,25,25.0,23,7,-16,-69.57,47,1,-46,-97.87,100,104,4,4.0,473,456,-17,-3.59,743,693,-50,-6.73,EUCLIDES DA CUNHA PAULISTA SP,-22.55452,-52.592779,25,3442
SP,FARTURA,412,469,57,13.83,1355,1378,23,1.7,45,37,-8,-17.78,622,575,-47,-7.56,1299,1302,3,0.23,3733,3761,28,0.75,FARTURA SP,-23.390039,-49.5109023,25,3443
SP,FERNANDOPOLIS,472,572,100,21.19,3208,3091,-117,-3.65,838,835,-3,-0.36,5161,4920,-241,-4.67,6778,7004,226,3.33,16457,16422,-35,-0.21,FERNANDOPOLIS SP,-20.2825647,-50.2500762,25,3444
SP,FERNANDO PRESTES,253,250,-3,-1.19,279,323,44,15.77,13,17,4,30.77,281,282,1,0.36,541,546,5,0.92,1367,1418,51,3.73,FERNANDO PRESTES SP,-21.266061,-48.687384,25,3445
SP,FERNAO,87,101,14,16.09,20,30,10,50.0,0,0,0,0.0,52,45,-7,-13.46,170,165,-5,-2.94,329,341,12,3.65,FERNAO SP,-22.3595388,-49.5209504,25,3446
SP,FLORA RICA,55,47,-8,-14.55,1,1,0,0.0,0,0,0,0.0,11,11,0,0.0,210,174,-36,-17.14,277,233,-44,-15.88,FLORA RICA SP,-21.6760063,-51.3804532,25,3448
SP,FLOREAL,49,34,-15,-30.61,88,86,-2,-2.27,14,17,3,21.43,79,78,-1,-1.27,218,220,2,0.92,448,435,-13,-2.9,FLOREAL SP,-20.6767063,-50.1455638,25,3449
SP,FLORIDA PAULISTA,172,178,6,3.49,261,220,-41,-15.71,42,37,-5,-11.9,293,318,25,8.53,590,586,-4,-0.68,1358,1339,-19,-1.4,FLORIDA PAULISTA SP,-21.614061,-51.1729548,25,3450
SP,FRANCA,1071,1110,39,3.64,24265,19559,-4706,-19.39,2804,2582,-222,-7.92,24221,25238,1017,4.2,32443,31989,-454,-1.4,84804,80478,-4326,-5.1,FRANCA SP,-20.5299482,-47.4676216,25,3452
SP,GABRIEL MONTEIRO,83,103,20,24.1,439,413,-26,-5.92,1,7,6,600.0,91,113,22,24.18,296,291,-5,-1.69,910,927,17,1.87,GABRIEL MONTEIRO SP,-21.5299436,-50.5533059,25,3455
SP,GALIA,326,318,-8,-2.45,302,377,75,24.83,21,18,-3,-14.29,170,148,-22,-12.94,488,526,38,7.79,1307,1387,80,6.12,GALIA SP,-22.2936976,-49.5516228,25,3456
SP,GARCA,1201,1179,-22,-1.83,2555,2749,194,7.59,188,238,50,26.6,2394,2298,-96,-4.01,3813,3870,57,1.49,10151,10334,183,1.8,GARCA SP,-22.2125766,-49.6547994,25,3457
SP,GENERAL SALGADO,326,318,-8,-2.45,150,154,4,2.67,18,16,-2,-11.11,316,307,-9,-2.85,764,680,-84,-10.99,1574,1475,-99,-6.29,GENERAL SALGADO SP,-20.6488139,-50.3608101,25,3460
SP,GETULINA,589,511,-78,-13.24,33,29,-4,-12.12,13,7,-6,-46.15,152,139,-13,-8.55,452,478,26,5.75,1239,1164,-75,-6.05,GETULINA SP,-21.7988557,-49.9288096,25,3461
SP,GLICERIO,193,205,12,6.22,269,249,-20,-7.43,2,2,0,0.0,60,50,-10,-16.67,353,341,-12,-3.4,877,847,-30,-3.42,GLICERIO SP,-21.3814805,-50.2100452,25,3462
SP,GUAICARA,311,278,-33,-10.61,428,467,39,9.11,44,34,-10,-22.73,199,223,24,12.06,569,528,-41,-7.21,1551,1530,-21,-1.35,GUAICARA SP,-21.6213012,-49.7962941,25,3463
SP,GUAIMBE,194,258,64,32.99,23,15,-8,-34.78,0,5,5,0.0,78,72,-6,-7.69,257,273,16,6.23,552,623,71,12.86,GUAIMBE SP,-21.909072,-49.89861,25,3464
SP,GUAIRA,2649,2615,-34,-1.28,7610,7521,-89,-1.17,63,60,-3,-4.76,1722,1830,108,6.27,2985,2991,6,0.2,15029,15017,-12,-0.08,GUAIRA SP,-20.3245873,-48.3148818,25,3465
SP,GUAPIARA,444,340,-104,-23.42,303,289,-14,-4.62,2,2,0,0.0,413,377,-36,-8.72,879,951,72,8.19,2041,1959,-82,-4.02,GUAPIARA SP,-24.18921,-48.529549,25,3467
SP,GUARA,131,121,-10,-7.63,387,514,127,32.82,193,62,-131,-67.88,915,836,-79,-8.63,1382,1386,4,0.29,3008,2919,-89,-2.96,GUARA SP,-20.4290496,-47.8250067,25,3468
SP,GUARACAI,308,240,-68,-22.08,215,207,-8,-3.72,0,1,1,0.0,256,241,-15,-5.86,580,531,-49,-8.45,1359,1220,-139,-10.23,GUARACAI SP,-21.0322387,-51.2100464,25,3469
SP,GUARACI,267,251,-16,-5.99,1079,1193,114,10.57,4,26,22,550.0,256,252,-4,-1.56,851,848,-3,-0.35,2457,2570,113,4.6,GUARACI SP,-20.4976771,-48.9452074,25,3470
SP,GUARANTA,299,294,-5,-1.67,302,267,-35,-11.59,1,1,0,0.0,117,105,-12,-10.26,451,448,-3,-0.67,1170,1115,-55,-4.7,GUARANTA SP,-21.8950705,-49.590107,25,3472
SP,GUARARAPES,908,978,70,7.71,2125,2080,-45,-2.12,159,191,32,20.13,1200,1273,73,6.08,2220,2272,52,2.34,6612,6794,182,2.75,GUARARAPES SP,-21.2542739,-50.6440083,25,3473
SP,GUARAREMA,332,300,-32,-9.64,2851,2841,-10,-0.35,79,141,62,78.48,1321,1154,-167,-12.64,3351,2863,-488,-14.56,7934,7299,-635,-8.0,GUARAREMA SP,-23.4133724,-46.0379249,25,3474
SP,GUARATINGUETA,578,534,-44,-7.61,5318,5350,32,0.6,2356,1846,-510,-21.65,7379,7075,-304,-4.12,15605,14677,-928,-5.95,31236,29482,-1754,-5.62,GUARATINGUETA SP,-22.8057839,-45.1908926,25,3475
SP,GUAREI,730,760,30,4.11,568,603,35,6.16,11,31,20,181.82,292,337,45,15.41,738,760,22,2.98,2339,2491,152,6.5,GUAREI SP,-23.3718195,-48.184685,25,3476
SP,GUARIBA,144,208,64,44.44,2844,2830,-14,-0.49,365,380,15,4.11,1440,1488,48,3.33,2431,2408,-23,-0.95,7224,7314,90,1.25,GUARIBA SP,-21.35938,-48.23158,25,3477
SP,GUATAPARA,209,184,-25,-11.96,188,86,-102,-54.26,118,67,-51,-43.22,220,228,8,3.64,799,865,66,8.26,1534,1430,-104,-6.78,GUATAPARA SP,-21.496092,-48.0360685,25,3480
SP,GUZOLANDIA,176,176,0,0.0,118,70,-48,-40.68,2,6,4,200.0,29,59,30,103.45,280,244,-36,-12.86,605,555,-50,-8.26,GUZOLANDIA SP,-20.6491637,-50.6622974,25,3481
SP,HERCULANDIA,323,330,7,2.17,265,282,17,6.42,3,1,-2,-66.67,205,216,11,5.37,447,467,20,4.47,1243,1296,53,4.26,HERCULANDIA SP,-22.004508,-50.3862746,25,3482
SP,IACANGA,336,264,-72,-21.43,1509,1538,29,1.92,4,9,5,125.0,407,476,69,16.95,725,715,-10,-1.38,2981,3002,21,0.7,IACANGA SP,-21.8928341,-49.0226082,25,3485
SP,IACRI,240,255,15,6.25,102,130,28,27.45,57,98,41,71.93,171,233,62,36.26,363,335,-28,-7.71,933,1051,118,12.65,IACRI SP,-21.8583385,-50.6892931,25,3486
SP,IARAS,674,708,34,5.04,51,50,-1,-1.96,0,0,0,0.0,117,111,-6,-5.13,892,898,6,0.67,1734,1767,33,1.9,IARAS SP,-22.8742567,-49.1593923,25,3487
SP,IBIRA,185,153,-32,-17.3,514,568,54,10.51,121,157,36,29.75,443,417,-26,-5.87,746,718,-28,-3.75,2009,2013,4,0.2,IBIRA SP,-21.0815104,-49.2424619,25,3489
SP,IBIRAREMA,90,92,2,2.22,129,328,199,154.26,3,2,-1,-33.33,149,132,-17,-11.41,350,285,-65,-18.57,721,839,118,16.37,IBIRAREMA SP,-22.8131812,-50.0720477,25,3490
SP,IBITINGA,533,536,3,0.56,7103,7238,135,1.9,293,299,6,2.05,3512,3791,279,7.94,3875,3909,34,0.88,15316,15773,457,2.98,IBITINGA SP,-21.75623,-48.831903,25,3491
SP,IBIUNA,3160,3353,193,6.11,2345,2515,170,7.25,231,289,58,25.11,3673,3602,-71,-1.93,4730,4637,-93,-1.97,14139,14396,257,1.82,IBIUNA SP,-23.6544825,-47.220856,25,3492
SP,ICEM,93,111,18,19.35,139,134,-5,-3.6,2,3,1,50.0,139,124,-15,-10.79,592,621,29,4.9,965,993,28,2.9,ICEM SP,-20.3413103,-49.1970982,25,3493
SP,IEPE,157,149,-8,-5.1,81,72,-9,-11.11,0,0,0,0.0,262,269,7,2.67,562,610,48,8.54,1062,1100,38,3.58,IEPE SP,-22.660165,-51.077881,25,3494
SP,IGARAPAVA,253,348,95,37.55,1753,1785,32,1.83,197,154,-43,-21.83,1419,1474,55,3.88,2199,2044,-155,-7.05,5821,5805,-16,-0.27,IGARAPAVA SP,-20.0411748,-47.7476682,25,3496
SP,IGARATA,103,93,-10,-9.71,358,347,-11,-3.07,15,32,17,113.33,302,290,-12,-3.97,907,865,-42,-4.63,1685,1627,-58,-3.44,IGARATA SP,-23.2063475,-46.156934,25,3497
SP,IGUAPE,169,163,-6,-3.55,170,167,-3,-1.76,33,24,-9,-27.27,834,855,21,2.52,1585,1602,17,1.07,2791,2811,20,0.72,IGUAPE SP,-24.7042692,-47.5563733,25,3498
SP,ILHA SOLTEIRA,135,155,20,14.81,412,421,9,2.18,77,44,-33,-42.86,1173,1187,14,1.19,3218,3199,-19,-0.59,5015,5006,-9,-0.18,ILHA SOLTEIRA SP,-20.4281001,-51.3410871,25,3501
SP,INDAIATUBA,641,703,62,9.67,25955,25905,-50,-0.19,3793,3606,-187,-4.93,14764,14729,-35,-0.24,31650,32426,776,2.45,76803,77369,566,0.74,INDAIATUBA SP,-23.09028,-47.21806,25,3502
SP,INDIAPORA,78,89,11,14.1,26,27,1,3.85,0,0,0,0.0,96,91,-5,-5.21,75,352,277,369.33,275,559,284,103.27,INDIAPORA SP,-19.9802644,-50.2906035,25,3504
SP,IPAUSSU,153,166,13,8.5,1581,1594,13,0.82,25,31,6,24.0,494,493,-1,-0.2,1247,1137,-110,-8.82,3500,3421,-79,-2.26,IPAUSSU SP,-23.0544285,-49.6264306,25,3506
SP,IPORANGA,31,34,3,9.68,65,6,-59,-90.77,6,10,4,66.67,79,65,-14,-17.72,389,369,-20,-5.14,570,484,-86,-15.09,IPORANGA SP,-24.5843214,-48.594028,25,3510
SP,IPUA,502,470,-32,-6.37,507,520,13,2.56,5,5,0,0.0,686,609,-77,-11.22,1040,1066,26,2.5,2740,2670,-70,-2.55,IPUA SP,-20.4441839,-48.012504,25,3511
SP,IRAPUA,237,194,-43,-18.14,147,135,-12,-8.16,14,18,4,28.57,228,251,23,10.09,412,401,-11,-2.67,1038,999,-39,-3.76,IRAPUA SP,-21.2791964,-49.4101967,25,3513
SP,IRAPURU,53,46,-7,-13.21,10,10,0,0.0,9,5,-4,-44.44,143,139,-4,-2.8,448,441,-7,-1.56,663,641,-22,-3.32,IRAPURU SP,-21.5691828,-51.3494606,25,3514
SP,ITABERA,776,806,30,3.87,428,430,2,0.47,37,30,-7,-18.92,665,675,10,1.5,911,890,-21,-2.31,2817,2831,14,0.5,ITABERA SP,-23.8621345,-49.1398926,25,3515
SP,ITAI,2073,2429,356,17.17,534,375,-159,-29.78,92,41,-51,-55.43,864,832,-32,-3.7,1533,1557,24,1.57,5096,5234,138,2.71,ITAI SP,-23.4172598,-49.0935788,25,3516
SP,ITAJOBI,352,419,67,19.03,1391,1494,103,7.4,30,27,-3,-10.0,801,875,74,9.24,974,993,19,1.95,3548,3808,260,7.33,ITAJOBI SP,-21.312294,-49.0596336,25,3517
SP,ITAJU,88,71,-17,-19.32,192,224,32,16.67,8,11,3,37.5,63,65,2,3.17,261,249,-12,-4.6,612,620,8,1.31,ITAJU SP,-21.9816841,-48.8046536,25,3518
SP,ITAPETININGA,5525,6300,775,14.03,8000,8487,487,6.09,1470,1225,-245,-16.67,8585,8812,227,2.64,12931,12464,-467,-3.61,36511,37288,777,2.13,ITAPETININGA SP,-23.588607,-48.048326,25,3522
SP,ITAPEVA,279,217,-62,-22.22,249,200,-49,-19.68,11,6,-5,-45.45,789,822,33,4.18,980,891,-89,-9.08,2308,2136,-172,-7.45,ITAPEVA SP,-23.9849105,-48.8803886,25,3523
SP,ITAPIRA,1116,656,-460,-41.22,9765,9657,-108,-1.11,1428,1308,-120,-8.4,3784,3735,-49,-1.29,8343,8016,-327,-3.92,24436,23372,-1064,-4.35,ITAPIRA SP,-22.436111,-46.821667,25,3525
SP,ITAPIRAPUA PAULISTA,229,211,-18,-7.86,1,1,0,0.0,0,3,3,0.0,89,86,-3,-3.37,249,239,-10,-4.02,568,540,-28,-4.93,ITAPIRAPUA PAULISTA SP,-24.5735083,-49.1703846,25,3526
SP,ITAPOLIS,1719,1332,-387,-22.51,3072,2936,-136,-4.43,48,61,13,27.08,2437,2301,-136,-5.58,2758,2843,85,3.08,10034,9473,-561,-5.59,ITAPOLIS SP,-21.5958368,-48.8122696,25,3527
SP,ITAPORANGA,4,5,1,25.0,778,850,72,9.25,17,17,0,0.0,481,449,-32,-6.65,1170,1110,-60,-5.13,2450,2431,-19,-0.78,ITAPORANGA SP,-23.7066252,-49.4895934,25,3528
SP,ITAPUI,204,204,0,0.0,2224,2442,218,9.8,2,31,29,1450.0,1330,1386,56,4.21,743,730,-13,-1.75,4503,4793,290,6.44,ITAPUI SP,-22.2346755,-48.7189744,25,3529
SP,ITAPURA,106,100,-6,-5.66,3,3,0,0.0,79,40,-39,-49.37,50,44,-6,-12.0,417,598,181,43.41,655,785,130,19.85,ITAPURA SP,-20.6435211,-51.5084479,25,3530
SP,ITARARE,625,589,-36,-5.76,1013,958,-55,-5.43,84,89,5,5.95,2885,2756,-129,-4.47,3758,3410,-348,-9.26,8365,7802,-563,-6.73,ITARARE SP,-24.1145368,-49.3352464,25,3532
SP,ITARIRI,291,275,-16,-5.5,85,92,7,8.24,12,8,-4,-33.33,476,438,-38,-7.98,736,840,104,14.13,1600,1653,53,3.31,ITARIRI SP,-24.2900711,-47.176151,25,3533
SP,ITATIBA,648,591,-57,-8.8,11561,11676,115,0.99,2236,2762,526,23.52,5559,5528,-31,-0.56,14589,14131,-458,-3.14,34593,34688,95,0.27,ITATIBA SP,-22.9965861,-46.8412042,25,3534
SP,ITATINGA,932,1005,73,7.83,462,454,-8,-1.73,9,9,0,0.0,603,590,-13,-2.16,1043,1055,12,1.15,3049,3113,64,2.1,ITATINGA SP,-23.1042417,-48.6134874,25,3535
SP,ITIRAPINA,1167,1138,-29,-2.49,1029,1216,187,18.17,9,11,2,22.22,412,435,23,5.58,1632,3597,1965,120.4,4249,6397,2148,50.55,ITIRAPINA SP,-22.2536514,-47.8212546,25,3536
SP,ITOBI,216,272,56,25.93,104,110,6,5.77,0,0,0,0.0,201,197,-4,-1.99,473,431,-42,-8.88,994,1010,16,1.61,ITOBI SP,-21.730853,-46.9743,25,3538
SP,ITUVERAVA,418,350,-68,-16.27,1055,1158,103,9.76,62,66,4,6.45,2092,2064,-28,-1.34,3841,3559,-282,-7.34,7468,7197,-271,-3.63,ITUVERAVA SP,-20.3366604,-47.7797924,25,3541
SP,JABORANDI,1737,2174,437,25.16,104,104,0,0.0,0,8,8,0.0,56,88,32,57.14,552,400,-152,-27.54,2449,2774,325,13.27,JABORANDI SP,-20.6921079,-48.4144076,25,3542
SP,JABOTICABAL,779,758,-21,-2.7,4594,4785,191,4.16,2821,3064,243,8.61,4444,4323,-121,-2.72,9446,9063,-383,-4.05,22084,21993,-91,-0.41,JABOTICABAL SP,-21.252037,-48.325223,25,3543
SP,JACUPIRANGA,951,923,-28,-2.94,428,472,44,10.28,15,6,-9,-60.0,669,584,-85,-12.71,1183,1328,145,12.26,3246,3313,67,2.06,JACUPIRANGA SP,-24.703773,-48.0060639,25,3546
SP,JAGUARIUNA,471,441,-30,-6.37,13217,13169,-48,-0.36,644,665,21,3.26,3839,3706,-133,-3.46,15825,15500,-325,-2.05,33996,33481,-515,-1.51,JAGUARIUNA SP,-22.70374,-46.985062,25,3547
SP,JALES,181,156,-25,-13.81,2128,2271,143,6.72,160,186,26,16.25,4146,4132,-14,-0.34,4882,4972,90,1.84,11497,11717,220,1.91,JALES SP,-20.2671767,-50.5492435,25,3548
SP,JAU,814,837,23,2.83,10013,8697,-1316,-13.14,1309,1266,-43,-3.28,9833,9697,-136,-1.38,15312,15415,103,0.67,37281,35912,-1369,-3.67,JAU SP,-22.293585,-48.559193,25,3553
SP,JERIQUARA,265,273,8,3.02,69,68,-1,-1.45,7,2,-5,-71.43,89,147,58,65.17,301,304,3,1.0,731,794,63,8.62,JERIQUARA SP,-20.3104773,-47.5915669,25,3554
SP,JOANOPOLIS,215,205,-10,-4.65,615,593,-22,-3.58,4,18,14,350.0,606,628,22,3.63,952,881,-71,-7.46,2392,2325,-67,-2.8,JOANOPOLIS SP,-22.930004,-46.275208,25,3555
SP,JOAO RAMALHO,208,202,-6,-2.88,4,3,-1,-25.0,0,0,0,0.0,53,51,-2,-3.77,269,246,-23,-8.55,534,502,-32,-5.99,JOAO RAMALHO SP,-22.2486157,-50.7677114,25,3556
SP,JOSE BONIFACIO,1148,845,-303,-26.39,3277,3090,-187,-5.71,314,403,89,28.34,2099,2041,-58,-2.76,2965,3000,35,1.18,9803,9379,-424,-4.33,JOSE BONIFACIO SP,-23.5641145,-46.43473669552859,25,3557
SP,JULIO MESQUITA,108,108,0,0.0,0,0,0,0.0,0,0,0,0.0,43,38,-5,-11.63,325,306,-19,-5.85,476,452,-24,-5.04,JULIO MESQUITA SP,-22.0099839,-49.7889446,25,3558
SP,JUMIRIM,96,108,12,12.5,880,1017,137,15.57,0,2,2,0.0,84,93,9,10.71,251,226,-25,-9.96,1311,1446,135,10.3,JUMIRIM SP,-23.0843839,-47.7882279,25,3559
SP,JUNDIAI,496,561,65,13.1,42127,43096,969,2.3,5161,5341,180,3.49,39249,37801,-1448,-3.69,81137,78467,-2670,-3.29,168170,165266,-2904,-1.73,JUNDIAI SP,-23.1887668,-46.884506,25,3560
SP,JUNQUEIROPOLIS,224,202,-22,-9.82,2038,1890,-148,-7.26,186,149,-37,-19.89,1161,1160,-1,-0.09,2010,1833,-177,-8.81,5619,5234,-385,-6.85,JUNQUEIROPOLIS SP,-21.5109531,-51.4351505,25,3561
SP,JUQUIA,496,488,-8,-1.61,224,213,-11,-4.91,10,16,6,60.0,441,456,15,3.4,1166,1027,-139,-11.92,2337,2200,-137,-5.86,JUQUIA SP,-24.3172209,-47.6355618,25,3562
SP,JUQUITIBA,53,51,-2,-3.77,356,390,34,9.55,208,287,79,37.98,1125,1093,-32,-2.84,2806,2578,-228,-8.13,4548,4399,-149,-3.28,JUQUITIBA SP,-23.932346,-47.0714217,25,3563
SP,LAGOINHA,169,154,-15,-8.88,38,38,0,0.0,0,0,0,0.0,122,123,1,0.82,381,358,-23,-6.04,710,673,-37,-5.21,LAGOINHA SP,-23.0898337,-45.1903825,25,3564
SP,LARANJAL PAULISTA,240,222,-18,-7.5,4679,5167,488,10.43,114,131,17,14.91,1374,1410,36,2.62,2864,2748,-116,-4.05,9271,9678,407,4.39,LARANJAL PAULISTA SP,-23.0509576,-47.8372975,25,3565
SP,LAVINIA,161,165,4,2.48,0,0,0,0.0,1,1,0,0.0,118,112,-6,-5.08,402,384,-18,-4.48,682,662,-20,-2.93,LAVINIA SP,-21.1665477,-51.0410539,25,3566
SP,LEME,509,523,14,2.75,7138,7057,-81,-1.13,767,622,-145,-18.9,5288,5216,-72,-1.36,8909,9968,1059,11.89,22611,23386,775,3.43,LEME SP,-22.1859721,-47.389764,25,3568
SP,LENCOIS PAULISTA,1821,1810,-11,-0.6,6793,7800,1007,14.82,1632,6096,4464,273.53,3889,3928,39,1.0,6574,6727,153,2.33,20709,26361,5652,27.29,LENCOIS PAULISTA SP,-22.6029897,-48.8031367,25,3569
SP,LIMEIRA,827,850,23,2.78,29997,30333,336,1.12,2552,2526,-26,-1.02,18553,17895,-658,-3.55,30740,30014,-726,-2.36,82669,81618,-1051,-1.27,LIMEIRA SP,-22.5615068,-47.401766,25,3570
SP,LINS,468,552,84,17.95,9091,10222,1131,12.44,428,422,-6,-1.4,4335,4269,-66,-1.52,10355,10043,-312,-3.01,24677,25508,831,3.37,LINS SP,-21.6741873,-49.7518932,25,3572
SP,LORENA,303,313,10,3.3,4342,4596,254,5.85,720,727,7,0.97,3703,3568,-135,-3.65,7649,8020,371,4.85,16717,17224,507,3.03,LORENA SP,-22.7367652,-45.1070876,25,3573
SP,LOURDES,32,35,3,9.38,1,1,0,0.0,0,0,0,0.0,15,14,-1,-6.67,202,198,-4,-1.98,250,248,-2,-0.8,LOURDES SP,-20.9672545,-50.224966,25,3574
SP,LUCIANOPOLIS,800,473,-327,-40.88,36,39,3,8.33,2,2,0,0.0,40,39,-1,-2.5,184,185,1,0.54,1062,738,-324,-30.51,LUCIANOPOLIS SP,-22.4310459,-49.5219241,25,3577
SP,LUIS ANTONIO,3772,3099,-673,-17.84,1297,1287,-10,-0.77,212,168,-44,-20.75,327,333,6,1.83,1400,1334,-66,-4.71,7008,6221,-787,-11.23,LUIS ANTONIO SP,-21.55,-47.78008333333334,25,3578
SP,LUIZIANIA,123,130,7,5.69,27,20,-7,-25.93,0,2,2,0.0,99,106,7,7.07,283,270,-13,-4.59,532,528,-4,-0.75,LUIZIANIA SP,-21.6763356,-50.3269863,25,3579
SP,LUPERCIO,115,161,46,40.0,159,154,-5,-3.14,1,1,0,0.0,52,51,-1,-1.92,239,231,-8,-3.35,566,598,32,5.65,LUPERCIO SP,-22.4145801,-49.8183516,25,3580
SP,LUTECIA,120,116,-4,-3.33,42,38,-4,-9.52,22,16,-6,-27.27,23,26,3,13.04,258,254,-4,-1.55,465,450,-15,-3.23,LUTECIA SP,-22.338378,-50.394007,25,3581
SP,MACATUBA,684,706,22,3.22,1435,1347,-88,-6.13,63,112,49,77.78,615,595,-20,-3.25,1091,603,-488,-44.73,3888,3363,-525,-13.5,MACATUBA SP,-22.50022,-48.710229,25,3582
SP,MACAUBAL,74,76,2,2.7,154,156,2,1.3,16,21,5,31.25,219,208,-11,-5.02,1282,1156,-126,-9.83,1745,1617,-128,-7.34,MACAUBAL SP,-20.8071616,-49.9648439,25,3583
SP,MAGDA,160,203,43,26.88,118,117,-1,-0.85,1,3,2,200.0,69,72,3,4.35,234,238,4,1.71,582,633,51,8.76,MAGDA SP,-20.6444651,-50.2260983,25,3585
SP,MANDURI,366,360,-6,-1.64,337,341,4,1.19,8,8,0,0.0,288,278,-10,-3.47,568,550,-18,-3.17,1567,1537,-30,-1.91,MANDURI SP,-23.0059018,-49.317191,25,3588
SP,MARABA PAULISTA,187,204,17,9.09,38,34,-4,-10.53,0,0,0,0.0,29,35,6,20.69,368,333,-35,-9.51,622,606,-16,-2.57,MARABA PAULISTA SP,-22.1069936,-51.9629504,25,3589
SP,MARACAI,288,298,10,3.47,454,477,23,5.07,84,56,-28,-33.33,451,475,24,5.32,1436,1452,16,1.11,2713,2758,45,1.66,MARACAI SP,-22.6112679,-50.6670685,25,3590
SP,MARILIA,969,855,-114,-11.76,12903,13466,563,4.36,2356,2722,366,15.53,15617,15033,-584,-3.74,37460,38850,1390,3.71,69305,70926,1621,2.34,MARILIA SP,-22.217108,-49.95006,25,3593
SP,MARINOPOLIS,71,66,-5,-7.04,1,1,0,0.0,0,0,0,0.0,41,41,0,0.0,183,165,-18,-9.84,296,273,-23,-7.77,MARINOPOLIS SP,-20.4408333,-50.8227778,25,3594
SP,MARTINOPOLIS,356,337,-19,-5.34,367,360,-7,-1.91,23,38,15,65.22,650,683,33,5.08,1643,1660,17,1.03,3039,3078,39,1.28,MARTINOPOLIS SP,-22.146153,-51.170949,25,3595
SP,MATAO,10634,8562,-2072,-19.48,10023,11060,1037,10.35,691,531,-160,-23.15,4156,4173,17,0.41,7754,7562,-192,-2.48,33258,31888,-1370,-4.12,MATAO SP,-21.6033611,-48.3660603,25,3596
SP,MENDONCA,1210,1254,44,3.64,561,558,-3,-0.53,42,26,-16,-38.1,171,182,11,6.43,452,410,-42,-9.29,2436,2430,-6,-0.25,MENDONCA SP,-21.1838813,-49.579059,25,3598
SP,MERIDIANO,88,98,10,11.36,1444,1543,99,6.86,40,44,4,10.0,96,110,14,14.58,299,255,-44,-14.72,1967,2050,83,4.22,MERIDIANO SP,-20.3547223,-50.172574,25,3599
SP,MESOPOLIS,33,33,0,0.0,4,4,0,0.0,0,0,0,0.0,16,28,12,75.0,194,182,-12,-6.19,247,247,0,0.0,MESOPOLIS SP,-19.9662274,-50.6190438,25,3600
SP,MIGUELOPOLIS,250,244,-6,-2.4,54,59,5,9.26,179,143,-36,-20.11,751,704,-47,-6.26,1609,1631,22,1.37,2843,2781,-62,-2.18,MIGUELOPOLIS SP,-20.179612,-48.030997,25,3601
SP,MINEIROS DO TIETE,155,144,-11,-7.1,384,377,-7,-1.82,35,115,80,228.57,239,240,1,0.42,689,640,-49,-7.11,1502,1516,14,0.93,MINEIROS DO TIETE SP,-22.4133188,-48.450554,25,3602
SP,MIRACATU,511,494,-17,-3.33,270,273,3,1.11,27,18,-9,-33.33,526,509,-17,-3.23,1636,1511,-125,-7.64,2970,2805,-165,-5.56,MIRACATU SP,-24.2839078,-47.4535128,25,3603
SP,MIRA ESTRELA,77,62,-15,-19.48,25,27,2,8.0,0,0,0,0.0,49,47,-2,-4.08,283,297,14,4.95,434,433,-1,-0.23,MIRA ESTRELA SP,-19.9806298,-50.136873,25,3604
SP,MIRANDOPOLIS,368,330,-38,-10.33,796,821,25,3.14,28,26,-2,-7.14,1098,1079,-19,-1.73,1599,1495,-104,-6.5,3889,3751,-138,-3.55,MIRANDOPOLIS SP,-21.1328313,-51.1029422,25,3605
SP,MIRANTE DO PARANAPANEMA,187,193,6,3.21,1653,1597,-56,-3.39,7,2,-5,-71.43,336,298,-38,-11.31,1505,1387,-118,-7.84,3688,3477,-211,-5.72,MIRANTE DO PARANAPANEMA SP,-22.2925861,-51.907143,25,3606
SP,MOCOCA,2992,2574,-418,-13.97,4570,4686,116,2.54,359,418,59,16.43,4129,4298,169,4.09,5159,4934,-225,-4.36,17209,16910,-299,-1.74,MOCOCA SP,-21.464731,-47.002405,25,3609
SP,MOMBUCA,73,64,-9,-12.33,290,298,8,2.76,3,3,0,0.0,26,107,81,311.54,231,231,0,0.0,623,703,80,12.84,MOMBUCA SP,-22.9293093,-47.5650724,25,3613
SP,MONTE ALTO,723,563,-160,-22.13,5378,5599,221,4.11,177,162,-15,-8.47,3118,3150,32,1.03,3940,4124,184,4.67,13336,13598,262,1.96,MONTE ALTO SP,-21.265545,-48.497066,25,3617
SP,MONTE APRAZIVEL,272,269,-3,-1.1,870,1075,205,23.56,291,363,72,24.74,868,852,-16,-1.84,1458,1668,210,14.4,3759,4227,468,12.45,MONTE APRAZIVEL SP,-20.7625702,-49.7088402,25,3618
SP,MONTE AZUL PAULISTA,2090,1927,-163,-7.8,433,502,69,15.94,109,86,-23,-21.1,1202,1290,88,7.32,1453,1424,-29,-2.0,5287,5229,-58,-1.1,MONTE AZUL PAULISTA SP,-20.90649,-48.638717,25,3619
SP,MONTE CASTELO,144,149,5,3.47,55,55,0,0.0,4,1,-3,-75.0,53,51,-2,-3.77,262,261,-1,-0.38,518,517,-1,-0.19,MONTE CASTELO SP,-21.3006353,-51.5686963,25,3620
SP,MORRO AGUDO,937,1041,104,11.1,3041,3219,178,5.85,28,35,7,25.0,1029,1024,-5,-0.49,2118,2171,53,2.5,7153,7490,337,4.71,MORRO AGUDO SP,-20.7276692,-48.052795,25,3623
SP,MORUNGABA,223,232,9,4.04,2135,2238,103,4.82,75,61,-14,-18.67,449,417,-32,-7.13,1448,1491,43,2.97,4330,4439,109,2.52,MORUNGABA SP,-22.88,-46.79167,25,3624
SP,MOTUCA,84,98,14,16.67,202,300,98,48.51,73,45,-28,-38.36,50,47,-3,-6.0,258,240,-18,-6.98,667,730,63,9.45,MOTUCA SP,-21.5095864,-48.1503832,25,3625
SP,MURUTINGA DO SUL,74,70,-4,-5.41,14,14,0,0.0,0,0,0,0.0,64,71,7,10.94,293,280,-13,-4.44,445,435,-10,-2.25,MURUTINGA DO SUL SP,-20.9913722,-51.2782237,25,3626
SP,NANTES,116,115,-1,-0.86,0,41,41,0.0,0,3,3,0.0,46,45,-1,-2.17,208,239,31,14.9,370,443,73,19.73,NANTES SP,-22.6191472,-51.2382255,25,3627
SP,NATIVIDADE DA SERRA,186,182,-4,-2.15,32,29,-3,-9.38,0,1,1,0.0,69,81,12,17.39,386,367,-19,-4.92,673,660,-13,-1.93,NATIVIDADE DA SERRA SP,-23.3783786,-45.4438173,25,3629
SP,NAZARE PAULISTA,113,69,-44,-38.94,1021,953,-68,-6.66,59,125,66,111.86,382,370,-12,-3.14,1232,1204,-28,-2.27,2807,2721,-86,-3.06,NAZARE PAULISTA SP,-23.1819309,-46.3992986,25,3630
SP,NHANDEARA,174,177,3,1.72,177,185,8,4.52,44,42,-2,-4.55,419,400,-19,-4.53,937,861,-76,-8.11,1751,1665,-86,-4.91,NHANDEARA SP,-20.6943324,-50.0406028,25,3632
SP,NIPOA,107,48,-59,-55.14,73,67,-6,-8.22,21,32,11,52.38,106,99,-7,-6.6,341,294,-47,-13.78,648,540,-108,-16.67,NIPOA SP,-20.9126469,-49.7791476,25,3633
SP,NOVA CAMPINA,346,354,8,2.31,939,885,-54,-5.75,35,20,-15,-42.86,234,157,-77,-32.91,588,577,-11,-1.87,2142,1993,-149,-6.96,NOVA CAMPINA SP,-24.1225305,-48.9054041,25,3635
SP,NOVA CANAA PAULISTA,22,21,-1,-4.55,1,1,0,0.0,1,1,0,0.0,18,19,1,5.56,175,170,-5,-2.86,217,212,-5,-2.3,NOVA CANAA PAULISTA SP,-20.3872473,-50.9481571,25,3636
SP,NOVA CASTILHO,36,39,3,8.33,5,7,2,40.0,0,0,0,0.0,16,20,4,25.0,5,143,138,2760.0,62,209,147,237.1,NOVA CASTILHO SP,-20.7638386,-50.3427479,25,3637
SP,NOVA EUROPA,143,171,28,19.58,2451,2466,15,0.61,23,41,18,78.26,205,206,1,0.49,622,624,2,0.32,3444,3508,64,1.86,NOVA EUROPA SP,-21.7808203,-48.5661712,25,3638
SP,NOVA GRANADA,556,518,-38,-6.83,279,232,-47,-16.85,86,129,43,50.0,780,754,-26,-3.33,1165,1172,7,0.6,2866,2805,-61,-2.13,NOVA GRANADA SP,-20.5345426,-49.3186951,25,3639
SP,NOVA INDEPENDENCIA,90,88,-2,-2.22,1091,1092,1,0.09,11,9,-2,-18.18,62,62,0,0.0,414,333,-81,-19.57,1668,1584,-84,-5.04,NOVA INDEPENDENCIA SP,-21.1066536,-51.4910804,25,3641
SP,NOVO HORIZONTE,0,0,0,0.0,1,0,-1,-100.0,0,1,1,0.0,26,24,-2,-7.69,455,404,-51,-11.21,482,429,-53,-11.0,NOVO HORIZONTE SP,-21.4674564,-49.2235377,25,3645
SP,NUPORANGA,416,376,-40,-9.62,1646,1878,232,14.09,10,5,-5,-50.0,232,207,-25,-10.78,778,758,-20,-2.57,3082,3224,142,4.61,NUPORANGA SP,-20.730877,-47.7522561,25,3646
SP,OCAUCU,384,258,-126,-32.81,73,72,-1,-1.37,16,11,-5,-31.25,102,102,0,0.0,283,292,9,3.18,858,735,-123,-14.34,OCAUCU SP,-22.4396255,-49.9226712,25,3647
SP,OLEO,119,105,-14,-11.76,4,4,0,0.0,8,5,-3,-37.5,13,13,0,0.0,190,187,-3,-1.58,334,314,-20,-5.99,OLEO SP,-22.9422754,-49.3408082,25,3648
SP,OLIMPIA,537,516,-21,-3.91,4463,4743,280,6.27,428,459,31,7.24,3265,3211,-54,-1.65,7388,7184,-204,-2.76,16081,16113,32,0.2,OLIMPIA SP,-20.736634,-48.910625,25,3649
SP,ORLANDIA,893,959,66,7.39,3412,3810,398,11.66,895,944,49,5.47,2517,2564,47,1.87,4050,3978,-72,-1.78,11767,12255,488,4.15,ORLANDIA SP,-20.720278,-47.886667,25,3653
SP,OSCAR BRESSANE,47,35,-12,-25.53,80,84,4,5.0,0,0,0,0.0,52,43,-9,-17.31,280,262,-18,-6.43,459,424,-35,-7.63,OSCAR BRESSANE SP,-22.314874,-50.281118,25,3655
SP,OSVALDO CRUZ,217,217,0,0.0,2226,2181,-45,-2.02,113,150,37,32.74,1867,1852,-15,-0.8,3288,3115,-173,-5.26,7711,7515,-196,-2.54,OSVALDO CRUZ SP,-21.7962773,-50.879119,25,3656
SP,OURINHOS,2063,1983,-80,-3.88,5618,5648,30,0.53,908,965,57,6.28,6929,7028,99,1.43,12247,8885,-3362,-27.45,27765,24509,-3256,-11.73,OURINHOS SP,-22.9777918,-49.868204,25,3657
SP,OUROESTE,211,280,69,32.7,956,946,-10,-1.05,325,338,13,4.0,354,375,21,5.93,780,900,120,15.38,2626,2839,213,8.11,OUROESTE SP,-20.0013584,-50.3736414,25,3658
SP,OURO VERDE,75,86,11,14.67,37,44,7,18.92,25,25,0,0.0,155,155,0,0.0,415,433,18,4.34,707,743,36,5.09,OURO VERDE SP,-21.4892638,-51.7025981,25,3659
SP,PACAEMBU,170,193,23,13.53,47,61,14,29.79,6,0,-6,-100.0,360,380,20,5.56,1534,768,-766,-49.93,2117,1402,-715,-33.77,PACAEMBU SP,-21.566243,-51.2633114,25,3660
SP,PALESTINA,0,0,0,0.0,0,0,0,0.0,0,0,0,0.0,1,1,0,0.0,259,220,-39,-15.06,260,221,-39,-15.0,PALESTINA SP,-20.389344,-49.4320384,25,3661
SP,PALMITAL,572,507,-65,-11.36,831,872,41,4.93,25,19,-6,-24.0,1098,1118,20,1.82,1655,1575,-80,-4.83,4181,4091,-90,-2.15,PALMITAL SP,-22.786384,-50.2198965,25,3664
SP,PANORAMA,113,125,12,10.62,910,929,19,2.09,102,126,24,23.53,590,557,-33,-5.59,965,1002,37,3.83,2680,2739,59,2.2,PANORAMA SP,-21.3612672,-51.8572739,25,3665
SP,PARAGUACU PAULISTA,6162,6195,33,0.54,1240,1277,37,2.98,102,112,10,9.8,1674,1640,-34,-2.03,3577,3560,-17,-0.48,12755,12784,29,0.23,PARAGUACU PAULISTA SP,-22.4203497,-50.5792099,25,3666
SP,PARAIBUNA,344,345,1,0.29,362,402,40,11.05,35,25,-10,-28.57,438,454,16,3.65,1514,1466,-48,-3.17,2693,2692,-1,-0.04,PARAIBUNA SP,-23.3864203,-45.6626797,25,3667
SP,PARAISO,135,139,4,2.96,1128,1207,79,7.0,11,2,-9,-81.82,164,186,22,13.41,439,404,-35,-7.97,1877,1938,61,3.25,PARAISO SP,-21.015911,-48.776105,25,3668
SP,PARANAPANEMA,1884,1944,60,3.18,170,182,12,7.06,72,123,51,70.83,1232,1261,29,2.35,1449,1433,-16,-1.1,4807,4943,136,2.83,PARANAPANEMA SP,-23.390161,-48.720868,25,3669
SP,PARANAPUA,304,296,-8,-2.63,2,2,0,0.0,2,2,0,0.0,229,237,8,3.49,233,200,-33,-14.16,770,737,-33,-4.29,PARANAPUA SP,-20.1033995,-50.5858761,25,3670
SP,PARAPUA,452,403,-49,-10.84,1215,1278,63,5.19,66,170,104,157.58,430,441,11,2.56,664,649,-15,-2.26,2827,2941,114,4.03,PARAPUA SP,-21.781309,-50.7922396,25,3671
SP,PARDINHO,360,347,-13,-3.61,217,227,10,4.61,10,18,8,80.0,232,237,5,2.16,1441,1210,-231,-16.03,2260,2039,-221,-9.78,PARDINHO SP,-23.0806795,-48.3768158,25,3672
SP,PARIQUERA-ACU,679,751,72,10.6,172,192,20,11.63,75,92,17,22.67,706,674,-32,-4.53,2657,2596,-61,-2.3,4289,4305,16,0.37,PARIQUERA-ACU SP,-24.7146891,-47.8802361,25,3673
SP,PAULICEIA,56,54,-2,-3.57,979,1057,78,7.97,220,186,-34,-15.45,248,235,-13,-5.24,518,498,-20,-3.86,2021,2030,9,0.45,PAULICEIA SP,-21.3143975,-51.8316259,25,3676
SP,PAULISTANIA,98,119,21,21.43,2,4,2,100.0,0,0,0,0.0,18,20,2,11.11,196,211,15,7.65,314,354,40,12.74,PAULISTANIA SP,-22.5730321,-49.3985251,25,3678
SP,PEDERNEIRAS,1437,1498,61,4.24,4610,5311,701,15.21,175,153,-22,-12.57,2090,2132,42,2.01,3720,3936,216,5.81,12032,13030,998,8.29,PEDERNEIRAS SP,-22.351086,-48.778113,25,3680
SP,PEDRA BELA,243,214,-29,-11.93,94,78,-16,-17.02,4,3,-1,-25.0,210,263,53,25.24,350,339,-11,-3.14,901,897,-4,-0.44,PEDRA BELA SP,-22.7950193,-46.4431811,25,3681
SP,PEDREGULHO,1056,1231,175,16.57,555,538,-17,-3.06,21,23,2,9.52,428,441,13,3.04,1012,1022,10,0.99,3072,3255,183,5.96,PEDREGULHO SP,-20.25071,-47.4808786,25,3683
SP,PEDREIRA,66,111,45,68.18,6748,7203,455,6.74,130,114,-16,-12.31,2905,2845,-60,-2.07,3446,3210,-236,-6.85,13295,13483,188,1.41,PEDREIRA SP,-22.741347,-46.894846,25,3684
SP,PEDRINHAS PAULISTA,57,62,5,8.77,40,64,24,60.0,48,57,9,18.75,169,171,2,1.18,287,286,-1,-0.35,601,640,39,6.49,PEDRINHAS PAULISTA SP,-22.815725,-50.792359,25,3685
SP,PEDRO DE TOLEDO,103,117,14,13.59,28,29,1,3.57,7,5,-2,-28.57,285,265,-20,-7.02,505,482,-23,-4.55,928,898,-30,-3.23,PEDRO DE TOLEDO SP,-24.2769071,-47.23393,25,3686
SP,PENAPOLIS,588,692,104,17.69,4227,4073,-154,-3.64,399,407,8,2.01,3687,3724,37,1.0,5453,5349,-104,-1.91,14354,14245,-109,-0.76,PENAPOLIS SP,-21.4192406,-50.0765588,25,3687
SP,PEREIRA BARRETO,340,352,12,3.53,1769,1672,-97,-5.48,15,22,7,46.67,1145,1125,-20,-1.75,2051,2011,-40,-1.95,5320,5182,-138,-2.59,PEREIRA BARRETO SP,-20.6378509,-51.1052172,25,3688
SP,PEREIRAS,469,443,-26,-5.54,1170,1203,33,2.82,136,105,-31,-22.79,203,230,27,13.3,509,555,46,9.04,2487,2536,49,1.97,PEREIRAS SP,-23.0743096,-47.9746014,25,3689
SP,PERUIBE,39,33,-6,-15.38,196,212,16,8.16,539,605,66,12.24,3402,3475,73,2.15,5491,5028,-463,-8.43,9667,9353,-314,-3.25,PERUIBE SP,-24.3218105,-46.9977452,25,3690
SP,PIACATU,115,136,21,18.26,347,303,-44,-12.68,3,3,0,0.0,110,154,44,40.0,416,408,-8,-1.92,991,1004,13,1.31,PIACATU SP,-21.5901744,-50.5972241,25,3691
SP,PIEDADE,1380,1557,177,12.83,1238,1239,1,0.08,26,44,18,69.23,2498,2330,-168,-6.73,2727,2736,9,0.33,7869,7906,37,0.47,PIEDADE SP,-23.7074096,-47.4252319,25,3692
SP,PILAR DO SUL,1073,1002,-71,-6.62,515,483,-32,-6.21,68,52,-16,-23.53,1953,2029,76,3.89,2075,2197,122,5.88,5684,5763,79,1.39,PILAR DO SUL SP,-23.8121684,-47.7201865,25,3693
SP,PINHALZINHO,129,112,-17,-13.18,530,494,-36,-6.79,18,12,-6,-33.33,647,638,-9,-1.39,808,839,31,3.84,2132,2095,-37,-1.74,PINHALZINHO SP,-22.7824349,-46.5901718,25,3696
SP,PIQUEROBI,155,166,11,7.1,71,60,-11,-15.49,0,1,1,0.0,31,38,7,22.58,293,286,-7,-2.39,550,551,1,0.18,PIQUEROBI SP,-21.8856652,-51.7296404,25,3697
SP,PIQUETE,67,58,-9,-13.43,591,523,-68,-11.51,18,355,337,1872.22,205,202,-3,-1.46,522,464,-58,-11.11,1403,1602,199,14.18,PIQUETE SP,-22.6138451,-45.1777096,25,3698
SP,PIRACAIA,188,212,24,12.77,1532,1483,-49,-3.2,321,161,-160,-49.84,871,950,79,9.07,1791,1798,7,0.39,4703,4604,-99,-2.11,PIRACAIA SP,-23.052545,-46.359374,25,3699
SP,PIRACICABA,1009,1190,181,17.94,36856,38407,1551,4.21,4102,3968,-134,-3.27,28072,27868,-204,-0.73,51094,49331,-1763,-3.45,121133,120764,-369,-0.3,PIRACICABA SP,-22.72528,-47.64917,25,3700
SP,PIRAJU,536,504,-32,-5.97,1056,1051,-5,-0.47,92,154,62,67.39,1753,1648,-105,-5.99,2556,2473,-83,-3.25,5993,5830,-163,-2.72,PIRAJU SP,-23.1897822,-49.3840493,25,3701
SP,PIRAJUI,929,1037,108,11.63,461,470,9,1.95,47,57,10,21.28,741,742,1,0.13,1478,1454,-24,-1.62,3656,3760,104,2.84,PIRAJUI SP,-21.9957877,-49.4549675,25,3702
SP,PIRANGI,352,380,28,7.95,621,680,59,9.5,16,4,-12,-75.0,538,515,-23,-4.28,965,1310,345,35.75,2492,2889,397,15.93,PIRANGI SP,-21.0969623,-48.6652131,25,3703
SP,PIRASSUNUNGA,888,1740,852,95.95,5963,6157,194,3.25,522,310,-212,-40.61,4280,4324,44,1.03,10445,10187,-258,-2.47,22098,22718,620,2.81,PIRASSUNUNGA SP,-21.9980468,-47.4280861,25,3706
SP,PITANGUEIRAS,794,778,-16,-2.02,3710,3877,167,4.5,52,41,-11,-21.15,1269,1225,-44,-3.47,1976,2029,53,2.68,7801,7950,149,1.91,PITANGUEIRAS SP,-21.013203,-48.220951,25,3708
SP,PLANALTO,122,133,11,9.02,24,19,-5,-20.83,10,15,5,50.0,396,376,-20,-5.05,1107,967,-140,-12.65,1659,1510,-149,-8.98,PLANALTO SP,-21.0342185,-49.928323,25,3709
SP,PLATINA,181,184,3,1.66,68,68,0,0.0,5,3,-2,-40.0,18,26,8,44.44,249,242,-7,-2.81,521,523,2,0.38,PLATINA SP,-22.6328334,-50.2049642,25,3710
SP,POLONI,110,163,53,48.18,235,188,-47,-20.0,4,3,-1,-25.0,96,102,6,6.25,509,681,172,33.79,954,1137,183,19.18,POLONI SP,-20.7836955,-49.8149752,25,3712
SP,POMPEIA,289,306,17,5.88,3827,4134,307,8.02,62,71,9,14.52,1013,981,-32,-3.16,2265,2336,71,3.13,7456,7828,372,4.99,POMPEIA SP,-22.1088293,-50.1720753,25,3713
SP,PONGAI,31,35,4,12.9,19,57,38,200.0,6,8,2,33.33,92,98,6,6.52,298,295,-3,-1.01,446,493,47,10.54,PONGAI SP,-21.7379814,-49.3584449,25,3714
SP,PONTAL,997,1075,78,7.82,4906,5058,152,3.1,54,101,47,87.04,1172,1150,-22,-1.88,2509,2578,69,2.75,9638,9962,324,3.36,PONTAL SP,-21.0239714,-48.0393457,25,3715
SP,PONTALINDA,60,58,-2,-3.33,32,21,-11,-34.38,0,1,1,0.0,29,27,-2,-6.9,250,234,-16,-6.4,371,341,-30,-8.09,PONTALINDA SP,-20.44071,-50.5235329,25,3716
SP,POPULINA,169,159,-10,-5.92,9,10,1,11.11,0,0,0,0.0,36,46,10,27.78,308,254,-54,-17.53,522,469,-53,-10.15,POPULINA SP,-19.9427771,-50.5372875,25,3718
SP,PORANGABA,232,272,40,17.24,320,124,-196,-61.25,3,6,3,100.0,257,288,31,12.06,578,707,129,22.32,1390,1397,7,0.5,PORANGABA SP,-23.17615,-48.119464,25,3719
SP,PORTO FELIZ,1609,1565,-44,-2.73,6275,6208,-67,-1.07,188,199,11,5.85,2364,2625,261,11.04,5461,5338,-123,-2.25,15897,15935,38,0.24,PORTO FELIZ SP,-23.2125392,-47.5240065,25,3720
SP,PORTO FERREIRA,399,367,-32,-8.02,6092,6507,415,6.81,212,247,35,16.51,4029,3835,-194,-4.82,4686,4677,-9,-0.19,15418,15633,215,1.39,PORTO FERREIRA SP,-21.8529134,-47.4794943,25,3721
SP,POTIRENDABA,105,113,8,7.62,2252,2401,149,6.62,121,155,34,28.1,567,598,31,5.47,1365,1325,-40,-2.93,4410,4592,182,4.13,POTIRENDABA SP,-21.0457369,-49.3767154,25,3723
SP,PRADOPOLIS,14,19,5,35.71,4895,4929,34,0.69,232,262,30,12.93,597,571,-26,-4.36,1389,1615,226,16.27,7127,7396,269,3.77,PRADOPOLIS SP,-21.3597815,-48.0746603,25,3725
SP,PRATANIA,492,503,11,2.24,174,97,-77,-44.25,1,3,2,200.0,115,107,-8,-6.96,486,482,-4,-0.82,1268,1192,-76,-5.99,PRATANIA SP,-22.809027,-48.6656779,25,3727
SP,PRESIDENTE ALVES,156,130,-26,-16.67,59,55,-4,-6.78,3,0,-3,-100.0,67,57,-10,-14.93,276,241,-35,-12.68,561,483,-78,-13.9,PRESIDENTE ALVES SP,-22.09991,-49.438133,25,3728
SP,PRESIDENTE EPITACIO,292,285,-7,-2.4,542,591,49,9.04,93,110,17,18.28,1821,1766,-55,-3.02,2853,2826,-27,-0.95,5601,5578,-23,-0.41,PRESIDENTE EPITACIO SP,-21.765074,-52.11114,25,3730
SP,PRESIDENTE PRUDENTE,434,442,8,1.84,10578,11194,616,5.82,1922,2161,239,12.43,16995,16586,-409,-2.41,35448,37057,1609,4.54,65377,67440,2063,3.16,PRESIDENTE PRUDENTE SP,-22.1225167,-51.3882528,25,3731
SP,PRESIDENTE VENCESLAU,281,274,-7,-2.49,383,261,-122,-31.85,222,170,-52,-23.42,1929,1963,34,1.76,3097,3060,-37,-1.19,5912,5728,-184,-3.11,PRESIDENTE VENCESLAU SP,-21.877116,-51.8451047,25,3732
SP,PROMISSAO,1305,1260,-45,-3.45,3029,3437,408,13.47,263,153,-110,-41.83,1787,1537,-250,-13.99,2484,2601,117,4.71,8868,8988,120,1.35,PROMISSAO SP,-21.5404913,-49.8574709,25,3733
SP,QUADRA,189,177,-12,-6.35,12,7,-5,-41.67,1,0,-1,-100.0,58,45,-13,-22.41,348,314,-34,-9.77,608,543,-65,-10.69,QUADRA SP,-23.299332,-48.054657,25,3734
SP,QUATA,148,159,11,7.43,2164,1977,-187,-8.64,27,77,50,185.19,365,350,-15,-4.11,1114,1141,27,2.42,3818,3704,-114,-2.99,QUATA SP,-22.2470977,-50.7003624,25,3735
SP,QUELUZ,99,87,-12,-12.12,225,241,16,7.11,0,8,8,0.0,305,310,5,1.64,1039,1043,4,0.38,1668,1689,21,1.26,QUELUZ SP,-22.5371881,-44.7752585,25,3737
SP,RANCHARIA,1640,1680,40,2.44,1748,1847,99,5.66,31,38,7,22.58,1178,1138,-40,-3.4,2370,2323,-47,-1.98,6967,7026,59,0.85,RANCHARIA SP,-22.2294981,-50.8922333,25,3740
SP,REGINOPOLIS,498,959,461,92.57,52,64,12,23.08,18,16,-2,-11.11,144,132,-12,-8.33,359,355,-4,-1.11,1071,1526,455,42.48,REGINOPOLIS SP,-21.8884118,-49.22273,25,3743
SP,REGISTRO,1110,1076,-34,-3.06,1005,951,-54,-5.37,304,319,15,4.93,3541,3523,-18,-0.51,7450,7295,-155,-2.08,13410,13164,-246,-1.83,REGISTRO SP,-24.497942,-47.844895,25,3744
SP,RIBEIRAO BONITO,481,431,-50,-10.4,145,145,0,0.0,122,319,197,161.48,293,296,3,1.02,701,684,-17,-2.43,1742,1875,133,7.63,RIBEIRAO BONITO SP,-22.0692867,-48.1781765,25,3747
SP,RIBEIRAO BRANCO,1913,1856,-57,-2.98,71,81,10,14.08,82,74,-8,-9.76,641,664,23,3.59,833,810,-23,-2.76,3540,3485,-55,-1.55,RIBEIRAO BRANCO SP,-24.2211495,-48.7678322,25,3748
SP,RIBEIRAO DO SUL,110,107,-3,-2.73,89,94,5,5.62,13,16,3,23.08,136,133,-3,-2.21,250,246,-4,-1.6,598,596,-2,-0.33,RIBEIRAO DO SUL SP,-22.7861813,-49.9285258,25,3750
SP,RIBEIRAO DOS INDIOS,27,21,-6,-22.22,33,24,-9,-27.27,1,0,-1,-100.0,34,33,-1,-2.94,226,222,-4,-1.77,321,300,-21,-6.54,RIBEIRAO DOS INDIOS SP,-21.8378246,-51.602158,25,3751
SP,RIBEIRAO PRETO,978,878,-100,-10.22,21314,22059,745,3.5,12131,11853,-278,-2.29,62071,60824,-1247,-2.01,135298,130808,-4490,-3.32,231792,226422,-5370,-2.32,RIBEIRAO PRETO SP,-21.178333,-47.8066671,25,3754
SP,RIVERSUL,91,91,0,0.0,77,81,4,5.19,0,0,0,0.0,111,113,2,1.8,304,292,-12,-3.95,583,577,-6,-1.03,RIVERSUL SP,-23.8303603,-49.4340558,25,3755
SP,RIFAINA,119,149,30,25.21,241,353,112,46.47,23,34,11,47.83,119,110,-9,-7.56,404,436,32,7.92,906,1082,176,19.43,RIFAINA SP,-20.080256,-47.429109,25,3756
SP,RINOPOLIS,529,529,0,0.0,363,417,54,14.88,11,8,-3,-27.27,214,204,-10,-4.67,734,696,-38,-5.18,1851,1854,3,0.16,RINOPOLIS SP,-21.728308,-50.7226134,25,3758
SP,RIO CLARO,419,384,-35,-8.35,53,52,-1,-1.89,6,15,9,150.0,335,331,-4,-1.19,1486,1458,-28,-1.88,2299,2240,-59,-2.57,RIO CLARO SP,-22.4099468,-47.5603801,25,3759
SP,RIOLANDIA,221,250,29,13.12,23,21,-2,-8.7,0,0,0,0.0,143,142,-1,-0.7,662,662,0,0.0,1049,1075,26,2.48,RIOLANDIA SP,-19.980944,-49.6814309,25,3762
SP,ROSANA,153,162,9,5.88,204,218,14,6.86,37,49,12,32.43,468,450,-18,-3.85,1606,1538,-68,-4.23,2468,2417,-51,-2.07,ROSANA SP,-22.5788641,-53.0552246,25,3763
SP,RUBIACEA,100,97,-3,-3.0,5,5,0,0.0,0,5,5,0.0,15,21,6,40.0,347,337,-10,-2.88,467,465,-2,-0.43,RUBIACEA SP,-21.2996334,-50.7298698,25,3765
SP,SABINO,60,53,-7,-11.67,22,20,-2,-9.09,1,0,-1,-100.0,164,157,-7,-4.27,313,307,-6,-1.92,560,537,-23,-4.11,SABINO SP,-21.4598472,-49.5776811,25,3767
SP,SAGRES,24,29,5,20.83,53,48,-5,-9.43,0,0,0,0.0,14,16,2,14.29,236,227,-9,-3.81,327,320,-7,-2.14,SAGRES SP,-21.8840628,-50.9574608,25,3768
SP,SALES,85,86,1,1.18,143,151,8,5.59,10,12,2,20.0,156,145,-11,-7.05,468,489,21,4.49,862,883,21,2.44,SALES SP,-21.3418263,-49.4999228,25,3769
SP,SALES OLIVEIRA,542,528,-14,-2.58,751,760,9,1.2,75,70,-5,-6.67,300,325,25,8.33,861,811,-50,-5.81,2529,2494,-35,-1.38,SALES OLIVEIRA SP,-20.769612,-47.836873,25,3770
SP,SALMOURAO,81,118,37,45.68,36,2,-34,-94.44,2,2,0,0.0,50,52,2,4.0,270,310,40,14.81,439,484,45,10.25,SALMOURAO SP,-21.625096,-50.8605656,25,3772
SP,SALTO GRANDE,172,186,14,8.14,415,471,56,13.49,13,8,-5,-38.46,280,269,-11,-3.93,528,578,50,9.47,1408,1512,104,7.39,SALTO GRANDE SP,-22.891426,-49.9851484,25,3776
SP,SANDOVALINA,137,139,2,1.46,1479,1122,-357,-24.14,4,0,-4,-100.0,37,45,8,21.62,476,420,-56,-11.76,2133,1726,-407,-19.08,SANDOVALINA SP,-22.4560782,-51.7634004,25,3777
SP,SANTA ALBERTINA,1935,968,-967,-49.97,270,277,7,2.59,2,1,-1,-50.0,166,189,23,13.86,463,482,19,4.1,2836,1917,-919,-32.4,SANTA ALBERTINA SP,-20.0323485,-50.7278392,25,3779
SP,SANTA CRUZ DAS PALMEIRAS,1602,1486,-116,-7.24,376,310,-66,-17.55,34,82,48,141.18,1320,1252,-68,-5.15,2406,2371,-35,-1.45,5738,5501,-237,-4.13,SANTA CRUZ DAS PALMEIRAS SP,-21.823475,-47.248023,25,3785
SP,SANTA CRUZ DO RIO PARDO,3625,3424,-201,-5.54,3324,3462,138,4.15,409,338,-71,-17.36,3193,3183,-10,-0.31,4591,4326,-265,-5.77,15142,14733,-409,-2.7,SANTA CRUZ DO RIO PARDO SP,-22.9060715,-49.6277378,25,3786
SP,SANTA FE DO SUL,295,262,-33,-11.19,2213,1791,-422,-19.07,426,477,51,11.97,2248,2258,10,0.44,3936,3857,-79,-2.01,9118,8645,-473,-5.19,SANTA FE DO SUL SP,-20.2106188,-50.9270837,25,3788
SP,SANTA MARIA DA SERRA,125,130,5,4.0,496,544,48,9.68,7,6,-1,-14.29,158,161,3,1.9,419,430,11,2.63,1205,1271,66,5.48,SANTA MARIA DA SERRA SP,-22.5691072,-48.157095,25,3792
SP,SANTA MERCEDES,60,83,23,38.33,26,33,7,26.92,0,0,0,0.0,33,36,3,9.09,244,215,-29,-11.89,363,367,4,1.1,SANTA MERCEDES SP,-21.3513258,-51.7534,25,3793
SP,SANTA RITA DO PASSA QUATRO,465,508,43,9.25,1450,1627,177,12.21,55,43,-12,-21.82,1261,1300,39,3.09,2212,2316,104,4.7,5443,5794,351,6.45,SANTA RITA DO PASSA QUATRO SP,-21.7103738,-47.4777943,25,3797
SP,SANTA ROSA DE VITERBO,208,130,-78,-37.5,1156,1163,7,0.61,113,159,46,40.71,1021,978,-43,-4.21,1728,1686,-42,-2.43,4226,4116,-110,-2.6,SANTA ROSA DE VITERBO SP,-21.4869452,-47.3654908,25,3798
SP,SANTA SALETE,25,25,0,0.0,3,2,-1,-33.33,0,0,0,0.0,20,35,15,75.0,158,150,-8,-5.06,206,212,6,2.91,SANTA SALETE SP,-20.2451795,-50.6889625,25,3799
SP,SANTO ANASTACIO,373,371,-2,-0.54,443,598,155,34.99,41,33,-8,-19.51,823,777,-46,-5.59,1630,1668,38,2.33,3310,3447,137,4.14,SANTO ANASTACIO SP,-21.974662,-51.652662,25,3800
SP,SANTO ANTONIO DA ALEGRIA,315,295,-20,-6.35,98,53,-45,-45.92,12,9,-3,-25.0,203,159,-44,-21.67,485,467,-18,-3.71,1113,983,-130,-11.68,SANTO ANTONIO DA ALEGRIA SP,-21.0893048,-47.1523426,25,3802
SP,SANTO ANTONIO DE POSSE,1314,1293,-21,-1.6,1978,2131,153,7.74,298,227,-71,-23.83,2105,1898,-207,-9.83,2093,2224,131,6.26,7788,7773,-15,-0.19,SANTO ANTONIO DE POSSE SP,-22.6054087,-46.9210727,25,3803
SP,SANTO ANTONIO DO ARACANGUA,516,468,-48,-9.3,411,223,-188,-45.74,10,18,8,80.0,78,80,2,2.56,626,623,-3,-0.48,1641,1412,-229,-13.95,SANTO ANTONIO DO ARACANGUA SP,-20.9354866,-50.4953504,25,3804
SP,SANTO ANTONIO DO JARDIM,341,307,-34,-9.97,211,209,-2,-0.95,7,4,-3,-42.86,324,294,-30,-9.26,332,293,-39,-11.75,1215,1107,-108,-8.89,SANTO ANTONIO DO JARDIM SP,-22.1158536,-46.6839541,25,3805
SP,SANTO ANTONIO DO PINHAL,138,121,-17,-12.32,36,36,0,0.0,9,8,-1,-11.11,229,243,14,6.11,753,695,-58,-7.7,1165,1103,-62,-5.32,SANTO ANTONIO DO PINHAL SP,-22.8250504,-45.6674063,25,3806
SP,SANTOPOLIS DO AGUAPEI,114,62,-52,-45.61,9,19,10,111.11,5,2,-3,-60.0,111,121,10,9.01,292,314,22,7.53,531,518,-13,-2.45,SANTOPOLIS DO AGUAPEI SP,-21.6379556,-50.5008527,25,3808
SP,SAO BENTO DO SAPUCAI,159,159,0,0.0,86,97,11,12.79,15,1,-14,-93.33,436,440,4,0.92,961,853,-108,-11.24,1657,1550,-107,-6.46,SAO BENTO DO SAPUCAI SP,-22.6884605,-45.7329767,25,3810
SP,SAO CARLOS,2731,2747,16,0.59,18324,18717,393,2.14,2375,2584,209,8.8,15677,15205,-472,-3.01,35581,35965,384,1.08,74688,75218,530,0.71,SAO CARLOS SP,-22.0180395,-47.891154,25,3813
SP,SAO FRANCISCO,0,0,0,0.0,6,0,-6,-100.0,0,0,0,0.0,27,24,-3,-11.11,230,185,-45,-19.57,263,209,-54,-20.53,SAO FRANCISCO SP,-20.3604438,-50.696603,25,3814
SP,SAO JOAO DA BOA VISTA,1650,1682,32,1.94,5005,5052,47,0.94,505,497,-8,-1.58,6355,6637,282,4.44,9991,10162,171,1.71,23506,24030,524,2.23,SAO JOAO DA BOA VISTA SP,-21.9778137,-46.7881722,25,3815
SP,SAO JOAO DAS DUAS PONTES,43,42,-1,-2.33,4,2,-2,-50.0,0,10,10,0.0,38,30,-8,-21.05,188,181,-7,-3.72,273,265,-8,-2.93,SAO JOAO DAS DUAS PONTES SP,-20.3878223,-50.378858,25,3816
SP,SAO JOAO DE IRACEMA,23,61,38,165.22,0,0,0,0.0,0,0,0,0.0,22,21,-1,-4.55,214,175,-39,-18.22,259,257,-2,-0.77,SAO JOAO DE IRACEMA SP,-20.5134345,-50.352595,25,3817
SP,SAO JOAQUIM DA BARRA,286,288,2,0.7,5867,5966,99,1.69,168,190,22,13.1,2379,2331,-48,-2.02,3592,3565,-27,-0.75,12292,12340,48,0.39,SAO JOAQUIM DA BARRA SP,-20.5814993,-47.8608238,25,3819
SP,SAO JOSE DA BELA VISTA,182,171,-11,-6.04,1,26,25,2500.0,1,2,1,100.0,152,155,3,1.97,473,402,-71,-15.01,809,756,-53,-6.55,SAO JOSE DA BELA VISTA SP,-20.5934194,-47.6416942,25,3820
SP,SAO JOSE DO BARREIRO,132,123,-9,-6.82,33,35,2,6.06,2,9,7,350.0,39,35,-4,-10.26,315,306,-9,-2.86,521,508,-13,-2.5,SAO JOSE DO BARREIRO SP,-22.6452376,-44.5805246,25,3821
SP,SAO JOSE DO RIO PARDO,1191,1155,-36,-3.02,3318,3421,103,3.1,654,703,49,7.49,3710,3683,-27,-0.73,5384,5326,-58,-1.08,14257,14288,31,0.22,SAO JOSE DO RIO PARDO SP,-21.595288,-46.887303,25,3822
SP,SAO JOSE DO RIO PRETO,581,552,-29,-4.99,20094,20009,-85,-0.42,6206,6993,787,12.68,38459,37757,-702,-1.83,74212,71163,-3049,-4.11,139552,136474,-3078,-2.21,SAO JOSE DO RIO PRETO SP,-20.8125851,-49.3804212,25,3823
SP,SAO JOSE DOS CAMPOS,527,462,-65,-12.33,29865,34007,4142,13.87,8714,8974,260,2.98,38959,38011,-948,-2.43,101081,102080,999,0.99,179146,183534,4388,2.45,SAO JOSE DOS CAMPOS SP,-23.1860383,-45.8866816,25,3824
SP,SAO MANUEL,956,995,39,4.08,2392,2497,105,4.39,86,104,18,20.93,1844,1927,83,4.5,2915,2849,-66,-2.26,8193,8372,179,2.18,SAO MANUEL SP,-22.732081,-48.572316,25,3827
SP,SAO MIGUEL ARCANJO,1145,1173,28,2.45,425,411,-14,-3.29,51,29,-22,-43.14,1335,1400,65,4.87,1528,1488,-40,-2.62,4484,4501,17,0.38,SAO MIGUEL ARCANJO SP,-23.8807771,-47.9963492,25,3828
SP,SAO PAULO,2274,2482,208,9.15,352944,337902,-15042,-4.26,233209,252604,19395,8.32,852812,807254,-45558,-5.34,3540318,3445173,-95145,-2.69,4981557,4845415,-136142,-2.73,SAO PAULO SP,-23.5506507,-46.6333824,25,3829
SP,SAO PEDRO,33,22,-11,-33.33,2,5,3,150.0,0,0,0,0.0,19,25,6,31.58,259,229,-30,-11.58,313,281,-32,-10.22,SAO PEDRO SP,-22.5512765,-47.9072359,25,3830
SP,SAO PEDRO DO TURVO,585,760,175,29.91,231,228,-3,-1.3,0,0,0,0.0,134,127,-7,-5.22,394,399,5,1.27,1344,1514,170,12.65,SAO PEDRO DO TURVO SP,-22.745286,-49.742829,25,3831
SP,SAO SEBASTIAO DA GRAMA,819,895,76,9.28,396,371,-25,-6.31,9,16,7,77.78,571,600,29,5.08,829,737,-92,-11.1,2624,2619,-5,-0.19,SAO SEBASTIAO DA GRAMA SP,-21.7118854,-46.8284162,25,3834
SP,SAO SIMAO,498,454,-44,-8.84,908,1097,189,20.81,2,3,1,50.0,498,505,7,1.41,1407,1245,-162,-11.51,3313,3304,-9,-0.27,SAO SIMAO SP,-21.4800208,-47.5531095,25,3835
SP,SARAPUI,278,280,2,0.72,814,1072,258,31.7,4,9,5,125.0,245,259,14,5.71,550,490,-60,-10.91,1891,2110,219,11.58,SARAPUI SP,-23.63974,-47.824863,25,3837
SP,SARUTAIA,60,55,-5,-8.33,201,222,21,10.45,3,0,-3,-100.0,37,43,6,16.22,295,289,-6,-2.03,596,609,13,2.18,SARUTAIA SP,-23.2747217,-49.477186,25,3838
SP,SERRA NEGRA,375,342,-33,-8.8,897,802,-95,-10.59,70,103,33,47.14,1813,1759,-54,-2.98,3266,2914,-352,-10.78,6421,5920,-501,-7.8,SERRA NEGRA SP,-22.61222,-46.70056,25,3842
SP,SERTAOZINHO,164,150,-14,-8.54,0,0,0,0.0,1,1,0,0.0,25,19,-6,-24.0,311,245,-66,-21.22,501,415,-86,-17.17,SERTAOZINHO SP,-21.1614356,-47.9720115,25,3843
SP,SETE BARRAS,920,911,-9,-0.98,161,189,28,17.39,28,33,5,17.86,252,211,-41,-16.27,490,446,-44,-8.98,1851,1790,-61,-3.3,SETE BARRAS SP,-24.3878438,-47.9265798,25,3844
SP,SEVERINIA,378,400,22,5.82,520,464,-56,-10.77,16,19,3,18.75,425,424,-1,-0.24,1005,854,-151,-15.02,2344,2161,-183,-7.81,SEVERINIA SP,-20.810753,-48.80538,25,3845
SP,SILVEIRAS,146,141,-5,-3.42,49,29,-20,-40.82,1,0,-1,-100.0,153,128,-25,-16.34,440,426,-14,-3.18,789,724,-65,-8.24,SILVEIRAS SP,-22.66384,-44.852157,25,3846
SP,SOCORRO,308,288,-20,-6.49,1914,2030,116,6.06,136,147,11,8.09,2083,2016,-67,-3.22,3738,3353,-385,-10.3,8179,7834,-345,-4.22,SOCORRO SP,-22.5902619,-46.5249112,25,3847
SP,SOROCABA,327,388,61,18.65,48646,49192,546,1.12,8289,7676,-613,-7.4,43062,43933,871,2.02,95788,92796,-2992,-3.12,196112,193985,-2127,-1.08,SOROCABA SP,-23.5003451,-47.4582864,25,3848
SP,SUD MENNUCCI,676,537,-139,-20.56,243,284,41,16.87,15,23,8,53.33,142,143,1,0.7,523,456,-67,-12.81,1599,1443,-156,-9.76,SUD MENNUCCI SP,-20.6906175,-50.9240834,25,3849
SP,SUZANAPOLIS,87,94,7,8.05,975,1113,138,14.15,1,1,0,0.0,67,58,-9,-13.43,348,304,-44,-12.64,1478,1570,92,6.22,SUZANAPOLIS SP,-20.5011185,-51.0246771,25,3852
SP,TABAPUA,396,713,317,80.05,107,91,-16,-14.95,24,27,3,12.5,423,415,-8,-1.89,1028,1016,-12,-1.17,1978,2262,284,14.36,TABAPUA SP,-20.9648397,-49.0332398,25,3853
SP,TABATINGA,0,3,3,0.0,118,82,-36,-30.51,5,6,1,20.0,712,626,-86,-12.08,3208,3215,7,0.22,4043,3932,-111,-2.75,TABATINGA SP,-21.7373768,-48.6880522,25,3854
SP,TAGUAI,236,207,-29,-12.29,2997,2724,-273,-9.11,14,6,-8,-57.14,444,434,-10,-2.25,876,855,-21,-2.4,4567,4226,-341,-7.47,TAGUAI SP,-23.4534312,-49.4054454,25,3857
SP,TAIACU,130,127,-3,-2.31,22,29,7,31.82,2,1,-1,-50.0,190,182,-8,-4.21,321,312,-9,-2.8,665,651,-14,-2.11,TAIACU SP,-21.143144,-48.511203,25,3858
SP,TAIUVA,113,101,-12,-10.62,62,58,-4,-6.45,8,4,-4,-50.0,210,182,-28,-13.33,350,338,-12,-3.43,743,683,-60,-8.08,TAIUVA SP,-21.1238184,-48.4512476,25,3859
SP,TAMBAU,1011,906,-105,-10.39,2276,2211,-65,-2.86,107,98,-9,-8.41,1016,1022,6,0.59,1365,1338,-27,-1.98,5775,5575,-200,-3.46,TAMBAU SP,-21.70292,-47.270344,25,3860
SP,TANABI,314,365,51,16.24,2404,2611,207,8.61,27,21,-6,-22.22,1007,1018,11,1.09,1578,1571,-7,-0.44,5330,5586,256,4.8,TANABI SP,-20.6251635,-49.6519879,25,3861
SP,TAPIRAI,118,131,13,11.02,0,0,0,0.0,0,0,0,0.0,5,4,-1,-20.0,4,120,116,2900.0,127,255,128,100.79,TAPIRAI SP,-23.9638345,-47.5067136,25,3862
SP,TAPIRATIBA,777,722,-55,-7.08,805,195,-610,-75.78,32,58,26,81.25,353,333,-20,-5.67,714,744,30,4.2,2681,2052,-629,-23.46,TAPIRATIBA SP,-21.46824,-46.7493221,25,3863
SP,TAQUARAL,241,219,-22,-9.13,0,25,25,0.0,0,0,0,0.0,69,59,-10,-14.49,237,246,9,3.8,547,549,2,0.37,TAQUARAL SP,-21.07373,-48.412553,25,3864
SP,TAQUARITINGA,1062,1028,-34,-3.2,1935,2103,168,8.68,433,503,70,16.17,2812,2949,137,4.87,4384,4522,138,3.15,10626,11105,479,4.51,TAQUARITINGA SP,-21.407486,-48.5054848,25,3865
SP,TAQUARITUBA,695,689,-6,-0.86,770,824,54,7.01,181,138,-43,-23.76,1426,1408,-18,-1.26,1857,1891,34,1.83,4929,4950,21,0.43,TAQUARITUBA SP,-23.5337307,-49.2452541,25,3866
SP,TAQUARIVAI,615,621,6,0.98,94,91,-3,-3.19,17,43,26,152.94,287,327,40,13.94,411,455,44,10.71,1424,1537,113,7.94,TAQUARIVAI SP,-23.9257829,-48.7005328,25,3867
SP,TARUMA,1649,1701,52,3.15,1285,1324,39,3.04,457,659,202,44.2,595,597,2,0.34,1040,999,-41,-3.94,5026,5280,254,5.05,TARUMA SP,-22.7474736,-50.5783374,25,3869
SP,TATUI,1418,1411,-7,-0.49,8301,8462,161,1.94,707,685,-22,-3.11,6385,6544,159,2.49,12104,12594,490,4.05,28915,29696,781,2.7,TATUI SP,-23.3518451,-47.848026,25,3870
SP,TEJUPA,449,434,-15,-3.34,342,206,-136,-39.77,53,0,-53,-100.0,25,25,0,0.0,304,277,-27,-8.88,1173,942,-231,-19.69,TEJUPA SP,-23.3437238,-49.3772468,25,3872
SP,TEODORO SAMPAIO,70,68,-2,-2.86,82,134,52,63.41,0,0,0,0.0,94,73,-21,-22.34,572,428,-144,-25.17,818,703,-115,-14.06,TEODORO SAMPAIO SP,-22.5300202,-52.1686847,25,3873
SP,TERRA ROXA,206,278,72,34.95,179,169,-10,-5.59,2,1,-1,-50.0,236,234,-2,-0.85,601,536,-65,-10.82,1224,1218,-6,-0.49,TERRA ROXA SP,-20.787015,-48.331442,25,3874
SP,TIMBURI,155,152,-3,-1.94,29,39,10,34.48,3,3,0,0.0,28,31,3,10.71,230,182,-48,-20.87,445,407,-38,-8.54,TIMBURI SP,-23.2064076,-49.6045576,25,3876
SP,TORRE DE PEDRA,9,12,3,33.33,2,2,0,0.0,0,1,1,0.0,36,37,1,2.78,175,176,1,0.57,222,228,6,2.7,TORRE DE PEDRA SP,-23.2478026,-48.1941034,25,3877
SP,TORRINHA,376,362,-14,-3.72,239,255,16,6.69,23,8,-15,-65.22,511,495,-16,-3.13,937,894,-43,-4.59,2086,2014,-72,-3.45,TORRINHA SP,-22.4302536,-48.1690653,25,3878
SP,TRABIJU,136,193,57,41.91,31,67,36,116.13,3,4,1,33.33,14,17,3,21.43,169,196,27,15.98,353,477,124,35.13,TRABIJU SP,-22.0410733,-48.3350302,25,3879
SP,TUIUTI,158,150,-8,-5.06,29,27,-2,-6.9,52,31,-21,-40.38,73,65,-8,-10.96,333,337,4,1.2,645,610,-35,-5.43,TUIUTI SP,-22.819324,-46.6937627,25,3882
SP,TUPA,1195,1231,36,3.01,2601,2653,52,2.0,282,259,-23,-8.16,4580,4504,-76,-1.66,7794,7440,-354,-4.54,16452,16087,-365,-2.22,TUPA SP,-21.9349129,-50.5141255,25,3883
SP,TUPI PAULISTA,239,202,-37,-15.48,98,97,-1,-1.02,10,9,-1,-10.0,796,785,-11,-1.38,1106,1224,118,10.67,2249,2317,68,3.02,TUPI PAULISTA SP,-21.3861179,-51.5763259,25,3884
SP,TURIUBA,59,70,11,18.64,35,23,-12,-34.29,0,0,0,0.0,14,9,-5,-35.71,171,169,-2,-1.17,279,271,-8,-2.87,TURIUBA SP,-20.9491284,-50.1082011,25,3885
SP,TURMALINA,549,723,174,31.69,469,449,-20,-4.26,16,22,6,37.5,618,618,0,0.0,1352,1356,4,0.3,3004,3168,164,5.46,TURMALINA SP,-20.0530658,-50.4763212,25,3886
SP,UBARANA,123,123,0,0.0,883,866,-17,-1.93,15,4,-11,-73.33,98,89,-9,-9.18,338,335,-3,-0.89,1457,1417,-40,-2.75,UBARANA SP,-21.1637674,-49.7167796,25,3887
SP,UBIRAJARA,939,724,-215,-22.9,50,47,-3,-6.0,1,0,-1,-100.0,113,110,-3,-2.65,344,338,-6,-1.74,1447,1219,-228,-15.76,UBIRAJARA SP,-22.5261054,-49.6635412,25,3889
SP,UNIAO PAULISTA,23,29,6,26.09,83,57,-26,-31.33,1,3,2,200.0,15,12,-3,-20.0,165,167,2,1.21,287,268,-19,-6.62,UNIAO PAULISTA SP,-20.8878168,-49.8986804,25,3891
SP,URANIA,104,93,-11,-10.58,389,424,35,9.0,1,10,9,900.0,239,232,-7,-2.93,551,547,-4,-0.73,1284,1306,22,1.71,URANIA SP,-20.244491,-50.6450868,25,3892
SP,URU,52,47,-5,-9.62,2,2,0,0.0,0,0,0,0.0,9,9,0,0.0,198,198,0,0.0,261,256,-5,-1.92,URU SP,-21.7846064,-49.2819702,25,3893
SP,URUPES,385,384,-1,-0.26,741,714,-27,-3.64,20,28,8,40.0,562,590,28,4.98,994,1051,57,5.73,2702,2767,65,2.41,URUPES SP,-21.2027026,-49.2921996,25,3894
SP,VALENTIM GENTIL,133,109,-24,-18.05,1746,1937,191,10.94,18,16,-2,-11.11,316,379,63,19.94,703,657,-46,-6.54,2916,3098,182,6.24,VALENTIM GENTIL SP,-20.4226107,-50.0861511,25,3895
SP,VALPARAISO,276,264,-12,-4.35,3055,3144,89,2.91,140,164,24,17.14,489,544,55,11.25,1797,1695,-102,-5.68,5757,5811,54,0.94,VALPARAISO SP,-21.2230369,-50.8666375,25,3897
SP,VARGEM,98,80,-18,-18.37,223,162,-61,-27.35,13,32,19,146.15,203,200,-3,-1.48,397,436,39,9.82,934,910,-24,-2.57,VARGEM SP,-22.8902379,-46.4145366,25,3898
SP,VARGEM GRANDE DO SUL,605,562,-43,-7.11,1830,2067,237,12.95,72,83,11,15.28,2262,2333,71,3.14,2554,2888,334,13.08,7323,7933,610,8.33,VARGEM GRANDE DO SUL SP,-21.832194,-46.891286,25,3899
SP,VIRADOURO,277,252,-25,-9.03,646,729,83,12.85,12,25,13,108.33,693,685,-8,-1.15,1289,1307,18,1.4,2917,2998,81,2.78,VIRADOURO SP,-20.8726051,-48.2968122,25,3904
SP,VISTA ALEGRE DO ALTO,506,459,-47,-9.29,1960,2008,48,2.45,0,0,0,0.0,470,477,7,1.49,446,445,-1,-0.22,3382,3389,7,0.21,VISTA ALEGRE DO ALTO SP,-21.171293,-48.6299172,25,3905
SP,VOTUPORANGA,231,204,-27,-11.69,6428,7011,583,9.07,775,789,14,1.81,6340,6448,108,1.7,12291,12309,18,0.15,26065,26761,696,2.67,VOTUPORANGA SP,-20.4252908,-49.972028,25,3908
SP,ZACARIAS,186,195,9,4.84,83,78,-5,-6.02,0,0,0,0.0,33,34,1,3.03,283,272,-11,-3.89,585,579,-6,-1.03,ZACARIAS SP,-21.0523649,-50.0514502,25,3909
SP,CHAVANTES,147,143,-4,-2.72,453,539,86,18.98,1,1,0,0.0,314,320,6,1.91,756,769,13,1.72,1671,1772,101,6.04,CHAVANTES SP,-23.0406405,-49.7071698,25,3910
PR,ABATIA,159,141,-18,-11.32,75,86,11,14.67,14,32,18,128.57,225,188,-37,-16.44,543,529,-14,-2.58,1016,976,-40,-3.94,ABATIA PR,-23.3052967,-50.3102532,17,3912
PR,AGUDOS DO SUL,23,25,2,8.7,18,16,-2,-11.11,11,16,5,45.45,397,333,-64,-16.12,444,469,25,5.63,893,859,-34,-3.81,AGUDOS DO SUL PR,-25.9890808,-49.3328175,17,3914
PR,ALTAMIRA DO PARANA,65,62,-3,-4.62,38,30,-8,-21.05,3,0,-3,-100.0,92,100,8,8.7,299,269,-30,-10.03,497,461,-36,-7.24,ALTAMIRA DO PARANA PR,-24.7988854,-52.7131879,17,3916
PR,ALTONIA,217,242,25,11.52,1296,1120,-176,-13.58,8,12,4,50.0,699,681,-18,-2.58,1025,973,-52,-5.07,3245,3028,-217,-6.69,ALTONIA PR,-23.8722004,-53.894037,17,3917
PR,ALTO PARANA,372,328,-44,-11.83,446,433,-13,-2.91,39,35,-4,-10.26,430,341,-89,-20.7,823,693,-130,-15.8,2110,1830,-280,-13.27,ALTO PARANA PR,-23.131247,-52.318893,17,3918
PR,ALTO PIQUIRI,132,115,-17,-12.88,203,198,-5,-2.46,18,13,-5,-27.78,268,272,4,1.49,485,434,-51,-10.52,1106,1032,-74,-6.69,ALTO PIQUIRI PR,-24.0239021,-53.4417448,17,3919
PR,ALVORADA DO SUL,210,232,22,10.48,254,257,3,1.18,24,74,50,208.33,380,357,-23,-6.05,668,680,12,1.8,1536,1600,64,4.17,ALVORADA DO SUL PR,-22.7807269,-51.2307721,17,3920
PR,AMAPORA,119,134,15,12.61,100,112,12,12.0,5,2,-3,-60.0,77,82,5,6.49,323,302,-21,-6.5,624,632,8,1.28,AMAPORA PR,-23.094272,-52.786597,17,3921
PR,AMPERE,59,57,-2,-3.39,2916,2756,-160,-5.49,13,15,2,15.38,938,963,25,2.67,1350,1365,15,1.11,5276,5156,-120,-2.27,AMPERE PR,-25.9168712,-53.4742414,17,3922
PR,ANAHY,50,57,7,14.0,21,51,30,142.86,0,0,0,0.0,147,143,-4,-2.72,307,261,-46,-14.98,525,512,-13,-2.48,ANAHY PR,-24.6450861,-53.1337957,17,3923
PR,ANDIRA,285,231,-54,-18.95,856,993,137,16.0,77,72,-5,-6.49,747,707,-40,-5.35,1728,1771,43,2.49,3693,3774,81,2.19,ANDIRA PR,-23.0494761,-50.2310027,17,3924
PR,ANGULO,69,85,16,23.19,48,44,-4,-8.33,1,0,-1,-100.0,105,114,9,8.57,267,282,15,5.62,490,525,35,7.14,ANGULO PR,-23.1958345,-51.9094976,17,3925
PR,ANTONINA,144,142,-2,-1.39,72,64,-8,-11.11,18,30,12,66.67,544,499,-45,-8.27,2301,2474,173,7.52,3079,3209,130,4.22,ANTONINA PR,-25.4298854,-48.7125431,17,3926
PR,ANTONIO OLINTO,123,144,21,17.07,42,45,3,7.14,8,18,10,125.0,82,100,18,21.95,318,319,1,0.31,573,626,53,9.25,ANTONIO OLINTO PR,-25.9849006,-50.1974516,17,3927
PR,APUCARANA,411,395,-16,-3.89,11926,12361,435,3.65,1003,1104,101,10.07,7019,7020,1,0.01,12560,11556,-1004,-7.99,32919,32436,-483,-1.47,APUCARANA PR,-23.5525327,-51.4610764,17,3928
PR,ARAPONGAS,831,670,-161,-19.37,14684,15874,1190,8.1,590,585,-5,-0.85,7855,7871,16,0.2,11103,10889,-214,-1.93,35063,35889,826,2.36,ARAPONGAS PR,-23.4152862,-51.4293961,17,3929
PR,ARAPOTI,1381,1302,-79,-5.72,973,1014,41,4.21,73,84,11,15.07,1677,1623,-54,-3.22,2048,2274,226,11.04,6152,6297,145,2.36,ARAPOTI PR,-24.1457957,-49.8224605,17,3930
PR,ARAPUA,30,25,-5,-16.67,281,332,51,18.15,5,9,4,80.0,21,23,2,9.52,269,162,-107,-39.78,606,551,-55,-9.08,ARAPUA PR,-24.3079525,-51.7901941,17,3931
PR,ARARUNA,8,8,0,0.0,21,31,10,47.62,4,8,4,100.0,147,150,3,2.04,1104,876,-228,-20.65,1284,1073,-211,-16.43,ARARUNA PR,-23.9320308,-52.4976047,17,3932
PR,ARIRANHA DO IVAI,43,39,-4,-9.3,9,7,-2,-22.22,0,0,0,0.0,25,20,-5,-20.0,208,183,-25,-12.02,285,249,-36,-12.63,ARIRANHA DO IVAI PR,-24.3834527,-51.5876772,17,3934
PR,ASSAI,103,120,17,16.5,600,686,86,14.33,7,10,3,42.86,516,569,53,10.27,1051,1056,5,0.48,2277,2441,164,7.2,ASSAI PR,-23.3736041,-50.8454929,17,3935
PR,ASSIS CHATEAUBRIAND,406,374,-32,-7.88,802,803,1,0.12,162,186,24,14.81,2186,2457,271,12.4,2561,2561,0,0.0,6117,6381,264,4.32,ASSIS CHATEAUBRIAND PR,-24.4054826,-53.5120468,17,3936
PR,ASTORGA,324,385,61,18.83,1452,1478,26,1.79,231,298,67,29.0,1089,1109,20,1.84,2040,2041,1,0.05,5136,5311,175,3.41,ASTORGA PR,-23.2350184,-51.6647074,17,3937
PR,ATALAIA,316,326,10,3.16,2055,2050,-5,-0.24,76,48,-28,-36.84,437,447,10,2.29,1412,1323,-89,-6.3,4296,4194,-102,-2.37,ATALAIA PR,-23.1513833,-52.0529697,17,3938
PR,BANDEIRANTES,205,189,-16,-7.8,1905,1765,-140,-7.35,51,62,11,21.57,1420,1361,-59,-4.15,2586,2759,173,6.69,6167,6136,-31,-0.5,BANDEIRANTES PR,-23.1778891,-50.646475,17,3940
PR,BARBOSA FERRAZ,99,90,-9,-9.09,145,125,-20,-13.79,23,15,-8,-34.78,435,451,16,3.68,597,576,-21,-3.52,1299,1257,-42,-3.23,BARBOSA FERRAZ PR,-24.0287182,-52.00811,17,3941
PR,BARRA DO JACARE,79,78,-1,-1.27,42,40,-2,-4.76,1,0,-1,-100.0,15,32,17,113.33,234,203,-31,-13.25,371,353,-18,-4.85,BARRA DO JACARE PR,-23.1151788,-50.1813945,17,3943
PR,BELA VISTA DA CAROBA,2,0,-2,-100.0,34,35,1,2.94,0,0,0,0.0,61,72,11,18.03,257,230,-27,-10.51,354,337,-17,-4.8,BELA VISTA DA CAROBA PR,-25.8792818,-53.6672545,17,3944
PR,BELA VISTA DO PARAISO,277,229,-48,-17.33,442,478,36,8.14,29,40,11,37.93,646,667,21,3.25,1014,995,-19,-1.87,2408,2409,1,0.04,BELA VISTA DO PARAISO PR,-22.9948493,-51.1907996,17,3945
PR,BITURUNA,353,366,13,3.68,1579,1680,101,6.4,82,42,-40,-48.78,352,367,15,4.26,1049,992,-57,-5.43,3415,3447,32,0.94,BITURUNA PR,-26.161281,-51.5533319,17,3946
PR,BOA ESPERANCA,1555,1551,-4,-0.26,937,901,-36,-3.84,130,181,51,39.23,1956,1962,6,0.31,2711,2701,-10,-0.37,7289,7296,7,0.1,BOA ESPERANCA PR,-24.2411024,-52.7860277,17,3947
PR,BOA ESPERANCA DO IGUACU,22,18,-4,-18.18,92,57,-35,-38.04,0,6,6,0.0,92,92,0,0.0,273,238,-35,-12.82,479,411,-68,-14.2,BOA ESPERANCA DO IGUACU PR,-25.6362851,-53.2139114,17,3948
PR,BOA VENTURA DE SAO ROQUE,155,150,-5,-3.23,359,383,24,6.69,0,1,1,0.0,172,175,3,1.74,381,364,-17,-4.46,1067,1073,6,0.56,BOA VENTURA DE SAO ROQUE PR,-24.88177,-51.5441292,17,3949
PR,BOA VISTA DA APARECIDA,45,30,-15,-33.33,105,125,20,19.05,23,9,-14,-60.87,234,209,-25,-10.68,640,610,-30,-4.69,1047,983,-64,-6.11,BOA VISTA DA APARECIDA PR,-25.4357216,-53.4067721,17,3950
PR,BOM JESUS DO SUL,6,8,2,33.33,151,140,-11,-7.28,14,17,3,21.43,78,68,-10,-12.82,255,236,-19,-7.45,504,469,-35,-6.94,BOM JESUS DO SUL PR,-26.1922507,-53.6002033,17,3952
PR,BOM SUCESSO,0,1,1,0.0,0,0,0,0.0,0,3,3,0.0,8,9,1,12.5,353,386,33,9.35,361,399,38,10.53,BOM SUCESSO PR,-23.7101968,-51.7661597,17,3953
PR,BOM SUCESSO DO SUL,68,60,-8,-11.76,350,365,15,4.29,2,1,-1,-50.0,158,150,-8,-5.06,221,231,10,4.52,799,807,8,1.0,BOM SUCESSO DO SUL PR,-26.0749256,-52.8348629,17,3954
PR,BORRAZOPOLIS,84,90,6,7.14,115,102,-13,-11.3,5,16,11,220.0,298,286,-12,-4.03,500,483,-17,-3.4,1002,977,-25,-2.5,BORRAZOPOLIS PR,-23.9399295,-51.5842203,17,3955
PR,BRAGANEY,93,93,0,0.0,13,13,0,0.0,5,7,2,40.0,169,158,-11,-6.51,342,302,-40,-11.7,622,573,-49,-7.88,BRAGANEY PR,-24.8179919,-53.118506,17,3956
PR,BRASILANDIA DO SUL,58,45,-13,-22.41,0,0,0,0.0,2,3,1,50.0,164,170,6,3.66,215,265,50,23.26,439,483,44,10.02,BRASILANDIA DO SUL PR,-24.1975793,-53.527551,17,3957
PR,CAFEARA,67,60,-7,-10.45,19,15,-4,-21.05,5,7,2,40.0,28,33,5,17.86,201,194,-7,-3.48,320,309,-11,-3.44,CAFEARA PR,-22.78905,-51.714195,17,3958
PR,CAFELANDIA,445,436,-9,-2.02,1660,1606,-54,-3.25,46,34,-12,-26.09,569,537,-32,-5.62,1192,1121,-71,-5.96,3912,3734,-178,-4.55,CAFELANDIA PR,-24.6176963,-53.3218057,17,3959
PR,CAFEZAL DO SUL,49,46,-3,-6.12,139,156,17,12.23,2,2,0,0.0,78,96,18,23.08,278,277,-1,-0.36,546,577,31,5.68,CAFEZAL DO SUL PR,-23.900508,-53.512418,17,3960
PR,CALIFORNIA,52,46,-6,-11.54,668,511,-157,-23.5,12,7,-5,-41.67,200,215,15,7.5,555,541,-14,-2.52,1487,1320,-167,-11.23,CALIFORNIA PR,-23.6672543,-51.3554556,17,3961
PR,CAMBARA,264,271,7,2.65,2059,2056,-3,-0.15,55,47,-8,-14.55,1010,1041,31,3.07,1920,1827,-93,-4.84,5308,5242,-66,-1.24,CAMBARA PR,-23.042273,-50.075281,17,3962
PR,CAMPINA DA LAGOA,275,281,6,2.18,84,96,12,14.29,37,38,1,2.7,606,589,-17,-2.81,1042,1114,72,6.91,2044,2118,74,3.62,CAMPINA DA LAGOA PR,-24.5937926,-52.8038965,17,3965
PR,CAMPINA DO SIMAO,64,72,8,12.5,24,27,3,12.5,1,0,-1,-100.0,70,72,2,2.86,204,166,-38,-18.63,363,337,-26,-7.16,CAMPINA DO SIMAO PR,-25.1086375,-51.8076658,17,3966
PR,CAMPO BONITO,67,75,8,11.94,13,17,4,30.77,0,0,0,0.0,82,90,8,9.76,298,257,-41,-13.76,460,439,-21,-4.57,CAMPO BONITO PR,-25.0328004,-52.992976,17,3968
PR,CAMPO DO TENENTE,388,367,-21,-5.41,272,289,17,6.25,42,12,-30,-71.43,360,336,-24,-6.67,107,383,276,257.94,1169,1387,218,18.65,CAMPO DO TENENTE PR,-25.9814143,-49.684518,17,3969
PR,CAMPO MOURAO,678,626,-52,-7.67,4849,5439,590,12.17,569,624,55,9.67,7339,7384,45,0.61,12216,12287,71,0.58,25651,26360,709,2.76,CAMPO MOURAO PR,-24.046329,-52.37802,17,3972
PR,CANDIDO DE ABREU,176,159,-17,-9.66,249,250,1,0.4,0,0,0,0.0,311,308,-3,-0.96,720,698,-22,-3.06,1456,1415,-41,-2.82,CANDIDO DE ABREU PR,-24.5748319,-51.34301961412225,17,3973
PR,CANDOI,446,507,61,13.68,281,315,34,12.1,11,14,3,27.27,567,595,28,4.94,1015,570,-445,-43.84,2320,2001,-319,-13.75,CANDOI PR,-25.5711951,-52.051107,17,3974
PR,CANTAGALO,41,39,-2,-4.88,38,58,20,52.63,2,19,17,850.0,50,46,-4,-8.0,342,276,-66,-19.3,473,438,-35,-7.4,CANTAGALO PR,-25.3735238,-52.1238114,17,3975
PR,CAPANEMA,233,224,-9,-3.86,557,579,22,3.95,107,87,-20,-18.69,3161,3683,522,16.51,3643,3537,-106,-2.91,7701,8110,409,5.31,CAPANEMA PR,-25.6704878,-53.8083036,17,3976
PR,CAPITAO LEONIDAS MARQUES,63,60,-3,-4.76,936,1013,77,8.23,62,84,22,35.48,808,820,12,1.49,1198,1209,11,0.92,3067,3186,119,3.88,CAPITAO LEONIDAS MARQUES PR,-25.481645,-53.611238,17,3977
PR,CARLOPOLIS,386,370,-16,-4.15,660,540,-120,-18.18,21,20,-1,-4.76,532,529,-3,-0.56,828,874,46,5.56,2427,2333,-94,-3.87,CARLOPOLIS PR,-23.4285011,-49.7208814,17,3979
PR,CASCAVEL,727,721,-6,-0.83,2204,2395,191,8.67,17,17,0,0.0,1496,1588,92,6.15,2593,2197,-396,-15.27,7037,6918,-119,-1.69,CASCAVEL PR,-24.9554996,-53.4560544,17,3980
PR,CASTRO,3077,3202,125,4.06,4296,4457,161,3.75,497,628,131,26.36,4073,4177,104,2.55,6313,6146,-167,-2.65,18256,18610,354,1.94,CASTRO PR,-24.794072,-49.9972914,17,3981
PR,CATANDUVAS,185,167,-18,-9.73,244,293,49,20.08,1,1,0,0.0,264,296,32,12.12,564,527,-37,-6.56,1258,1284,26,2.07,CATANDUVAS PR,-25.2043528,-53.154826,17,3982
PR,CENTENARIO DO SUL,66,75,9,13.64,210,182,-28,-13.33,8,35,27,337.5,283,260,-23,-8.13,691,679,-12,-1.74,1258,1231,-27,-2.15,CENTENARIO DO SUL PR,-22.821497,-51.5951456,17,3983
PR,CERRO AZUL,306,235,-71,-23.2,158,169,11,6.96,16,17,1,6.25,375,388,13,3.47,631,610,-21,-3.33,1486,1419,-67,-4.51,CERRO AZUL PR,-24.8245108,-49.2615181,17,3984
PR,CEU AZUL,209,198,-11,-5.26,1044,972,-72,-6.9,20,36,16,80.0,422,586,164,38.86,1012,943,-69,-6.82,2707,2735,28,1.03,CEU AZUL PR,-25.1484973,-53.8494214,17,3985
PR,CHOPINZINHO,173,147,-26,-15.03,1341,1346,5,0.37,136,174,38,27.94,1194,1140,-54,-4.52,1592,1573,-19,-1.19,4436,4380,-56,-1.26,CHOPINZINHO PR,-25.8566167,-52.5294107,17,3986
PR,CIANORTE,573,538,-35,-6.11,9926,9824,-102,-1.03,333,253,-80,-24.02,5209,5244,35,0.67,7590,7627,37,0.49,23631,23486,-145,-0.61,CIANORTE PR,-23.4700798,-52.5549029,17,3987
PR,CIDADE GAUCHA,175,159,-16,-9.14,2119,2222,103,4.86,5,8,3,60.0,283,290,7,2.47,754,765,11,1.46,3336,3444,108,3.24,CIDADE GAUCHA PR,-23.3816558,-52.9444098,17,3988
PR,CLEVELANDIA,212,213,1,0.47,562,539,-23,-4.09,56,54,-2,-3.57,740,706,-34,-4.59,914,895,-19,-2.08,2484,2407,-77,-3.1,CLEVELANDIA PR,-26.404065,-52.3513972,17,3989
PR,COLORADO,69,65,-4,-5.8,3896,3785,-111,-2.85,42,29,-13,-30.95,1043,999,-44,-4.22,1808,1835,27,1.49,6858,6713,-145,-2.11,COLORADO PR,-22.8385097,-51.9730135,17,3991
PR,CONGONHINHAS,265,289,24,9.06,119,91,-28,-23.53,0,2,2,0.0,172,193,21,12.21,420,451,31,7.38,976,1026,50,5.12,CONGONHINHAS PR,-23.5497241,-50.5520182,17,3992
PR,CONSELHEIRO MAIRINCK,109,117,8,7.34,8,8,0,0.0,34,30,-4,-11.76,78,81,3,3.85,234,213,-21,-8.97,463,449,-14,-3.02,CONSELHEIRO MAIRINCK PR,-23.6229983,-50.1706779,17,3993
PR,CORBELIA,397,384,-13,-3.27,352,344,-8,-2.27,225,147,-78,-34.67,803,834,31,3.86,1434,1388,-46,-3.21,3211,3097,-114,-3.55,CORBELIA PR,-24.7951117,-53.2961804,17,3995
PR,CORNELIO PROCOPIO,537,533,-4,-0.74,1626,1742,116,7.13,123,114,-9,-7.32,2988,2979,-9,-0.3,11383,10555,-828,-7.27,16657,15923,-734,-4.41,CORNELIO PROCOPIO PR,-23.1825218,-50.6499263,17,3996
PR,CORONEL DOMINGOS SOARES,251,252,1,0.4,446,433,-13,-2.91,0,0,0,0.0,58,92,34,58.62,380,381,1,0.26,1135,1158,23,2.03,CORONEL DOMINGOS SOARES PR,-26.22394,-52.0314509,17,3997
PR,CORONEL VIVIDA,296,310,14,4.73,1274,1238,-36,-2.83,102,207,105,102.94,1350,1389,39,2.89,1397,1352,-45,-3.22,4419,4496,77,1.74,CORONEL VIVIDA PR,-25.9803771,-52.5654277,17,3998
PR,CORUMBATAI DO SUL,35,29,-6,-17.14,11,11,0,0.0,0,2,2,0.0,117,88,-29,-24.79,255,258,3,1.18,418,388,-30,-7.18,CORUMBATAI DO SUL PR,-24.100956,-52.11766,17,3999
PR,CRUZEIRO DO IGUACU,150,150,0,0.0,208,240,32,15.38,10,10,0,0.0,87,83,-4,-4.6,295,291,-4,-1.36,750,774,24,3.2,CRUZEIRO DO IGUACU PR,-25.6142278,-53.1299075,17,4000
PR,CRUZEIRO DO OESTE,373,431,58,15.55,1942,1977,35,1.8,57,76,19,33.33,717,791,74,10.32,1413,1399,-14,-0.99,4502,4674,172,3.82,CRUZEIRO DO OESTE PR,-23.7839582,-53.0709425,17,4001
PR,CRUZ MACHADO,68,60,-8,-11.76,271,272,1,0.37,24,16,-8,-33.33,394,426,32,8.12,725,710,-15,-2.07,1482,1484,2,0.13,CRUZ MACHADO PR,-26.0184626,-51.3503171,17,4003
PR,CRUZMALTINA,89,92,3,3.37,16,3,-13,-81.25,0,4,4,0.0,116,115,-1,-0.86,215,205,-10,-4.65,436,419,-17,-3.9,CRUZMALTINA PR,-23.9930826,-51.4435583,17,4004
PR,CURITIBA,865,938,73,8.44,83101,84081,980,1.18,39593,47725,8132,20.54,146699,139593,-7106,-4.84,628923,591468,-37455,-5.96,899181,863805,-35376,-3.93,CURITIBA PR,-25.65178105,-49.30920566150176,17,4005
PR,CURIUVA,46,47,1,2.17,281,325,44,15.66,9,12,3,33.33,288,270,-18,-6.25,820,876,56,6.83,1444,1530,86,5.96,CURIUVA PR,-24.0383013,-50.455484,17,4006
PR,DIAMANTE DO NORTE,86,67,-19,-22.09,21,21,0,0.0,14,12,-2,-14.29,186,187,1,0.54,328,313,-15,-4.57,635,600,-35,-5.51,DIAMANTE DO NORTE PR,-22.6565442,-52.8589113,17,4007
PR,DIAMANTE DO SUL,47,35,-12,-25.53,0,1,1,0.0,8,5,-3,-37.5,49,41,-8,-16.33,259,228,-31,-11.97,363,310,-53,-14.6,DIAMANTE DO SUL PR,-25.0436147,-52.6800923,17,4008
PR,DOIS VIZINHOS,930,1018,88,9.46,4812,4947,135,2.81,494,420,-74,-14.98,2626,2702,76,2.89,5355,5136,-219,-4.09,14217,14223,6,0.04,DOIS VIZINHOS PR,-25.7464681,-53.0554369,17,4010
PR,DOURADINA,196,184,-12,-6.12,698,681,-17,-2.44,25,9,-16,-64.0,914,1078,164,17.94,863,857,-6,-0.7,2696,2809,113,4.19,DOURADINA PR,-23.3847331,-53.2932989,17,4011
PR,DOUTOR CAMARGO,26,25,-1,-3.85,112,97,-15,-13.39,0,0,0,0.0,184,194,10,5.43,413,417,4,0.97,735,733,-2,-0.27,DOUTOR CAMARGO PR,-23.5575611,-52.2185546,17,4012
PR,ENEAS MARQUES,134,143,9,6.72,365,359,-6,-1.64,13,8,-5,-38.46,172,171,-1,-0.58,487,492,5,1.03,1171,1173,2,0.17,ENEAS MARQUES PR,-25.9435584,-53.1637539,17,4013
PR,ENGENHEIRO BELTRAO,334,324,-10,-2.99,201,215,14,6.97,169,130,-39,-23.08,606,625,19,3.14,881,826,-55,-6.24,2191,2120,-71,-3.24,ENGENHEIRO BELTRAO PR,-23.7996003,-52.2592684,17,4014
PR,ESPERANCA NOVA,35,46,11,31.43,113,74,-39,-34.51,0,3,3,0.0,26,27,1,3.85,184,159,-25,-13.59,358,309,-49,-13.69,ESPERANCA NOVA PR,-23.7246134,-53.8105174,17,4015
PR,ENTRE RIOS DO OESTE,355,394,39,10.99,190,163,-27,-14.21,21,23,2,9.52,235,216,-19,-8.09,451,418,-33,-7.32,1252,1214,-38,-3.04,ENTRE RIOS DO OESTE PR,-24.7002098,-54.2448233,17,4016
PR,ESPIGAO ALTO DO IGUACU,55,59,4,7.27,94,140,46,48.94,2,2,0,0.0,80,84,4,5.0,290,282,-8,-2.76,521,567,46,8.83,ESPIGAO ALTO DO IGUACU PR,-25.4223729,-52.8376411,17,4017
PR,FAROL,99,99,0,0.0,0,0,0,0.0,0,0,0,0.0,43,41,-2,-4.65,242,205,-37,-15.29,384,345,-39,-10.16,FAROL PR,-24.0935055,-52.6232183,17,4018
PR,FAXINAL,332,321,-11,-3.31,477,345,-132,-27.67,18,12,-6,-33.33,689,650,-39,-5.66,1094,953,-141,-12.89,2610,2281,-329,-12.61,FAXINAL PR,-24.001212,-51.3222727,17,4019
PR,FENIX,36,34,-2,-5.56,5,2,-3,-60.0,34,29,-5,-14.71,153,148,-5,-3.27,349,371,22,6.3,577,584,7,1.21,FENIX PR,-23.9169495,-51.9801443,17,4021
PR,FERNANDES PINHEIRO,107,90,-17,-15.89,159,167,8,5.03,0,0,0,0.0,65,56,-9,-13.85,467,371,-96,-20.56,798,684,-114,-14.29,FERNANDES PINHEIRO PR,-25.4148066,-50.5489837,17,4022
PR,FIGUEIRA,70,63,-7,-10.0,394,384,-10,-2.54,9,12,3,33.33,144,146,2,1.39,500,477,-23,-4.6,1117,1082,-35,-3.13,FIGUEIRA PR,-23.8481018,-50.4059875,17,4023
PR,FLORAI,136,166,30,22.06,242,245,3,1.24,3,5,2,66.67,141,157,16,11.35,343,334,-9,-2.62,865,907,42,4.86,FLORAI PR,-23.3206134,-52.3009856,17,4024
PR,FLOR DA SERRA DO SUL,17,12,-5,-29.41,296,271,-25,-8.45,7,6,-1,-14.29,109,109,0,0.0,362,342,-20,-5.52,791,740,-51,-6.45,FLOR DA SERRA DO SUL PR,-26.2589553,-53.308432,17,4025
PR,FLORESTOPOLIS,193,198,5,2.59,2037,1929,-108,-5.3,40,20,-20,-50.0,307,291,-16,-5.21,674,636,-38,-5.64,3251,3074,-177,-5.44,FLORESTOPOLIS PR,-22.8663942,-51.3905121,17,4027
PR,FORMOSA DO OESTE,111,103,-8,-7.21,103,135,32,31.07,7,1,-6,-85.71,480,469,-11,-2.29,404,428,24,5.94,1105,1136,31,2.81,FORMOSA DO OESTE PR,-24.2966562,-53.312801,17,4029
PR,FRANCISCO ALVES,95,85,-10,-10.53,150,165,15,10.0,0,5,5,0.0,188,191,3,1.6,424,407,-17,-4.01,857,853,-4,-0.47,FRANCISCO ALVES PR,-24.0694395,-53.844348,17,4031
PR,FRANCISCO BELTRAO,424,395,-29,-6.84,6086,6354,268,4.4,1489,1754,265,17.8,6945,7116,171,2.46,11417,8931,-2486,-21.77,26361,24550,-1811,-6.87,FRANCISCO BELTRAO PR,-26.0790979,-53.0533527,17,4032
PR,FOZ DO JORDAO,50,69,19,38.0,76,17,-59,-77.63,4,49,45,1125.0,101,78,-23,-22.77,657,553,-104,-15.83,888,766,-122,-13.74,FOZ DO JORDAO PR,-25.7377144,-52.1209188,17,4033
PR,GENERAL CARNEIRO,278,293,15,5.4,276,260,-16,-5.8,164,148,-16,-9.76,543,564,21,3.87,622,578,-44,-7.07,1883,1843,-40,-2.12,GENERAL CARNEIRO PR,-26.422982,-51.3146691,17,4034
PR,GODOY MOREIRA,8,6,-2,-25.0,0,0,0,0.0,0,0,0,0.0,41,40,-1,-2.44,271,245,-26,-9.59,320,291,-29,-9.06,GODOY MOREIRA PR,-24.1925289,-51.9232662,17,4035
PR,GOIOERE,334,344,10,2.99,613,641,28,4.57,45,53,8,17.78,1909,1825,-84,-4.4,2399,2373,-26,-1.08,5300,5236,-64,-1.21,GOIOERE PR,-24.1851885,-53.0250623,17,4036
PR,GOIOXIM,85,93,8,9.41,48,17,-31,-64.58,2,0,-2,-100.0,123,153,30,24.39,332,319,-13,-3.92,590,582,-8,-1.36,GOIOXIM PR,-25.1987274,-51.9924229,17,4037
PR,GRANDES RIOS,145,133,-12,-8.28,36,39,3,8.33,1,3,2,200.0,138,141,3,2.17,374,345,-29,-7.75,694,661,-33,-4.76,GRANDES RIOS PR,-24.1454626,-51.5063628,17,4038
PR,GUAIRA,2649,2615,-34,-1.28,7610,7521,-89,-1.17,63,60,-3,-4.76,1722,1830,108,6.27,2985,2991,6,0.2,15029,15017,-12,-0.08,GUAIRA PR,-24.0851924,-54.2567519,17,4039
PR,GUAIRACA,330,376,46,13.94,158,206,48,30.38,2,7,5,250.0,183,181,-2,-1.09,380,373,-7,-1.84,1053,1143,90,8.55,GUAIRACA PR,-22.9352304,-52.6865101,17,4040
PR,GUAMIRANGA,15,12,-3,-20.0,149,169,20,13.42,10,15,5,50.0,173,165,-8,-4.62,417,378,-39,-9.35,764,739,-25,-3.27,GUAMIRANGA PR,-25.1909033,-50.8116961,17,4041
PR,GUAPIRAMA,106,123,17,16.04,87,81,-6,-6.9,0,0,0,0.0,158,175,17,10.76,302,287,-15,-4.97,653,666,13,1.99,GUAPIRAMA PR,-23.5164582,-50.0431538,17,4042
PR,GUAPOREMA,37,34,-3,-8.11,76,91,15,19.74,0,0,0,0.0,28,18,-10,-35.71,191,175,-16,-8.38,332,318,-14,-4.22,GUAPOREMA PR,-23.340218,-52.778605,17,4043
PR,GUARACI,267,251,-16,-5.99,1079,1193,114,10.57,4,26,22,550.0,256,252,-4,-1.56,851,848,-3,-0.35,2457,2570,113,4.6,GUARACI PR,-22.970394,-51.6479769,17,4044
PR,GUARANIACU,350,345,-5,-1.43,179,197,18,10.06,74,92,18,24.32,664,677,13,1.96,1154,1082,-72,-6.24,2421,2393,-28,-1.16,GUARANIACU PR,-25.10035,-52.867811,17,4045
PR,GUARAPUAVA,2883,3225,342,11.86,7064,7586,522,7.39,1754,2272,518,29.53,12492,12822,330,2.64,18625,18598,-27,-0.14,42818,44503,1685,3.94,GUARAPUAVA PR,-25.3950986,-51.4622016,17,4046
PR,GUARAQUECABA,57,54,-3,-5.26,47,41,-6,-12.77,0,4,4,0.0,89,86,-3,-3.37,450,411,-39,-8.67,643,596,-47,-7.31,GUARAQUECABA PR,-25.2983566,-48.3290185,17,4047
PR,GUARATUBA,132,138,6,4.55,180,197,17,9.44,153,178,25,16.34,2072,2239,167,8.06,4014,3811,-203,-5.06,6551,6563,12,0.18,GUARATUBA PR,-25.8806192,-48.5750905,17,4048
PR,HONORIO SERPA,162,145,-17,-10.49,92,99,7,7.61,28,32,4,14.29,139,143,4,2.88,300,297,-3,-1.0,721,716,-5,-0.69,HONORIO SERPA PR,-26.143149,-52.383794,17,4049
PR,IBAITI,1183,1278,95,8.03,885,1041,156,17.63,174,248,74,42.53,1188,1296,108,9.09,1863,2378,515,27.64,5293,6241,948,17.91,IBAITI PR,-23.8452962,-50.1905666,17,4050
PR,IBEMA,84,61,-23,-27.38,485,538,53,10.93,7,2,-5,-71.43,191,198,7,3.66,370,345,-25,-6.76,1137,1144,7,0.62,IBEMA PR,-25.1192916,-53.0071928,17,4051
PR,ICARAIMA,279,247,-32,-11.47,79,96,17,21.52,34,34,0,0.0,320,330,10,3.12,545,538,-7,-1.28,1257,1245,-12,-0.95,ICARAIMA PR,-23.3948345,-53.6162036,17,4053
PR,IGUATU,236,256,20,8.47,2957,2862,-95,-3.21,242,283,41,16.94,4409,4336,-73,-1.66,5951,5234,-717,-12.05,13795,12971,-824,-5.97,IGUATU PR,-24.7170385,-53.0865561,17,4055
PR,IMBAU,74,98,24,32.43,167,169,2,1.2,51,55,4,7.84,326,312,-14,-4.29,757,652,-105,-13.87,1375,1286,-89,-6.47,IMBAU PR,-24.447597,-50.7557188,17,4056
PR,IMBITUVA,267,263,-4,-1.5,3470,4300,830,23.92,55,62,7,12.73,1339,1332,-7,-0.52,1435,1466,31,2.16,6566,7423,857,13.05,IMBITUVA PR,-25.2293338,-50.6051002,17,4057
PR,INACIO MARTINS,207,195,-12,-5.8,309,369,60,19.42,46,36,-10,-21.74,299,313,14,4.68,530,528,-2,-0.38,1391,1441,50,3.59,INACIO MARTINS PR,-25.5725435,-51.0764637,17,4058
PR,INAJA,317,224,-93,-29.34,104,109,5,4.81,0,0,0,0.0,123,134,11,8.94,718,645,-73,-10.17,1262,1112,-150,-11.89,INAJA PR,-22.7530214,-52.1976067,17,4059
PR,INDIANOPOLIS,561,560,-1,-0.18,290,564,274,94.48,306,2187,1881,614.71,106,104,-2,-1.89,511,576,65,12.72,1774,3991,2217,124.97,INDIANOPOLIS PR,-23.4807249,-52.6987037,17,4060
PR,IPIRANGA,305,269,-36,-11.8,171,177,6,3.51,47,17,-30,-63.83,534,565,31,5.81,769,728,-41,-5.33,1826,1756,-70,-3.83,IPIRANGA PR,-25.0239759,-50.5854615,17,4061
PR,IPORA,142,133,-9,-6.34,437,417,-20,-4.58,15,144,129,860.0,632,582,-50,-7.91,882,857,-25,-2.83,2108,2133,25,1.19,IPORA PR,-24.0039474,-53.7100595,17,4062
PR,IRACEMA DO OESTE,76,69,-7,-9.21,21,31,10,47.62,0,0,0,0.0,60,64,4,6.67,203,170,-33,-16.26,360,334,-26,-7.22,IRACEMA DO OESTE PR,-24.427888,-53.3539137,17,4063
PR,IRATI,341,272,-69,-20.23,2817,2938,121,4.3,743,761,18,2.42,3446,3389,-57,-1.65,4416,4234,-182,-4.12,11763,11594,-169,-1.44,IRATI PR,-25.469663,-50.649287,17,4064
PR,IRETAMA,139,122,-17,-12.23,39,40,1,2.56,8,8,0,0.0,227,217,-10,-4.41,1133,959,-174,-15.36,1546,1346,-200,-12.94,IRETAMA PR,-24.4204859,-52.1021817,17,4065
PR,ITAGUAJE,40,43,3,7.5,0,0,0,0.0,0,0,0,0.0,114,66,-48,-42.11,323,441,118,36.53,477,550,73,15.3,ITAGUAJE PR,-22.618282,-51.967351,17,4066
PR,ITAIPULANDIA,299,323,24,8.03,1015,1413,398,39.21,121,106,-15,-12.4,368,366,-2,-0.54,705,642,-63,-8.94,2508,2850,342,13.64,ITAIPULANDIA PR,-25.1417007,-54.2980691,17,4067
PR,ITAMBARACA,152,177,25,16.45,81,131,50,61.73,0,5,5,0.0,88,80,-8,-9.09,403,364,-39,-9.68,724,757,33,4.56,ITAMBARACA PR,-23.0176678,-50.406887,17,4068
PR,ITAUNA DO SUL,33,29,-4,-12.12,69,105,36,52.17,11,6,-5,-45.45,39,42,3,7.69,293,260,-33,-11.26,445,442,-3,-0.67,ITAUNA DO SUL PR,-22.7302304,-52.8854393,17,4072
PR,IVAI,85,94,9,10.59,674,457,-217,-32.2,5,2,-3,-60.0,425,447,22,5.18,571,548,-23,-4.03,1760,1548,-212,-12.05,IVAI PR,-25.0069795,-50.8568896,17,4073
PR,IVAIPORA,136,142,6,4.41,348,388,40,11.49,149,92,-57,-38.26,2107,2054,-53,-2.52,3233,3028,-205,-6.34,5973,5704,-269,-4.5,IVAIPORA PR,-24.5748319,-51.34301961412225,17,4074
PR,IVATE,63,66,3,4.76,1326,1261,-65,-4.9,1,1,0,0.0,124,131,7,5.65,417,392,-25,-6.0,1931,1851,-80,-4.14,IVATE PR,-23.4084656,-53.3698352,17,4075
PR,IVATUBA,27,25,-2,-7.41,1,1,0,0.0,0,0,0,0.0,63,42,-21,-33.33,738,698,-40,-5.42,829,766,-63,-7.6,IVATUBA PR,-23.618722,-52.2174491,17,4076
PR,JABOTI,67,66,-1,-1.49,114,92,-22,-19.3,0,2,2,0.0,94,86,-8,-8.51,313,290,-23,-7.35,588,536,-52,-8.84,JABOTI PR,-23.7431092,-50.0748781,17,4077
PR,JACAREZINHO,1292,1331,39,3.02,3087,3009,-78,-2.53,143,169,26,18.18,1557,1546,-11,-0.71,4256,4554,298,7.0,10335,10609,274,2.65,JACAREZINHO PR,-23.159115,-49.973889,17,4078
PR,JAGUAPITA,574,690,116,20.21,4678,4869,191,4.08,23,52,29,126.09,368,351,-17,-4.62,909,820,-89,-9.79,6552,6782,230,3.51,JAGUAPITA PR,-23.1102516,-51.5327741,17,4079
PR,JAGUARIAIVA,825,791,-34,-4.12,2570,2816,246,9.57,427,709,282,66.04,1640,1699,59,3.6,3334,3307,-27,-0.81,8796,9322,526,5.98,JAGUARIAIVA PR,-24.2589699,-49.7201518,17,4080
PR,JANDAIA DO SUL,75,69,-6,-8.0,2189,2127,-62,-2.83,185,367,182,98.38,1391,1373,-18,-1.29,2054,2031,-23,-1.12,5894,5967,73,1.24,JANDAIA DO SUL PR,-23.6003907,-51.645674,17,4081
PR,JANIOPOLIS,123,124,1,0.81,54,44,-10,-18.52,0,0,0,0.0,227,208,-19,-8.37,332,365,33,9.94,736,741,5,0.68,JANIOPOLIS PR,-24.140124,-52.77836,17,4082
PR,JAPIRA,58,48,-10,-17.24,109,97,-12,-11.01,3,3,0,0.0,49,47,-2,-4.08,274,253,-21,-7.66,493,448,-45,-9.13,JAPIRA PR,-23.8119773,-50.1397133,17,4083
PR,JAPURA,0,2,2,0.0,13,4,-9,-69.23,0,0,0,0.0,16,19,3,18.75,13,8,-5,-38.46,42,33,-9,-21.43,JAPURA PR,-23.4700798,-52.5549029,17,4084
PR,JARDIM ALEGRE,63,54,-9,-14.29,76,60,-16,-21.05,46,75,29,63.04,442,558,116,26.24,674,743,69,10.24,1301,1490,189,14.53,JARDIM ALEGRE PR,-24.1795192,-51.6927177,17,4085
PR,JARDIM OLINDA,36,34,-2,-5.56,93,150,57,61.29,0,0,0,0.0,14,13,-1,-7.14,181,161,-20,-11.05,324,358,34,10.49,JARDIM OLINDA PR,-22.5520625,-52.036373,17,4086
PR,JESUITAS,121,110,-11,-9.09,225,217,-8,-3.56,2,6,4,200.0,403,378,-25,-6.2,570,580,10,1.75,1321,1291,-30,-2.27,JESUITAS PR,-24.3807263,-53.3855699,17,4088
PR,JOAQUIM TAVORA,91,108,17,18.68,3337,3557,220,6.59,17,18,1,5.88,531,573,42,7.91,1102,1017,-85,-7.71,5078,5273,195,3.84,JOAQUIM TAVORA PR,-23.4999724,-49.9232545,17,4089
PR,JUNDIAI DO SUL,140,138,-2,-1.43,2,1,-1,-50.0,4,2,-2,-50.0,38,38,0,0.0,198,204,6,3.03,382,383,1,0.26,JUNDIAI DO SUL PR,-23.4369861,-50.2478173,17,4090
PR,JURANDA,109,112,3,2.75,65,73,8,12.31,28,54,26,92.86,426,433,7,1.64,516,527,11,2.13,1144,1199,55,4.81,JURANDA PR,-24.420866,-52.841344,17,4091
PR,JUSSARA,6,7,1,16.67,10,6,-4,-40.0,0,0,0,0.0,73,74,1,1.37,513,463,-50,-9.75,602,550,-52,-8.64,JUSSARA PR,-23.621931,-52.46931,17,4092
PR,KALORE,35,31,-4,-11.43,143,138,-5,-3.5,0,0,0,0.0,154,180,26,16.88,354,346,-8,-2.26,686,695,9,1.31,KALORE PR,-23.8242643,-51.6683666,17,4093
PR,LARANJEIRAS DO SUL,246,252,6,2.44,978,1163,185,18.92,90,85,-5,-5.56,1674,1833,159,9.5,2612,2341,-271,-10.38,5600,5674,74,1.32,LARANJEIRAS DO SUL PR,-25.4073197,-52.4150132,17,4096
PR,LEOPOLIS,208,192,-16,-7.69,13,19,6,46.15,0,0,0,0.0,32,34,2,6.25,295,258,-37,-12.54,548,503,-45,-8.21,LEOPOLIS PR,-23.0789091,-50.7501808,17,4097
PR,LIDIANOPOLIS,60,64,4,6.67,13,11,-2,-15.38,6,6,0,0.0,103,110,7,6.8,288,307,19,6.6,470,498,28,5.96,LIDIANOPOLIS PR,-24.1073464,-51.6525676,17,4098
PR,LINDOESTE,162,203,41,25.31,61,73,12,19.67,6,3,-3,-50.0,134,152,18,13.43,365,351,-14,-3.84,728,782,54,7.42,LINDOESTE PR,-25.2608275,-53.5758136,17,4099
PR,LOANDA,219,239,20,9.13,2086,2416,330,15.82,26,46,20,76.92,1075,1097,22,2.05,1757,1750,-7,-0.4,5163,5548,385,7.46,LOANDA PR,-22.9320944,-53.1352452,17,4100
PR,LOBATO,41,42,1,2.44,278,272,-6,-2.16,4,7,3,75.0,80,65,-15,-18.75,345,317,-28,-8.12,748,703,-45,-6.02,LOBATO PR,-23.0077055,-51.9524309,17,4101
PR,LONDRINA,1606,2908,1302,81.07,19927,19321,-606,-3.04,8514,8494,-20,-0.23,41170,39904,-1266,-3.08,92053,89605,-2448,-2.66,163270,160232,-3038,-1.86,LONDRINA PR,-23.1778891,-50.646475,17,4102
PR,LUIZIANA,472,462,-10,-2.12,42,44,2,4.76,0,8,8,0.0,208,205,-3,-1.44,477,435,-42,-8.81,1199,1154,-45,-3.75,LUIZIANA PR,-24.2838237,-52.2767531,17,4103
PR,LUNARDELLI,71,68,-3,-4.23,17,18,1,5.88,2,1,-1,-50.0,123,114,-9,-7.32,304,291,-13,-4.28,517,492,-25,-4.84,LUNARDELLI PR,-24.0793542,-51.7421822,17,4104
PR,LUPIONOPOLIS,56,47,-9,-16.07,143,170,27,18.88,2,3,1,50.0,147,139,-8,-5.44,412,417,5,1.21,760,776,16,2.11,LUPIONOPOLIS PR,-22.7558205,-51.6575301,17,4105
PR,MALLET,171,153,-18,-10.53,1333,1319,-14,-1.05,2,4,2,100.0,449,465,16,3.56,972,955,-17,-1.75,2927,2896,-31,-1.06,MALLET PR,-25.8851656,-50.8268768,17,4106
PR,MAMBORE,476,469,-7,-1.47,96,98,2,2.08,18,29,11,61.11,676,674,-2,-0.3,842,839,-3,-0.36,2108,2109,1,0.05,MAMBORE PR,-24.3084433,-52.5298446,17,4107
PR,MANDAGUARI,307,306,-1,-0.33,6324,6884,560,8.86,89,104,15,16.85,1777,1845,68,3.83,2532,2652,120,4.74,11029,11791,762,6.91,MANDAGUARI PR,-23.5224849,-51.6787511,17,4109
PR,MANFRINOPOLIS,12,12,0,0.0,78,38,-40,-51.28,0,0,0,0.0,177,199,22,12.43,211,192,-19,-9.0,478,441,-37,-7.74,MANFRINOPOLIS PR,-26.1440729,-53.3113372,17,4111
PR,MANGUEIRINHA,366,363,-3,-0.82,446,331,-115,-25.78,12,18,6,50.0,824,951,127,15.41,1219,1309,90,7.38,2867,2972,105,3.66,MANGUEIRINHA PR,-25.9412009,-52.1740852,17,4112
PR,MANOEL RIBAS,112,106,-6,-5.36,308,306,-2,-0.65,12,15,3,25.0,656,677,21,3.2,796,754,-42,-5.28,1884,1858,-26,-1.38,MANOEL RIBAS PR,-24.5177239,-51.6685729,17,4113
PR,MARECHAL CANDIDO RONDON,535,558,23,4.3,5874,4133,-1741,-29.64,454,532,78,17.18,4351,4625,274,6.3,5500,5373,-127,-2.31,16714,15221,-1493,-8.93,MARECHAL CANDIDO RONDON PR,-24.5582532,-54.0587821,17,4114
PR,MARILANDIA DO SUL,217,211,-6,-2.76,160,149,-11,-6.88,12,35,23,191.67,255,252,-3,-1.18,542,550,8,1.48,1186,1197,11,0.93,MARILANDIA DO SUL PR,-23.7462425,-51.3021452,17,4117
PR,MARILUZ,128,134,6,4.69,42,42,0,0.0,1,4,3,300.0,233,224,-9,-3.86,489,454,-35,-7.16,893,858,-35,-3.92,MARILUZ PR,-24.0031216,-53.148113,17,4119
PR,MARINGA,518,574,56,10.81,26824,26404,-420,-1.57,9108,9455,347,3.81,38980,38053,-927,-2.38,85972,83567,-2405,-2.8,161402,158053,-3349,-2.07,MARINGA PR,-23.07916265,-52.46413707432433,17,4120
PR,MARIOPOLIS,196,201,5,2.55,137,154,17,12.41,21,10,-11,-52.38,308,321,13,4.22,536,509,-27,-5.04,1198,1195,-3,-0.25,MARIOPOLIS PR,-26.3518327,-52.5491563,17,4121
PR,MARIPA,107,102,-5,-4.67,428,425,-3,-0.7,22,17,-5,-22.73,256,274,18,7.03,482,469,-13,-2.7,1295,1287,-8,-0.62,MARIPA PR,-24.419978,-53.828641,17,4122
PR,MARMELEIRO,146,153,7,4.79,640,685,45,7.03,62,96,34,54.84,836,894,58,6.94,1047,1098,51,4.87,2731,2926,195,7.14,MARMELEIRO PR,-26.1472,-53.026741,17,4123
PR,MARQUINHO,37,40,3,8.11,24,31,7,29.17,4,9,5,125.0,72,71,-1,-1.39,221,223,2,0.9,358,374,16,4.47,MARQUINHO PR,-25.1133759,-52.2581854,17,4124
PR,MARUMBI,298,320,22,7.38,132,204,72,54.55,0,1,1,0.0,174,162,-12,-6.9,337,352,15,4.45,941,1039,98,10.41,MARUMBI PR,-23.7070343,-51.6408276,17,4125
PR,MATELANDIA,99,93,-6,-6.06,6603,8290,1687,25.55,58,31,-27,-46.55,670,648,-22,-3.28,1498,1426,-72,-4.81,8928,10488,1560,17.47,MATELANDIA PR,-25.2404183,-53.9835004,17,4126
PR,MATO RICO,51,48,-3,-5.88,0,0,0,0.0,0,0,0,0.0,43,43,0,0.0,30,291,261,870.0,124,382,258,208.06,MATO RICO PR,-24.7045571,-52.1493001,17,4128
PR,MAUA DA SERRA,126,115,-11,-8.73,699,565,-134,-19.17,36,37,1,2.78,338,337,-1,-0.3,725,790,65,8.97,1924,1844,-80,-4.16,MAUA DA SERRA PR,-23.9045517,-51.2261166,17,4129
PR,MEDIANEIRA,400,406,6,1.5,7590,7874,284,3.74,658,801,143,21.73,4253,4287,34,0.8,5009,4828,-181,-3.61,17910,18196,286,1.6,MEDIANEIRA PR,-25.2954233,-54.0940666,17,4130
PR,MERCEDES,61,73,12,19.67,232,289,57,24.57,2,4,2,100.0,303,284,-19,-6.27,421,414,-7,-1.66,1019,1064,45,4.42,MERCEDES PR,-24.4504957,-54.1647255,17,4131
PR,MIRADOR,29,70,41,141.38,1,0,-1,-100.0,7,0,-7,-100.0,131,143,12,9.16,433,450,17,3.93,601,663,62,10.32,MIRADOR PR,-23.257015,-52.7756432,17,4132
PR,MIRASELVA,17,15,-2,-11.76,4,4,0,0.0,1,1,0,0.0,27,30,3,11.11,193,192,-1,-0.52,242,242,0,0.0,MIRASELVA PR,-22.9675823,-51.4847793,17,4133
PR,MISSAL,81,63,-18,-22.22,296,308,12,4.05,22,15,-7,-31.82,516,547,31,6.01,870,798,-72,-8.28,1785,1731,-54,-3.03,MISSAL PR,-25.0913359,-54.2476738,17,4134
PR,MOREIRA SALES,275,297,22,8.0,640,157,-483,-75.47,11,9,-2,-18.18,289,277,-12,-4.15,684,657,-27,-3.95,1899,1397,-502,-26.43,MOREIRA SALES PR,-24.0509413,-53.0101722,17,4135
PR,MORRETES,129,117,-12,-9.3,282,289,7,2.48,31,12,-19,-61.29,428,584,156,36.45,1608,1508,-100,-6.22,2478,2510,32,1.29,MORRETES PR,-25.4770051,-48.8321911,17,4136
PR,MUNHOZ DE MELO,74,74,0,0.0,173,104,-69,-39.88,2,1,-1,-50.0,42,43,1,2.38,263,268,5,1.9,554,490,-64,-11.55,MUNHOZ DE MELO PR,-23.0158278,-49.9540397,17,4137
PR,NOVA AURORA,453,443,-10,-2.21,1296,1456,160,12.35,35,55,20,57.14,681,632,-49,-7.2,995,959,-36,-3.62,3460,3545,85,2.46,NOVA AURORA PR,-24.5282336,-53.2576703,17,4141
PR,NOVA CANTU,163,171,8,4.91,25,27,2,8.0,8,6,-2,-25.0,232,214,-18,-7.76,411,343,-68,-16.55,839,761,-78,-9.3,NOVA CANTU PR,-24.6739252,-52.5731265,17,4142
PR,NOVA ESPERANCA,316,290,-26,-8.23,1143,1177,34,2.97,110,100,-10,-9.09,1494,1477,-17,-1.14,1906,1874,-32,-1.68,4969,4918,-51,-1.03,NOVA ESPERANCA PR,-23.1818437,-52.1999852,17,4143
PR,NOVA ESPERANCA DO SUDOESTE,50,50,0,0.0,302,326,24,7.95,8,9,1,12.5,209,224,15,7.18,393,369,-24,-6.11,962,978,16,1.66,NOVA ESPERANCA DO SUDOESTE PR,-25.9004038,-53.2617627,17,4144
PR,NOVA FATIMA,9,5,-4,-44.44,29,44,15,51.72,0,21,21,0.0,81,73,-8,-9.88,449,418,-31,-6.9,568,561,-7,-1.23,NOVA FATIMA PR,-23.433056,-50.5618055,17,4145
PR,NOVA LARANJEIRAS,138,144,6,4.35,19,18,-1,-5.26,43,28,-15,-34.88,227,225,-2,-0.88,454,407,-47,-10.35,881,822,-59,-6.7,NOVA LARANJEIRAS PR,-25.305376,-52.544682,17,4146
PR,NOVA OLIMPIA,122,145,23,18.85,302,281,-21,-6.95,0,1,1,0.0,149,140,-9,-6.04,474,446,-28,-5.91,1047,1013,-34,-3.25,NOVA OLIMPIA PR,-23.4699403,-53.090112,17,4148
PR,NOVA SANTA BARBARA,20,88,68,340.0,65,75,10,15.38,0,0,0,0.0,82,90,8,9.76,274,252,-22,-8.03,441,505,64,14.51,NOVA SANTA BARBARA PR,-23.5860638,-50.7638011,17,4149
PR,NOVA SANTA ROSA,149,174,25,16.78,452,521,69,15.27,13,11,-2,-15.38,403,418,15,3.72,735,753,18,2.45,1752,1877,125,7.13,NOVA SANTA ROSA PR,-24.468132,-53.9547649,17,4150
PR,NOVA PRATA DO IGUACU,161,168,7,4.35,455,607,152,33.41,33,56,23,69.7,360,377,17,4.72,632,654,22,3.48,1641,1862,221,13.47,NOVA PRATA DO IGUACU PR,-25.6325323,-53.3463611,17,4151
PR,NOVA TEBAS,99,83,-16,-16.16,1,1,0,0.0,1,1,0,0.0,114,138,24,21.05,551,511,-40,-7.26,766,734,-32,-4.18,NOVA TEBAS PR,-24.437958,-51.945357,17,4152
PR,NOVO ITACOLOMI,36,35,-1,-2.78,221,219,-2,-0.9,19,7,-12,-63.16,48,49,1,2.08,265,263,-2,-0.75,589,573,-16,-2.72,NOVO ITACOLOMI PR,-23.7632302,-51.5074087,17,4153
PR,ORTIGUEIRA,765,1171,406,53.07,1320,2087,767,58.11,2097,4238,2141,102.1,549,522,-27,-4.92,1702,1776,74,4.35,6433,9794,3361,52.25,ORTIGUEIRA PR,-24.2088891,-50.925043,17,4154
PR,PALMAS,267,239,-28,-10.49,4234,4400,166,3.92,3775,3795,20,0.53,17673,17422,-251,-1.42,95078,97893,2815,2.96,121027,123749,2722,2.25,PALMAS PR,-26.483868,-51.988812,17,4158
PR,PALMEIRA,747,791,44,5.89,2456,2933,477,19.42,114,117,3,2.63,1460,1467,7,0.48,2578,2569,-9,-0.35,7355,7877,522,7.1,PALMEIRA PR,-25.4269718,-49.9987787,17,4159
PR,PALMITAL,572,507,-65,-11.36,831,872,41,4.93,25,19,-6,-24.0,1098,1118,20,1.82,1655,1575,-80,-4.83,4181,4091,-90,-2.15,PALMITAL PR,-24.8842985,-52.2113941,17,4160
PR,PALOTINA,742,808,66,8.89,7696,8585,889,11.55,127,138,11,8.66,3161,3219,58,1.83,3724,3865,141,3.79,15450,16615,1165,7.54,PALOTINA PR,-24.2839929,-53.8405463,17,4161
PR,PARAISO DO NORTE,1735,1904,169,9.74,1825,1953,128,7.01,13,14,1,7.69,351,303,-48,-13.68,780,841,61,7.82,4704,5015,311,6.61,PARAISO DO NORTE PR,-23.2800271,-52.601419,17,4162
PR,PARANACITY,65,55,-10,-15.38,1327,1328,1,0.08,31,22,-9,-29.03,225,179,-46,-20.44,629,645,16,2.54,2277,2229,-48,-2.11,PARANACITY PR,-22.9304971,-52.1523164,17,4163
PR,PARANAGUA,46,19,-27,-58.7,4270,4308,38,0.89,906,1007,101,11.15,7993,7582,-411,-5.14,26079,26674,595,2.28,39294,39590,296,0.75,PARANAGUA PR,-25.5148822,-48.5226695,17,4164
PR,PARANAPOEMA,111,97,-14,-12.61,147,138,-9,-6.12,2,0,-2,-100.0,40,41,1,2.5,191,161,-30,-15.71,491,437,-54,-11.0,PARANAPOEMA PR,-22.6561084,-52.0865163,17,4165
PR,PARANAVAI,1184,1245,61,5.15,5983,5988,5,0.08,857,949,92,10.74,5837,5755,-82,-1.4,8580,8434,-146,-1.7,22441,22371,-70,-0.31,PARANAVAI PR,-23.07916265,-52.46413707432433,17,4166
PR,PATO BRAGADO,90,98,8,8.89,522,465,-57,-10.92,45,35,-10,-22.22,296,298,2,0.68,489,479,-10,-2.04,1442,1375,-67,-4.65,PATO BRAGADO PR,-24.6270545,-54.2264587,17,4167
PR,PATO BRANCO,1014,1029,15,1.48,7661,7845,184,2.4,2648,2610,-38,-1.44,7452,7705,253,3.4,12031,12024,-7,-0.06,30806,31213,407,1.32,PATO BRANCO PR,-26.2295984,-52.6712474,17,4168
PR,PAULA FREITAS,118,125,7,5.93,137,187,50,36.5,63,40,-23,-36.51,279,317,38,13.62,349,358,9,2.58,946,1027,81,8.56,PAULA FREITAS PR,-26.2092739,-50.936462,17,4169
PR,PAULO FRONTIN,25,22,-3,-12.0,97,95,-2,-2.06,14,12,-2,-14.29,170,177,7,4.12,345,330,-15,-4.35,651,636,-15,-2.3,PAULO FRONTIN PR,-26.0399524,-50.8337759,17,4170
PR,PEABIRU,203,229,26,12.81,311,399,88,28.3,25,24,-1,-4.0,438,456,18,4.11,691,655,-36,-5.21,1668,1763,95,5.7,PEABIRU PR,-23.9142123,-52.3455598,17,4171
PR,PEROBAL,85,82,-3,-3.53,266,270,4,1.5,89,92,3,3.37,154,152,-2,-1.3,363,314,-49,-13.5,957,910,-47,-4.91,PEROBAL PR,-23.894861,-53.409838,17,4172
PR,PEROLA,37,31,-6,-16.22,1223,796,-427,-34.91,16,11,-5,-31.25,401,406,5,1.25,730,882,152,20.82,2407,2126,-281,-11.67,PEROLA PR,-23.8031666,-53.6824972,17,4173
PR,PIEN,66,58,-8,-12.12,1612,1801,189,11.72,25,85,60,240.0,335,376,41,12.24,880,744,-136,-15.45,2918,3064,146,5.0,PIEN PR,-26.0988916,-49.4297904,17,4175
PR,PINHALAO,56,52,-4,-7.14,141,96,-45,-31.91,13,38,25,192.31,130,119,-11,-8.46,98,315,217,221.43,438,620,182,41.55,PINHALAO PR,-23.7889966,-50.0577318,17,4177
PR,PINHAL DE SAO BENTO,8,19,11,137.5,95,79,-16,-16.84,1,1,0,0.0,21,24,3,14.29,211,223,12,5.69,336,346,10,2.98,PINHAL DE SAO BENTO PR,-26.0326418,-53.4837511,17,4178
PR,PINHAO,30,26,-4,-13.33,3,3,0,0.0,1,0,-1,-100.0,44,42,-2,-4.55,376,286,-90,-23.94,454,357,-97,-21.37,PINHAO PR,-25.6960895,-51.6566366,17,4179
PR,PIRAI DO SUL,848,777,-71,-8.37,1093,1115,22,2.01,351,28,-323,-92.02,649,688,39,6.01,1229,1172,-57,-4.64,4170,3780,-390,-9.35,PIRAI DO SUL PR,-24.5346602,-49.9399216,17,4180
PR,PITANGA,438,432,-6,-1.37,804,831,27,3.36,248,286,38,15.32,1640,1685,45,2.74,2551,2357,-194,-7.6,5681,5591,-90,-1.58,PITANGA PR,-24.759586,-51.7637582,17,4182
PR,PITANGUEIRAS,794,778,-16,-2.02,3710,3877,167,4.5,52,41,-11,-21.15,1269,1225,-44,-3.47,1976,2029,53,2.68,7801,7950,149,1.91,PITANGUEIRAS PR,-23.2313428,-51.587301,17,4183
PR,PLANALTINA DO PARANA,171,179,8,4.68,153,165,12,7.84,16,27,11,68.75,143,175,32,22.38,288,238,-50,-17.36,771,784,13,1.69,PLANALTINA DO PARANA PR,-23.0235277,-52.913283764436514,17,4184
PR,PLANALTO,122,133,11,9.02,24,19,-5,-20.83,10,15,5,50.0,396,376,-20,-5.05,1107,967,-140,-12.65,1659,1510,-149,-8.98,PLANALTO PR,-25.7184492,-53.767216,17,4185
PR,PONTA GROSSA,1636,1677,41,2.51,16243,17083,840,5.17,5667,10565,4898,86.43,22060,21492,-568,-2.57,42982,42386,-596,-1.39,88588,93203,4615,5.21,PONTA GROSSA PR,-25.0891685,-50.1601812,17,4186
PR,PORECATU,52,34,-18,-34.62,674,659,-15,-2.23,7,15,8,114.29,410,425,15,3.66,1068,1033,-35,-3.28,2211,2166,-45,-2.04,PORECATU PR,-22.753724,-51.37949,17,4188
PR,PORTO AMAZONAS,215,187,-28,-13.02,48,44,-4,-8.33,240,257,17,7.08,80,75,-5,-6.25,378,377,-1,-0.26,961,940,-21,-2.19,PORTO AMAZONAS PR,-25.5494226,-49.8973805,17,4189
PR,PORTO BARREIRO,33,28,-5,-15.15,0,0,0,0.0,3,4,1,33.33,60,62,2,3.33,230,205,-25,-10.87,326,299,-27,-8.28,PORTO BARREIRO PR,-25.5466703,-52.409026,17,4190
PR,PORTO RICO,59,88,29,49.15,23,24,1,4.35,19,28,9,47.37,87,84,-3,-3.45,408,394,-14,-3.43,596,618,22,3.69,PORTO RICO PR,-22.774742,-53.267731,17,4191
PR,PORTO VITORIA,48,45,-3,-6.25,204,171,-33,-16.18,13,11,-2,-15.38,36,41,5,13.89,282,254,-28,-9.93,583,522,-61,-10.46,PORTO VITORIA PR,-26.1605673,-51.2239397,17,4192
PR,PRADO FERREIRA,105,124,19,18.1,337,489,152,45.1,3,2,-1,-33.33,109,119,10,9.17,260,250,-10,-3.85,814,984,170,20.88,PRADO FERREIRA PR,-23.039784,-51.4431235,17,4193
PR,PRIMEIRO DE MAIO,121,110,-11,-9.09,274,277,3,1.09,5,3,-2,-40.0,327,370,43,13.15,628,619,-9,-1.43,1355,1379,24,1.77,PRIMEIRO DE MAIO PR,-22.851714,-51.029251,17,4196
PR,PRUDENTOPOLIS,282,331,49,17.38,1477,1514,37,2.51,357,466,109,30.53,2041,2204,163,7.99,2879,2711,-168,-5.84,7036,7226,190,2.7,PRUDENTOPOLIS PR,-25.203358,-50.9895774,17,4197
PR,QUARTO CENTENARIO,168,166,-2,-1.19,56,52,-4,-7.14,4,5,1,25.0,120,112,-8,-6.67,356,343,-13,-3.65,704,678,-26,-3.69,QUARTO CENTENARIO PR,-24.27904,-53.075881,17,4198
PR,QUATIGUA,33,35,2,6.06,346,423,77,22.25,1,0,-1,-100.0,456,386,-70,-15.35,706,713,7,0.99,1542,1557,15,0.97,QUATIGUA PR,-23.5669626,-49.9160315,17,4199
PR,QUATRO PONTES,187,208,21,11.23,391,376,-15,-3.84,4,6,2,50.0,146,151,5,3.42,396,399,3,0.76,1124,1140,16,1.42,QUATRO PONTES PR,-24.5741062,-53.9780237,17,4201
PR,QUEDAS DO IGUACU,186,178,-8,-4.3,2540,2345,-195,-7.68,108,52,-56,-51.85,1259,1295,36,2.86,1579,1575,-4,-0.25,5672,5445,-227,-4.0,QUEDAS DO IGUACU PR,-25.453001,-52.9090429,17,4202
PR,QUERENCIA DO NORTE,183,186,3,1.64,157,143,-14,-8.92,11,7,-4,-36.36,289,234,-55,-19.03,615,596,-19,-3.09,1255,1166,-89,-7.09,QUERENCIA DO NORTE PR,-23.083758,-53.483022,17,4203
PR,QUINTA DO SOL,133,119,-14,-10.53,15,10,-5,-33.33,2,2,0,0.0,173,170,-3,-1.73,361,222,-139,-38.5,684,523,-161,-23.54,QUINTA DO SOL PR,-23.8494169,-52.1334452,17,4204
PR,QUITANDINHA,28,27,-1,-3.57,239,254,15,6.28,18,20,2,11.11,479,488,9,1.88,801,818,17,2.12,1565,1607,42,2.68,QUITANDINHA PR,-25.8737269,-49.4977717,17,4205
PR,RAMILANDIA,53,50,-3,-5.66,6,6,0,0.0,10,34,24,240.0,63,71,8,12.7,231,203,-28,-12.12,363,364,1,0.28,RAMILANDIA PR,-25.1190203,-54.0301175,17,4206
PR,RANCHO ALEGRE,137,137,0,0.0,29,64,35,120.69,1,3,2,200.0,67,68,1,1.49,208,205,-3,-1.44,442,477,35,7.92,RANCHO ALEGRE PR,-23.070922,-50.9142676,17,4207
PR,REALEZA,147,146,-1,-0.68,683,729,46,6.73,314,310,-4,-1.27,1265,1354,89,7.04,1538,1407,-131,-8.52,3947,3946,-1,-0.03,REALEZA PR,-25.7720262,-53.5338306,17,4209
PR,REBOUCAS,196,83,-113,-57.65,597,616,19,3.18,59,33,-26,-44.07,404,410,6,1.49,774,765,-9,-1.16,2030,1907,-123,-6.06,REBOUCAS PR,-25.6259339,-50.6946598,17,4210
PR,RENASCENCA,76,76,0,0.0,289,321,32,11.07,17,11,-6,-35.29,355,365,10,2.82,387,377,-10,-2.58,1124,1150,26,2.31,RENASCENCA PR,-26.158837,-52.970349,17,4211
PR,RESERVA,634,577,-57,-8.99,468,403,-65,-13.89,63,74,11,17.46,1034,1058,24,2.32,1426,1353,-73,-5.12,3625,3465,-160,-4.41,RESERVA PR,-24.6545336,-50.8484432,17,4212
PR,RESERVA DO IGUACU,165,149,-16,-9.7,110,108,-2,-1.82,22,9,-13,-59.09,113,112,-1,-0.88,420,401,-19,-4.52,830,779,-51,-6.14,RESERVA DO IGUACU PR,-25.8365103,-52.028256,17,4213
PR,RIBEIRAO CLARO,345,302,-43,-12.46,758,755,-3,-0.4,19,27,8,42.11,404,404,0,0.0,1073,1054,-19,-1.77,2599,2542,-57,-2.19,RIBEIRAO CLARO PR,-23.1960492,-49.7568326,17,4214
PR,RIBEIRAO DO PINHAL,200,177,-23,-11.5,202,170,-32,-15.84,5,4,-1,-20.0,324,317,-7,-2.16,742,761,19,2.56,1473,1429,-44,-2.99,RIBEIRAO DO PINHAL PR,-23.4063092,-50.3581945,17,4215
PR,RIO AZUL,32,35,3,9.38,651,667,16,2.46,21,22,1,4.76,424,434,10,2.36,717,736,19,2.65,1845,1894,49,2.66,RIO AZUL PR,-25.726644,-50.790534,17,4216
PR,RIO BOM,56,48,-8,-14.29,46,43,-3,-6.52,1,1,0,0.0,55,57,2,3.64,422,353,-69,-16.35,580,502,-78,-13.45,RIO BOM PR,-23.7618456,-51.4127871,17,4217
PR,RIO BONITO DO IGUACU,59,53,-6,-10.17,24,30,6,25.0,18,14,-4,-22.22,419,392,-27,-6.44,654,611,-43,-6.57,1174,1100,-74,-6.3,RIO BONITO DO IGUACU PR,-25.4903906,-52.5262069,17,4218
PR,RIO BRANCO DO IVAI,66,64,-2,-3.03,14,14,0,0.0,17,8,-9,-52.94,80,73,-7,-8.75,279,278,-1,-0.36,456,437,-19,-4.17,RIO BRANCO DO IVAI PR,-24.3193396,-51.3139672,17,4219
PR,ROLANDIA,662,605,-57,-8.61,10950,12070,1120,10.23,313,376,63,20.13,3647,3597,-50,-1.37,4921,4808,-113,-2.3,20493,21456,963,4.7,ROLANDIA PR,-23.3119901,-51.3674145,17,4222
PR,RONCADOR,397,358,-39,-9.82,35,37,2,5.71,56,43,-13,-23.21,392,416,24,6.12,738,689,-49,-6.64,1618,1543,-75,-4.64,RONCADOR PR,-24.5952165,-52.2710073,17,4223
PR,RONDON,165,158,-7,-4.24,1565,1717,152,9.71,14,16,2,14.29,273,243,-30,-10.99,598,743,145,24.25,2615,2877,262,10.02,RONDON PR,-23.4171839,-52.7722221,17,4224
PR,ROSARIO DO IVAI,85,90,5,5.88,26,39,13,50.0,5,3,-2,-40.0,211,209,-2,-0.95,366,367,1,0.27,693,708,15,2.16,ROSARIO DO IVAI PR,-24.2545374,-51.2505025,17,4225
PR,SABAUDIA,174,176,2,1.15,1922,2073,151,7.86,41,42,1,2.44,271,303,32,11.81,1488,1430,-58,-3.9,3896,4024,128,3.29,SABAUDIA PR,-23.319019,-51.5544109,17,4226
PR,SALGADO FILHO,34,22,-12,-35.29,345,111,-234,-67.83,10,6,-4,-40.0,89,89,0,0.0,264,235,-29,-10.98,742,463,-279,-37.6,SALGADO FILHO PR,-26.1732041,-53.3619195,17,4227
PR,SALTO DO ITARARE,25,23,-2,-8.0,357,211,-146,-40.9,0,0,0,0.0,69,50,-19,-27.54,290,289,-1,-0.34,741,573,-168,-22.67,SALTO DO ITARARE PR,-23.6038767,-49.626581,17,4228
PR,SALTO DO LONTRA,261,233,-28,-10.73,633,570,-63,-9.95,186,393,207,111.29,608,598,-10,-1.64,827,829,2,0.24,2515,2623,108,4.29,SALTO DO LONTRA PR,-25.7815642,-53.3085197,17,4229
PR,SANTA AMELIA,74,102,28,37.84,46,68,22,47.83,3,0,-3,-100.0,62,62,0,0.0,231,222,-9,-3.9,416,454,38,9.13,SANTA AMELIA PR,-23.2661996,-50.4278622,17,4230
PR,SANTA CECILIA DO PAVAO,64,68,4,6.25,55,56,1,1.82,0,0,0,0.0,78,81,3,3.85,295,258,-37,-12.54,492,463,-29,-5.89,SANTA CECILIA DO PAVAO PR,-23.5176577,-50.7837199,17,4231
PR,SANTA CRUZ DE MONTE CASTELO,156,147,-9,-5.77,150,186,36,24.0,2,0,-2,-100.0,250,248,-2,-0.8,721,636,-85,-11.79,1279,1217,-62,-4.85,SANTA CRUZ DE MONTE CASTELO PR,-22.9582028,-53.294859,17,4232
PR,SANTA FE,80,75,-5,-6.25,1075,959,-116,-10.79,17,17,0,0.0,564,523,-41,-7.27,866,894,28,3.23,2602,2468,-134,-5.15,SANTA FE PR,-23.039993,-51.808014,17,4233
PR,SANTA HELENA,0,0,0,0.0,16,14,-2,-12.5,0,0,0,0.0,243,203,-40,-16.46,1329,1616,287,21.6,1588,1833,245,15.43,SANTA HELENA PR,-24.8591735,-54.3328813,17,4234
PR,SANTA INES,184,187,3,1.63,176,231,55,31.25,101,112,11,10.89,4397,4456,59,1.34,4924,4549,-375,-7.62,9782,9535,-247,-2.53,SANTA INES PR,-22.640225,-51.9031333,17,4235
PR,SANTA ISABEL DO IVAI,140,139,-1,-0.71,436,462,26,5.96,13,15,2,15.38,242,235,-7,-2.89,581,560,-21,-3.61,1412,1411,-1,-0.07,SANTA ISABEL DO IVAI PR,-23.0013818,-53.1940876,17,4236
PR,SANTA IZABEL DO OESTE,197,177,-20,-10.15,680,671,-9,-1.32,97,88,-9,-9.28,514,566,52,10.12,757,762,5,0.66,2245,2264,19,0.85,SANTA IZABEL DO OESTE PR,-25.821652,-53.480146,17,4237
PR,SANTA LUCIA,78,79,1,1.28,30,19,-11,-36.67,51,18,-33,-64.71,68,80,12,17.65,392,387,-5,-1.28,619,583,-36,-5.82,SANTA LUCIA PR,-25.4079427,-53.5677252,17,4238
PR,SANTA MARIA DO OESTE,102,103,1,0.98,72,59,-13,-18.06,9,14,5,55.56,186,177,-9,-4.84,504,428,-76,-15.08,873,781,-92,-10.54,SANTA MARIA DO OESTE PR,-24.9392355,-51.8712242,17,4239
PR,SANTA MARIANA,414,338,-76,-18.36,72,76,4,5.56,9,5,-4,-44.44,400,403,3,0.75,781,733,-48,-6.15,1676,1555,-121,-7.22,SANTA MARIANA PR,-23.1499367,-50.5199587,17,4240
PR,SANTA MONICA,109,107,-2,-1.83,178,189,11,6.18,0,2,2,0.0,31,35,4,12.9,282,251,-31,-10.99,600,584,-16,-2.67,SANTA MONICA PR,-23.1085921,-53.1103971,17,4241
PR,SANTANA DO ITARARE,107,108,1,0.93,81,71,-10,-12.35,0,0,0,0.0,113,115,2,1.77,351,307,-44,-12.54,652,601,-51,-7.82,SANTANA DO ITARARE PR,-23.7566225,-49.6292826,17,4242
PR,SANTO ANTONIO DA PLATINA,555,525,-30,-5.41,2930,2587,-343,-11.71,277,171,-106,-38.27,2638,2610,-28,-1.06,3678,3682,4,0.11,10078,9575,-503,-4.99,SANTO ANTONIO DA PLATINA PR,-23.2957157,-50.0778957,17,4245
PR,SANTO ANTONIO DO CAIUA,108,109,1,0.93,11,11,0,0.0,1,3,2,200.0,37,36,-1,-2.7,273,240,-33,-12.09,430,399,-31,-7.21,SANTO ANTONIO DO CAIUA PR,-22.7365132,-52.3446998,17,4246
PR,SANTO ANTONIO DO PARAISO,143,143,0,0.0,14,18,4,28.57,0,6,6,0.0,32,32,0,0.0,252,249,-3,-1.19,441,448,7,1.59,SANTO ANTONIO DO PARAISO PR,-23.4949247,-50.6468656,17,4247
PR,SANTO INACIO,102,87,-15,-14.71,3221,3617,396,12.29,2,2,0,0.0,155,198,43,27.74,472,454,-18,-3.81,3952,4358,406,10.27,SANTO INACIO PR,-22.6973239,-51.792679,17,4249
PR,SAO CARLOS DO IVAI,79,108,29,36.71,1081,964,-117,-10.82,5,15,10,200.0,133,124,-9,-6.77,489,505,16,3.27,1787,1716,-71,-3.97,SAO CARLOS DO IVAI PR,-23.315828,-52.476143,17,4250
PR,SAO JERONIMO DA SERRA,176,151,-25,-14.2,12,14,2,16.67,0,0,0,0.0,163,152,-11,-6.75,571,557,-14,-2.45,922,874,-48,-5.21,SAO JERONIMO DA SERRA PR,-23.7221275,-50.7389164,17,4251
PR,SAO JOAO,15,10,-5,-33.33,17,15,-2,-11.76,8,12,4,50.0,253,292,39,15.42,1102,832,-270,-24.5,1395,1161,-234,-16.77,SAO JOAO PR,-25.6164631,-53.6928707,17,4252
PR,SAO JOAO DO CAIUA,156,165,9,5.77,63,62,-1,-1.59,17,16,-1,-5.88,120,110,-10,-8.33,344,316,-28,-8.14,700,669,-31,-4.43,SAO JOAO DO CAIUA PR,-22.8544849,-52.3371114,17,4253
PR,SAO JOAO DO IVAI,97,93,-4,-4.12,65,101,36,55.38,1,1,0,0.0,496,480,-16,-3.23,738,763,25,3.39,1397,1438,41,2.93,SAO JOAO DO IVAI PR,-23.9914063,-51.8232148,17,4254
PR,SAO JOAO DO TRIUNFO,191,134,-57,-29.84,37,50,13,35.14,18,4,-14,-77.78,234,222,-12,-5.13,612,596,-16,-2.61,1092,1006,-86,-7.88,SAO JOAO DO TRIUNFO PR,-25.682971,-50.29492,17,4255
PR,SAO JORGE DO IVAI,225,220,-5,-2.22,31,36,5,16.13,5,3,-2,-40.0,232,251,19,8.19,452,415,-37,-8.19,945,925,-20,-2.12,SAO JORGE DO IVAI PR,-23.4327325,-52.2924553,17,4257
PR,SAO JORGE DO PATROCINIO,68,69,1,1.47,368,392,24,6.52,2,5,3,150.0,195,159,-36,-18.46,411,402,-9,-2.19,1044,1027,-17,-1.63,SAO JORGE DO PATROCINIO PR,-23.7612908,-53.8806252,17,4258
PR,SAO JOSE DA BOA VISTA,66,70,4,6.06,271,225,-46,-16.97,2,1,-1,-50.0,96,103,7,7.29,335,337,2,0.6,770,736,-34,-4.42,SAO JOSE DA BOA VISTA PR,-23.9171872,-49.6508016,17,4259
PR,SAO JOSE DAS PALMEIRAS,79,89,10,12.66,20,16,-4,-20.0,48,55,7,14.58,116,82,-34,-29.31,250,249,-1,-0.4,513,491,-22,-4.29,SAO JOSE DAS PALMEIRAS PR,-24.8350864,-54.0621488,17,4260
PR,SAO MANOEL DO PARANA,152,158,6,3.95,82,120,38,46.34,0,0,0,0.0,12,15,3,25.0,242,227,-15,-6.2,488,520,32,6.56,SAO MANOEL DO PARANA PR,-23.394137,-52.645376,17,4262
PR,SAO MATEUS DO SUL,562,567,5,0.89,1642,1665,23,1.4,81,154,73,90.12,2612,2568,-44,-1.68,3402,3429,27,0.79,8299,8383,84,1.01,SAO MATEUS DO SUL PR,-25.866823,-50.382796,17,4263
PR,SAO MIGUEL DO IGUACU,562,525,-37,-6.58,1362,1555,193,14.17,356,399,43,12.08,1393,1390,-3,-0.22,2604,2450,-154,-5.91,6277,6319,42,0.67,SAO MIGUEL DO IGUACU PR,-25.349171,-54.240498,17,4264
PR,SAO PEDRO DO IGUACU,115,106,-9,-7.83,41,49,8,19.51,2,2,0,0.0,187,174,-13,-6.95,341,307,-34,-9.97,686,638,-48,-7.0,SAO PEDRO DO IGUACU PR,-24.9341766,-53.8579529,17,4265
PR,SAO PEDRO DO IVAI,652,618,-34,-5.21,573,593,20,3.49,40,39,-1,-2.5,300,306,6,2.0,557,492,-65,-11.67,2122,2048,-74,-3.49,SAO PEDRO DO IVAI PR,-23.8660384,-51.8563711,17,4266
PR,SAO PEDRO DO PARANA,49,63,14,28.57,148,190,42,28.38,0,1,1,0.0,38,33,-5,-13.16,301,369,68,22.59,536,656,120,22.39,SAO PEDRO DO PARANA PR,-22.8240967,-53.222755,17,4267
PR,SAO SEBASTIAO DA AMOREIRA,87,64,-23,-26.44,70,79,9,12.86,1,1,0,0.0,432,287,-145,-33.56,434,436,2,0.46,1024,867,-157,-15.33,SAO SEBASTIAO DA AMOREIRA PR,-23.4647501,-50.7605173,17,4268
PR,SAO TOME,1,1,0,0.0,4,3,-1,-25.0,0,2,2,0.0,114,107,-7,-6.14,575,396,-179,-31.13,694,509,-185,-26.66,SAO TOME PR,-23.534946,-52.590125,17,4269
PR,SAPOPEMA,94,90,-4,-4.26,350,211,-139,-39.71,2,1,-1,-50.0,114,110,-4,-3.51,384,498,114,29.69,944,910,-34,-3.6,SAPOPEMA PR,-23.9105099,-50.5791315,17,4270
PR,SAUDADE DO IGUACU,57,59,2,3.51,357,332,-25,-7.0,46,57,11,23.91,117,101,-16,-13.68,491,480,-11,-2.24,1068,1029,-39,-3.65,SAUDADE DO IGUACU PR,-25.6915533,-52.6184857,17,4272
PR,SENGES,836,877,41,4.9,1762,2047,285,16.17,21,8,-13,-61.9,521,529,8,1.54,1093,1210,117,10.7,4233,4671,438,10.35,SENGES PR,-24.1141771,-49.4644197,17,4273
PR,SERRANOPOLIS DO IGUACU,78,85,7,8.97,55,78,23,41.82,6,5,-1,-16.67,148,160,12,8.11,373,384,11,2.95,660,712,52,7.88,SERRANOPOLIS DO IGUACU PR,-25.3798835,-54.0538801,17,4274
PR,SERTANEJA,229,223,-6,-2.62,90,86,-4,-4.44,65,101,36,55.38,197,172,-25,-12.69,472,459,-13,-2.75,1053,1041,-12,-1.14,SERTANEJA PR,-23.0367627,-50.816802,17,4275
PR,SERTANOPOLIS,339,351,12,3.54,887,909,22,2.48,97,75,-22,-22.68,830,806,-24,-2.89,1702,1678,-24,-1.41,3855,3819,-36,-0.93,SERTANOPOLIS PR,-23.0600434,-51.0373544,17,4276
PR,SIQUEIRA CAMPOS,112,97,-15,-13.39,3834,4206,372,9.7,112,116,4,3.57,905,884,-21,-2.32,1400,1363,-37,-2.64,6363,6666,303,4.76,SIQUEIRA CAMPOS PR,-23.687481,-49.830416,17,4277
PR,SULINA,23,24,1,4.35,73,90,17,23.29,1,3,2,200.0,78,81,3,3.85,263,233,-30,-11.41,438,431,-7,-1.6,SULINA PR,-25.7001327,-52.7207833,17,4278
PR,TAMARANA,264,261,-3,-1.14,260,242,-18,-6.92,14,22,8,57.14,407,403,-4,-0.98,737,698,-39,-5.29,1682,1626,-56,-3.33,TAMARANA PR,-23.7223793,-51.0936013,17,4279
PR,TAMBOARA,69,42,-27,-39.13,268,259,-9,-3.36,6,9,3,50.0,75,63,-12,-16.0,356,348,-8,-2.25,774,721,-53,-6.85,TAMBOARA PR,-23.1995071,-52.5000131,17,4280
PR,TAPEJARA,262,230,-32,-12.21,3285,3025,-260,-7.91,59,36,-23,-38.98,405,422,17,4.2,884,864,-20,-2.26,4895,4577,-318,-6.5,TAPEJARA PR,-23.7334411,-52.8701739,17,4281
PR,TAPIRA,317,292,-25,-7.89,843,824,-19,-2.25,387,443,56,14.47,59,54,-5,-8.47,643,366,-277,-43.08,2249,1979,-270,-12.01,TAPIRA PR,-23.323146,-53.0712033,17,4282
PR,TEIXEIRA SOARES,335,350,15,4.48,52,54,2,3.85,3,11,8,266.67,252,242,-10,-3.97,660,861,201,30.45,1302,1518,216,16.59,TEIXEIRA SOARES PR,-25.3719287,-50.4586285,17,4283
PR,TELEMACO BORBA,596,661,65,10.91,7986,7975,-11,-0.14,608,769,161,26.48,3205,3308,103,3.21,7183,7031,-152,-2.12,19578,19744,166,0.85,TELEMACO BORBA PR,-24.3282939,-50.6318021,17,4284
PR,TERRA BOA,191,177,-14,-7.33,2912,2881,-31,-1.06,42,26,-16,-38.1,469,472,3,0.64,1161,1176,15,1.29,4775,4732,-43,-0.9,TERRA BOA PR,-23.768329,-52.447002,17,4285
PR,TERRA RICA,246,262,16,6.5,1203,1150,-53,-4.41,12,12,0,0.0,442,417,-25,-5.66,914,841,-73,-7.99,2817,2682,-135,-4.79,TERRA RICA PR,-22.7264874,-52.6202541,17,4286
PR,TERRA ROXA,206,278,72,34.95,179,169,-10,-5.59,2,1,-1,-50.0,236,234,-2,-0.85,601,536,-65,-10.82,1224,1218,-6,-0.49,TERRA ROXA PR,-24.1670468,-54.097432,17,4287
PR,TIBAGI,1203,1232,29,2.41,187,171,-16,-8.56,120,87,-33,-27.5,680,632,-48,-7.06,1157,1055,-102,-8.82,3347,3177,-170,-5.08,TIBAGI PR,-24.5151667,-50.4101487,17,4288
PR,TIJUCAS DO SUL,255,249,-6,-2.35,305,379,74,24.26,70,71,1,1.43,610,567,-43,-7.05,1002,968,-34,-3.39,2242,2234,-8,-0.36,TIJUCAS DO SUL PR,-25.9273376,-49.179265,17,4289
PR,TOLEDO,21,11,-10,-47.62,94,96,2,2.13,7,16,9,128.57,138,131,-7,-5.07,350,461,111,31.71,610,715,105,17.21,TOLEDO PR,-24.7222438,-53.7402476,17,4290
PR,TOMAZINA,211,151,-60,-28.44,151,131,-20,-13.25,116,123,7,6.03,149,155,6,4.03,554,536,-18,-3.25,1181,1096,-85,-7.2,TOMAZINA PR,-23.7777942,-49.9546482,17,4291
PR,TRES BARRAS DO PARANA,129,142,13,10.08,439,449,10,2.28,62,91,29,46.77,369,374,5,1.36,739,656,-83,-11.23,1738,1712,-26,-1.5,TRES BARRAS DO PARANA PR,-25.4212699,-53.1837577,17,4292
PR,TUNAS DO PARANA,130,248,118,90.77,236,198,-38,-16.1,5,4,-1,-20.0,134,146,12,8.96,489,468,-21,-4.29,994,1064,70,7.04,TUNAS DO PARANA PR,-24.9761456,-49.0854528,17,4293
PR,TUNEIRAS DO OESTE,91,97,6,6.59,80,69,-11,-13.75,12,21,9,75.0,126,137,11,8.73,491,503,12,2.44,800,827,27,3.38,TUNEIRAS DO OESTE PR,-23.8672329,-52.8749376,17,4294
PR,TUPASSI,120,118,-2,-1.67,193,175,-18,-9.33,17,23,6,35.29,435,417,-18,-4.14,490,499,9,1.84,1255,1232,-23,-1.83,TUPASSI PR,-24.5857992,-53.5129537,17,4295
PR,TURVO,140,230,90,64.29,775,831,56,7.23,21,17,-4,-19.05,451,446,-5,-1.11,833,828,-5,-0.6,2220,2352,132,5.95,TURVO PR,-25.043933,-51.5392172,17,4296
PR,UBIRATA,198,200,2,1.01,4157,4867,710,17.08,80,136,56,70.0,1421,1514,93,6.54,2171,2314,143,6.59,8027,9031,1004,12.51,UBIRATA PR,-24.542725,-52.9899678,17,4297
PR,UMUARAMA,596,572,-24,-4.03,4786,6171,1385,28.94,1649,1649,0,0.0,9648,9444,-204,-2.11,13553,13149,-404,-2.98,30232,30985,753,2.49,UMUARAMA PR,-23.61229115,-53.20563471403803,17,4298
PR,UNIFLOR,53,48,-5,-9.43,80,72,-8,-10.0,9,7,-2,-22.22,42,43,1,2.38,294,210,-84,-28.57,478,380,-98,-20.5,UNIFLOR PR,-23.0853871,-52.1584403,17,4300
PR,URAI,248,225,-23,-9.27,177,171,-6,-3.39,3,0,-3,-100.0,406,428,22,5.42,656,672,16,2.44,1490,1496,6,0.4,URAI PR,-23.199997,-50.793873,17,4301
PR,WENCESLAU BRAZ,39,40,1,2.56,93,112,19,20.43,1,0,-1,-100.0,17,15,-2,-11.76,121,93,-28,-23.14,271,260,-11,-4.06,WENCESLAU BRAZ PR,-23.8748841,-49.8035872,17,4302
PR,VENTANIA,873,952,79,9.05,90,171,81,90.0,2,2,0,0.0,179,174,-5,-2.79,646,656,10,1.55,1790,1955,165,9.22,VENTANIA PR,-24.2470771,-50.245452,17,4303
PR,VERA CRUZ DO OESTE,180,176,-4,-2.22,87,96,9,10.34,5,0,-5,-100.0,262,253,-9,-3.44,576,571,-5,-0.87,1110,1096,-14,-1.26,VERA CRUZ DO OESTE PR,-25.058614,-53.8785648,17,4304
PR,VERE,39,36,-3,-7.69,343,385,42,12.24,7,9,2,28.57,411,411,0,0.0,655,633,-22,-3.36,1455,1474,19,1.31,VERE PR,-25.8812309,-52.9081757,17,4305
PR,ALTO PARAISO,142,154,12,8.45,126,82,-44,-34.92,3,7,4,133.33,365,407,42,11.51,778,656,-122,-15.68,1414,1306,-108,-7.64,ALTO PARAISO PR,-23.508137,-53.728537,17,4306
PR,DOUTOR ULYSSES,52,58,6,11.54,2,2,0,0.0,7,4,-3,-42.86,37,33,-4,-10.81,315,292,-23,-7.3,413,389,-24,-5.81,DOUTOR ULYSSES PR,-24.5661713,-49.4203013,17,4307
PR,VIRMOND,47,37,-10,-21.28,106,110,4,3.77,0,0,0,0.0,108,106,-2,-1.85,252,236,-16,-6.35,513,489,-24,-4.68,VIRMOND PR,-25.3816653,-52.2034599,17,4308
PR,XAMBRE,81,72,-9,-11.11,172,172,0,0.0,2,9,7,350.0,75,82,7,9.33,398,405,7,1.76,728,740,12,1.65,XAMBRE PR,-23.7361723,-53.4881707,17,4310
SC,ABDON BATISTA,9,14,5,55.56,52,46,-6,-11.54,10,6,-4,-40.0,105,123,18,17.14,323,291,-32,-9.91,499,480,-19,-3.81,ABDON BATISTA SC,-27.612419,-51.022992,23,4311
SC,ABELARDO LUZ,400,390,-10,-2.5,1668,1872,204,12.23,164,185,21,12.8,731,716,-15,-2.05,1254,1194,-60,-4.78,4217,4357,140,3.32,ABELARDO LUZ SC,-26.5705893,-52.3280339,23,4312
SC,AGROLANDIA,36,33,-3,-8.33,2024,2116,92,4.55,15,16,1,6.67,352,346,-6,-1.7,545,528,-17,-3.12,2972,3039,67,2.25,AGROLANDIA SC,-27.4120688,-49.8294621,23,4313
SC,AGUA DOCE,391,437,46,11.76,381,412,31,8.14,16,11,-5,-31.25,200,199,-1,-0.5,756,736,-20,-2.65,1744,1795,51,2.92,AGUA DOCE SC,-26.9986047,-51.5529306,23,4315
SC,AGUAS FRIAS,33,40,7,21.21,187,217,30,16.04,26,14,-12,-46.15,152,175,23,15.13,180,144,-36,-20.0,578,590,12,2.08,AGUAS FRIAS SC,-26.8817187,-52.8599756,23,4317
SC,ALFREDO WAGNER,45,48,3,6.67,125,111,-14,-11.2,17,16,-1,-5.88,488,488,0,0.0,529,503,-26,-4.91,1204,1166,-38,-3.16,ALFREDO WAGNER SC,-27.6950606,-49.3310844,23,4319
SC,ALTO BELA VISTA,11,10,-1,-9.09,82,75,-7,-8.54,20,21,1,5.0,47,33,-14,-29.79,181,148,-33,-18.23,341,287,-54,-15.84,ALTO BELA VISTA SC,-27.4320737,-51.905771,23,4320
SC,ANCHIETA,125,122,-3,-2.4,1593,1450,-143,-8.98,396,427,31,7.83,886,926,40,4.51,3406,2679,-727,-21.34,6406,5604,-802,-12.52,ANCHIETA SC,-26.5350527,-53.3293938,23,4321
SC,ANGELINA,10,8,-2,-20.0,59,90,31,52.54,97,173,76,78.35,176,162,-14,-7.95,419,374,-45,-10.74,761,807,46,6.04,ANGELINA SC,-27.5805287,-48.9838759,23,4322
SC,ANITA GARIBALDI,48,47,-1,-2.08,363,439,76,20.94,3,7,4,133.33,251,240,-11,-4.38,479,470,-9,-1.88,1144,1203,59,5.16,ANITA GARIBALDI SC,-27.6855032,-51.1293873,23,4323
SC,ANITAPOLIS,32,26,-6,-18.75,93,106,13,13.98,4,5,1,25.0,101,76,-25,-24.75,252,235,-17,-6.75,482,448,-34,-7.05,ANITAPOLIS SC,-27.9041185,-49.1287395,23,4324
SC,APIUNA,31,25,-6,-19.35,1804,1722,-82,-4.55,12,6,-6,-50.0,332,337,5,1.51,823,771,-52,-6.32,3002,2861,-141,-4.7,APIUNA SC,-27.0374658,-49.3885037,23,4326
SC,ARABUTA,35,33,-2,-5.71,291,302,11,3.78,11,17,6,54.55,59,61,2,3.39,295,323,28,9.49,691,736,45,6.51,ARABUTA SC,-27.1587028,-52.1438142,23,4327
SC,ARARANGUA,250,260,10,4.0,3049,3067,18,0.59,446,332,-114,-25.56,5481,5360,-121,-2.21,6175,6111,-64,-1.04,15401,15130,-271,-1.76,ARARANGUA SC,-28.9348832,-49.4858389,23,4329
SC,ARMAZEM,101,116,15,14.85,1273,1221,-52,-4.08,47,40,-7,-14.89,335,350,15,4.48,714,698,-16,-2.24,2470,2425,-45,-1.82,ARMAZEM SC,-28.2624996,-49.0190126,23,4330
SC,ARROIO TRINTA,58,68,10,17.24,233,216,-17,-7.3,40,59,19,47.5,120,117,-3,-2.5,383,377,-6,-1.57,834,837,3,0.36,ARROIO TRINTA SC,-26.9301976,-51.334928,23,4331
SC,ARVOREDO,377,231,-146,-38.73,54,85,31,57.41,11,10,-1,-9.09,57,67,10,17.54,352,318,-34,-9.66,851,711,-140,-16.45,ARVOREDO SC,-27.0755081,-52.4570855,23,4332
SC,ASCURRA,19,23,4,21.05,1458,1298,-160,-10.97,31,33,2,6.45,432,451,19,4.4,601,587,-14,-2.33,2541,2392,-149,-5.86,ASCURRA SC,-26.9569975,-49.3767752,23,4333
SC,ATALANTA,24,20,-4,-16.67,174,201,27,15.52,0,0,0,0.0,103,101,-2,-1.94,200,212,12,6.0,501,534,33,6.59,ATALANTA SC,-27.421916,-49.778863,23,4334
SC,AURORA,1,1,0,0.0,2,1,-1,-50.0,9,0,-9,-100.0,211,210,-1,-0.47,1369,1042,-327,-23.89,1592,1254,-338,-21.23,AURORA SC,-27.3166417,-49.6368502,23,4335
SC,BALNEARIO BARRA DO SUL,21,29,8,38.1,181,182,1,0.55,63,27,-36,-57.14,373,395,22,5.9,567,480,-87,-15.34,1205,1113,-92,-7.63,BALNEARIO BARRA DO SUL SC,-26.459842,-48.6061471,23,4338
SC,BANDEIRANTE,8,14,6,75.0,174,249,75,43.1,3,6,3,100.0,31,24,-7,-22.58,172,161,-11,-6.4,388,454,66,17.01,BANDEIRANTE SC,-26.7673451,-53.6391722,23,4340
SC,BARRA BONITA,245,241,-4,-1.63,4792,4747,-45,-0.94,170,160,-10,-5.88,1990,2091,101,5.08,4027,3782,-245,-6.08,11224,11021,-203,-1.81,BARRA BONITA SC,-26.6526364,-53.4419581,23,4341
SC,BELA VISTA DO TOLDO,34,34,0,0.0,24,22,-2,-8.33,0,0,0,0.0,94,93,-1,-1.06,380,409,29,7.63,532,558,26,4.89,BELA VISTA DO TOLDO SC,-26.274625,-50.466354,23,4343
SC,BELMONTE,323,391,68,21.05,172,167,-5,-2.91,2,5,3,150.0,191,184,-7,-3.66,908,861,-47,-5.18,1596,1608,12,0.75,BELMONTE SC,-26.8448262,-53.578916,23,4344
SC,BENEDITO NOVO,21,17,-4,-19.05,2050,2073,23,1.12,94,86,-8,-8.51,289,299,10,3.46,523,526,3,0.57,2977,3001,24,0.81,BENEDITO NOVO SC,-26.7840657,-49.3629511,23,4345
SC,BLUMENAU,144,146,2,1.39,40291,41286,995,2.47,5011,5348,337,6.73,25893,25843,-50,-0.19,58597,56009,-2588,-4.42,129936,128632,-1304,-1.0,BLUMENAU SC,-26.9195567,-49.0658025,23,4347
SC,BOCAINA DO SUL,48,39,-9,-18.75,72,104,32,44.44,1,0,-1,-100.0,66,56,-10,-15.15,304,254,-50,-16.45,491,453,-38,-7.74,BOCAINA DO SUL SC,-27.745494,-49.942279,23,4348
SC,BOM JARDIM DA SERRA,131,144,13,9.92,34,26,-8,-23.53,0,0,0,0.0,94,80,-14,-14.89,399,340,-59,-14.79,658,590,-68,-10.33,BOM JARDIM DA SERRA SC,-28.3380324,-49.625588,23,4350
SC,BOM JESUS,438,424,-14,-3.2,117,144,27,23.08,60,53,-7,-11.67,1206,1243,37,3.07,1703,1381,-322,-18.91,3524,3245,-279,-7.92,BOM JESUS SC,-26.7350604,-52.3916519,23,4351
SC,BOM JESUS DO OESTE,9,20,11,122.22,52,79,27,51.92,1,1,0,0.0,45,29,-16,-35.56,151,140,-11,-7.28,258,269,11,4.26,BOM JESUS DO OESTE SC,-26.6929713,-53.0967453,23,4352
SC,BOM RETIRO,397,363,-34,-8.56,237,219,-18,-7.59,14,22,8,57.14,312,294,-18,-5.77,643,574,-69,-10.73,1603,1472,-131,-8.17,BOM RETIRO SC,-27.798993,-49.486994,23,4353
SC,BRACO DO NORTE,314,289,-25,-7.96,5323,5288,-35,-0.66,575,905,330,57.39,2541,2481,-60,-2.36,3209,3261,52,1.62,11962,12224,262,2.19,BRACO DO NORTE SC,-28.2728633,-49.1622712,23,4355
SC,BRACO DO TROMBUDO,12,8,-4,-33.33,689,745,56,8.13,1,5,4,400.0,86,79,-7,-8.14,387,394,7,1.81,1175,1231,56,4.77,BRACO DO TROMBUDO SC,-27.358578,-49.882145,23,4356
SC,BRUNOPOLIS,84,93,9,10.71,43,50,7,16.28,0,0,0,0.0,61,59,-2,-3.28,194,140,-54,-27.84,382,342,-40,-10.47,BRUNOPOLIS SC,-27.310953,-50.837585,23,4357
SC,BRUSQUE,8,10,2,25.0,23891,23789,-102,-0.43,1775,1935,160,9.01,9785,10647,862,8.81,13990,14410,420,3.0,49449,50791,1342,2.71,BRUSQUE SC,-27.0964628,-48.9136323,23,4358
SC,CACADOR,1245,1165,-80,-6.43,11739,12923,1184,10.09,417,475,58,13.91,3668,3459,-209,-5.7,7722,7451,-271,-3.51,24791,25473,682,2.75,CACADOR SC,-26.77567,-51.0120041,23,4359
SC,CAIBI,62,68,6,9.68,395,409,14,3.54,43,54,11,25.58,269,264,-5,-1.86,594,627,33,5.56,1363,1422,59,4.33,CAIBI SC,-27.0751925,-53.2502133,23,4360
SC,CALMON,298,322,24,8.05,10,30,20,200.0,0,2,2,0.0,32,21,-11,-34.38,387,165,-222,-57.36,727,540,-187,-25.72,CALMON SC,-26.6023644,-51.0992893,23,4361
SC,CAPAO ALTO,146,150,4,2.74,107,117,10,9.35,3,1,-2,-66.67,43,48,5,11.63,378,361,-17,-4.5,677,677,0,0.0,CAPAO ALTO SC,-27.9382827,-50.511491,23,4363
SC,CAMPO ALEGRE,134,100,-34,-25.37,2912,2785,-127,-4.36,12,6,-6,-50.0,334,302,-32,-9.58,1410,1174,-236,-16.74,4802,4367,-435,-9.06,CAMPO ALEGRE SC,-26.1941684,-49.2657484,23,4364
SC,CAMPO BELO DO SUL,430,467,37,8.6,140,257,117,83.57,6,1,-5,-83.33,123,133,10,8.13,538,409,-129,-23.98,1237,1267,30,2.43,CAMPO BELO DO SUL SC,-27.8989298,-50.759562,23,4365
SC,CAMPO ERE,196,210,14,7.14,711,768,57,8.02,28,29,1,3.57,356,352,-4,-1.12,604,584,-20,-3.31,1895,1943,48,2.53,CAMPO ERE SC,-26.3947432,-53.0790495,23,4366
SC,CAMPOS NOVOS,893,947,54,6.05,3703,4118,415,11.21,293,316,23,7.85,2449,2334,-115,-4.7,2975,2846,-129,-4.34,10313,10561,248,2.4,CAMPOS NOVOS SC,-27.3962904,-51.2224397,23,4367
SC,CANELINHA,12,12,0,0.0,1231,1234,3,0.24,32,29,-3,-9.38,463,463,0,0.0,677,650,-27,-3.99,2415,2388,-27,-1.12,CANELINHA SC,-27.2660341,-48.7666708,23,4368
SC,CANOINHAS,429,388,-41,-9.56,2573,2861,288,11.19,383,359,-24,-6.27,3714,3926,212,5.71,4650,4847,197,4.24,11749,12381,632,5.38,CANOINHAS SC,-26.1755121,-50.3949592,23,4369
SC,CAPINZAL,369,409,40,10.84,5615,6206,591,10.53,202,163,-39,-19.31,1229,1167,-62,-5.04,1818,1781,-37,-2.04,9233,9726,493,5.34,CAPINZAL SC,-27.3440651,-51.6110403,23,4370
SC,CATANDUVAS,185,167,-18,-9.73,244,293,49,20.08,1,1,0,0.0,264,296,32,12.12,564,527,-37,-6.56,1258,1284,26,2.07,CATANDUVAS SC,-27.0689719,-51.660158,23,4372
SC,CAXAMBU DO SUL,30,34,4,13.33,179,220,41,22.91,22,24,2,9.09,98,98,0,0.0,248,253,5,2.02,577,629,52,9.01,CAXAMBU DO SUL SC,-27.1615046,-52.8796675,23,4373
SC,CELSO RAMOS,0,0,0,0.0,54,58,4,7.41,7,3,-4,-57.14,67,60,-7,-10.45,297,337,40,13.47,425,458,33,7.76,CELSO RAMOS SC,-27.6335797,-51.3368111,23,4374
SC,CERRO NEGRO,41,37,-4,-9.76,39,16,-23,-58.97,0,0,0,0.0,26,30,4,15.38,239,197,-42,-17.57,345,280,-65,-18.84,CERRO NEGRO SC,-27.7953331,-50.8741305,23,4375
SC,CHAPADAO DO LAGEADO,4,4,0,0.0,36,27,-9,-25.0,1,2,1,100.0,31,41,10,32.26,171,157,-14,-8.19,243,231,-12,-4.94,CHAPADAO DO LAGEADO SC,-27.590507,-49.553879,23,4376
SC,CHAPECO,923,982,59,6.39,25090,29205,4115,16.4,5402,5559,157,2.91,19209,19166,-43,-0.22,35378,35338,-40,-0.11,86002,90250,4248,4.94,CHAPECO SC,-27.0922364,-52.6166878,23,4377
SC,CONCORDIA,289,293,4,1.38,9756,10309,553,5.67,2363,1708,-655,-27.72,6206,6201,-5,-0.08,11756,11692,-64,-0.54,30370,30203,-167,-0.55,CONCORDIA SC,-27.2312011,-52.0231024,23,4379
SC,CORONEL FREITAS,73,78,5,6.85,1040,1060,20,1.92,76,69,-7,-9.21,365,376,11,3.01,596,542,-54,-9.06,2150,2125,-25,-1.16,CORONEL FREITAS SC,-26.9058932,-52.7028055,23,4381
SC,CORONEL MARTINS,12,14,2,16.67,2,5,3,150.0,5,5,0,0.0,43,40,-3,-6.98,169,133,-36,-21.3,231,197,-34,-14.72,CORONEL MARTINS SC,-26.5124719,-52.6681763,23,4382
SC,CORREIA PINTO,203,255,52,25.62,1601,1521,-80,-5.0,12,17,5,41.67,471,490,19,4.03,883,835,-48,-5.44,3170,3118,-52,-1.64,CORREIA PINTO SC,-27.587688,-50.361448,23,4384
SC,CRICIUMA,30,24,-6,-20.0,18719,19053,334,1.78,3808,4059,251,6.59,15881,15434,-447,-2.81,31161,30827,-334,-1.07,69599,69397,-202,-0.29,CRICIUMA SC,-28.6789941,-49.3695627,23,4385
SC,CUNHA PORA,56,59,3,5.36,983,1060,77,7.83,54,66,12,22.22,694,725,31,4.47,965,980,15,1.55,2752,2890,138,5.01,CUNHA PORA SC,-26.8927163,-53.1716516,23,4386
SC,CUNHATAI,13,11,-2,-15.38,77,70,-7,-9.09,8,7,-1,-12.5,80,94,14,17.5,139,132,-7,-5.04,317,314,-3,-0.95,CUNHATAI SC,-26.9735014,-53.0914014,23,4387
SC,CURITIBANOS,615,602,-13,-2.11,2732,2919,187,6.84,204,151,-53,-25.98,2624,2785,161,6.14,3368,3131,-237,-7.04,9543,9588,45,0.47,CURITIBANOS SC,-27.2900659,-50.5779683,23,4388
SC,DESCANSO,64,59,-5,-7.81,162,175,13,8.02,70,62,-8,-11.43,368,369,1,0.27,520,505,-15,-2.88,1184,1170,-14,-1.18,DESCANSO SC,-26.8246854,-53.5017586,23,4389
SC,DONA EMMA,19,20,1,5.26,750,790,40,5.33,3,5,2,66.67,83,100,17,20.48,271,264,-7,-2.58,1126,1179,53,4.71,DONA EMMA SC,-26.9849398,-49.7265136,23,4391
SC,DOUTOR PEDRINHO,11,9,-2,-18.18,772,746,-26,-3.37,0,0,0,0.0,70,72,2,2.86,157,152,-5,-3.18,1010,979,-31,-3.07,DOUTOR PEDRINHO SC,-26.716408,-49.482726,23,4392
SC,ENTRE RIOS,666,730,64,9.61,217,226,9,4.15,104,88,-16,-15.38,779,760,-19,-2.44,2519,2173,-346,-13.74,4285,3977,-308,-7.19,ENTRE RIOS SC,-26.7236463,-52.5638445,23,4393
SC,ERVAL VELHO,97,129,32,32.99,220,233,13,5.91,14,8,-6,-42.86,189,197,8,4.23,361,370,9,2.49,881,937,56,6.36,ERVAL VELHO SC,-27.2747859,-51.4429712,23,4395
SC,FAXINAL DOS GUEDES,1218,1296,78,6.4,1107,1125,18,1.63,80,78,-2,-2.5,443,435,-8,-1.81,924,902,-22,-2.38,3772,3836,64,1.7,FAXINAL DOS GUEDES SC,-26.8494222,-52.2586485,23,4396
SC,FLOR DO SERTAO,25,26,1,4.0,139,162,23,16.55,3,0,-3,-100.0,34,35,1,2.94,138,142,4,2.9,339,365,26,7.67,FLOR DO SERTAO SC,-26.7784693,-53.3478823,23,4397
SC,FLORIANOPOLIS,266,283,17,6.39,10443,10220,-223,-2.14,5601,6969,1368,24.42,36130,34558,-1572,-4.35,235854,241907,6053,2.57,288294,293937,5643,1.96,FLORIANOPOLIS SC,-27.5973002,-48.5496098,23,4398
SC,FORMOSA DO SUL,6,11,5,83.33,17,18,1,5.88,9,12,3,33.33,46,48,2,4.35,203,189,-14,-6.9,281,278,-3,-1.07,FORMOSA DO SUL SC,-26.6478829,-52.7934366,23,4399
SC,FRAIBURGO,1934,1963,29,1.5,1921,2061,140,7.29,219,304,85,38.81,1749,1730,-19,-1.09,2932,2536,-396,-13.51,8755,8594,-161,-1.84,FRAIBURGO SC,-27.023288,-50.919978,23,4401
SC,FREI ROGERIO,10,14,4,40.0,48,52,4,8.33,0,0,0,0.0,41,52,11,26.83,205,181,-24,-11.71,304,299,-5,-1.64,FREI ROGERIO SC,-27.175021,-50.807621,23,4402
SC,GALVAO,36,37,1,2.78,64,74,10,15.62,0,0,0,0.0,65,68,3,4.62,213,207,-6,-2.82,378,386,8,2.12,GALVAO SC,-26.4553595,-52.6869755,23,4403
SC,GARUVA,156,132,-24,-15.38,1951,1978,27,1.38,48,65,17,35.42,731,686,-45,-6.16,1366,1432,66,4.83,4252,4293,41,0.96,GARUVA SC,-26.0294904,-48.8545202,23,4405
SC,GRAO PARA,73,66,-7,-9.59,998,1078,80,8.02,30,27,-3,-10.0,163,165,2,1.23,533,458,-75,-14.07,1797,1794,-3,-0.17,GRAO PARA SC,-28.1856937,-49.2163956,23,4408
SC,GUARACIABA,116,114,-2,-1.72,106,95,-11,-10.38,31,24,-7,-22.58,119,124,5,4.2,1203,1131,-72,-5.99,1575,1488,-87,-5.52,GUARACIABA SC,-26.6001986,-53.5216209,23,4411
SC,GUARUJA DO SUL,21,17,-4,-19.05,330,392,62,18.79,5,3,-2,-40.0,301,195,-106,-35.22,418,385,-33,-7.89,1075,992,-83,-7.72,GUARUJA DO SUL SC,-26.3850268,-53.527794,23,4413
SC,IBIAM,11,19,8,72.73,51,66,15,29.41,3,9,6,200.0,7,10,3,42.86,183,170,-13,-7.1,255,274,19,7.45,IBIAM SC,-27.184658,-51.235154,23,4416
SC,IBICARE,67,61,-6,-8.96,79,86,7,8.86,8,10,2,25.0,132,131,-1,-0.76,371,702,331,89.22,657,990,333,50.68,IBICARE SC,-27.088141,-51.368101,23,4417
SC,IBIRAMA,19,18,-1,-5.26,3677,3750,73,1.99,134,133,-1,-0.75,769,832,63,8.19,1442,1500,58,4.02,6041,6233,192,3.18,IBIRAMA SC,-27.0537021,-49.5190771,23,4418
SC,IMARUI,26,34,8,30.77,128,98,-30,-23.44,185,234,49,26.49,253,260,7,2.77,427,411,-16,-3.75,1019,1037,18,1.77,IMARUI SC,-28.3440491,-48.8151737,23,4421
SC,IMBITUBA,32,37,5,15.62,1115,1173,58,5.2,299,278,-21,-7.02,3120,3230,110,3.53,5477,5311,-166,-3.03,10043,10029,-14,-0.14,IMBITUBA SC,-28.241827,-48.6643444,23,4422
SC,IMBUIA,7,2,-5,-71.43,72,86,14,19.44,3,7,4,133.33,417,458,41,9.83,352,324,-28,-7.95,851,877,26,3.06,IMBUIA SC,-27.49082,-49.421766,23,4423
SC,IOMERE,210,202,-8,-3.81,189,205,16,8.47,10,8,-2,-20.0,88,90,2,2.27,249,294,45,18.07,746,799,53,7.1,IOMERE SC,-27.0019673,-51.2405514,23,4425
SC,IPORA DO OESTE,53,74,21,39.62,368,373,5,1.36,87,124,37,42.53,549,513,-36,-6.56,653,688,35,5.36,1710,1772,62,3.63,IPORA DO OESTE SC,-26.988409,-53.5344408,23,4427
SC,IPUACU,30,35,5,16.67,994,943,-51,-5.13,2,3,1,50.0,162,164,2,1.23,370,354,-16,-4.32,1558,1499,-59,-3.79,IPUACU SC,-26.6349873,-52.4555915,23,4428
SC,IPUMIRIM,163,176,13,7.98,2231,2405,174,7.8,38,27,-11,-28.95,241,250,9,3.73,567,541,-26,-4.59,3240,3399,159,4.91,IPUMIRIM SC,-27.0762287,-52.135736,23,4429
SC,IRACEMINHA,10,8,-2,-20.0,27,39,12,44.44,12,8,-4,-33.33,93,100,7,7.53,235,197,-38,-16.17,377,352,-25,-6.63,IRACEMINHA SC,-26.8237077,-53.272834,23,4430
SC,IRANI,88,74,-14,-15.91,198,223,25,12.63,38,46,8,21.05,377,402,25,6.63,844,825,-19,-2.25,1545,1570,25,1.62,IRANI SC,-27.0230476,-51.9010675,23,4431
SC,IRATI,341,272,-69,-20.23,2817,2938,121,4.3,743,761,18,2.42,3446,3389,-57,-1.65,4416,4234,-182,-4.12,11763,11594,-169,-1.44,IRATI SC,-26.6577742,-52.8929851,23,4432
SC,IRINEOPOLIS,115,109,-6,-5.22,128,132,4,3.12,7,17,10,142.86,346,347,1,0.29,527,510,-17,-3.23,1123,1115,-8,-0.71,IRINEOPOLIS SC,-26.242006,-50.795687,23,4433
SC,ITA,27,26,-1,-3.7,443,481,38,8.58,58,42,-16,-27.59,213,206,-7,-3.29,860,906,46,5.35,1601,1661,60,3.75,ITA SC,-27.275006,-52.3381725,23,4434
SC,ITAIOPOLIS,131,227,96,73.28,2399,2517,118,4.92,10,9,-1,-10.0,682,720,38,5.57,973,926,-47,-4.83,4195,4399,204,4.86,ITAIOPOLIS SC,-26.3391899,-49.9071983,23,4435
SC,ITAPEMA,6,4,-2,-33.33,1357,1321,-36,-2.65,4408,4992,584,13.25,4619,4629,10,0.22,9351,9896,545,5.83,19741,20842,1101,5.58,ITAPEMA SC,-27.09472,-48.6137778,23,4437
SC,ITAPIRANGA,0,0,0,0.0,5,6,1,20.0,0,0,0,0.0,23,30,7,30.43,311,212,-99,-31.83,339,248,-91,-26.84,ITAPIRANGA SC,-27.1719977,-53.7118734,23,4438
SC,ITAPOA,13,13,0,0.0,241,272,31,12.86,83,97,14,16.87,1055,1115,60,5.69,2722,2890,168,6.17,4114,4387,273,6.64,ITAPOA SC,-26.1089446,-48.6060493,23,4439
SC,ITUPORANGA,128,195,67,52.34,2211,2244,33,1.49,530,516,-14,-2.64,1524,1557,33,2.17,2200,2304,104,4.73,6593,6816,223,3.38,ITUPORANGA SC,-27.4096219,-49.6014812,23,4440
SC,JABORA,57,84,27,47.37,294,327,33,11.22,4,4,0,0.0,82,92,10,12.2,333,322,-11,-3.3,770,829,59,7.66,JABORA SC,-27.1743246,-51.7348631,23,4441
SC,JACINTO MACHADO,22,31,9,40.91,881,876,-5,-0.57,52,40,-12,-23.08,432,420,-12,-2.78,877,793,-84,-9.58,2264,2160,-104,-4.59,JACINTO MACHADO SC,-28.999338,-49.7603204,23,4442
SC,JAGUARUNA,68,50,-18,-26.47,1603,1903,300,18.71,56,112,56,100.0,918,1120,202,22.0,2258,3893,1635,72.41,4903,7078,2175,44.36,JAGUARUNA SC,-28.6237365,-49.0288664,23,4443
SC,JARAGUA DO SUL,158,150,-8,-5.06,32422,32450,28,0.09,1743,1888,145,8.32,10584,10639,55,0.52,21412,21118,-294,-1.37,66319,66245,-74,-0.11,JARAGUA DO SUL SC,-26.4897432,-49.0778063,23,4444
SC,JARDINOPOLIS,818,808,-10,-1.22,2358,2466,108,4.58,276,306,30,10.87,2287,2299,12,0.52,3314,3084,-230,-6.94,9053,8963,-90,-0.99,JARDINOPOLIS SC,-26.721575,-52.8591464,23,4445
SC,JOINVILLE,361,297,-64,-17.73,73649,71485,-2164,-2.94,6815,6728,-87,-1.28,38514,38052,-462,-1.2,92366,95931,3565,3.86,211705,212493,788,0.37,JOINVILLE SC,-26.3044898,-48.8486726,23,4447
SC,JOSE BOITEUX,5,9,4,80.0,570,521,-49,-8.6,15,16,1,6.67,111,120,9,8.11,251,266,15,5.98,952,932,-20,-2.1,JOSE BOITEUX SC,-26.962072,-49.6262509,23,4448
SC,JUPIA,5,5,0,0.0,27,46,19,70.37,0,0,0,0.0,27,26,-1,-3.7,184,189,5,2.72,243,266,23,9.47,JUPIA SC,-26.3985774,-52.7262856,23,4449
SC,LACERDOPOLIS,98,115,17,17.35,129,160,31,24.03,12,12,0,0.0,42,47,5,11.9,290,257,-33,-11.38,571,591,20,3.5,LACERDOPOLIS SC,-27.2614296,-51.5564429,23,4450
SC,LAGES,1463,1581,118,8.07,9417,9976,559,5.94,1299,1392,93,7.16,10374,10300,-74,-0.71,20094,19731,-363,-1.81,42647,42980,333,0.78,LAGES SC,-27.8165664,-50.325883,23,4451
SC,LAJEADO GRANDE,2,1,-1,-50.0,79,72,-7,-8.86,0,0,0,0.0,28,30,2,7.14,168,101,-67,-39.88,277,204,-73,-26.35,LAJEADO GRANDE SC,-26.8583425,-52.5666619,23,4453
SC,LAURENTINO,61,64,3,4.92,1011,1061,50,4.95,7,6,-1,-14.29,431,406,-25,-5.8,389,410,21,5.4,1899,1947,48,2.53,LAURENTINO SC,-27.2193231,-49.7322856,23,4454
SC,LEBON REGIS,733,681,-52,-7.09,307,326,19,6.19,4,4,0,0.0,246,242,-4,-1.63,471,428,-43,-9.13,1761,1681,-80,-4.54,LEBON REGIS SC,-26.927987,-50.692109,23,4456
SC,LEOBERTO LEAL,5,1,-4,-80.0,19,8,-11,-57.89,2,0,-2,-100.0,89,94,5,5.62,261,244,-17,-6.51,376,347,-29,-7.71,LEOBERTO LEAL SC,-27.5071209,-49.2871979,23,4457
SC,LINDOIA DO SUL,15,12,-3,-20.0,108,107,-1,-0.93,51,36,-15,-29.41,94,97,3,3.19,370,373,3,0.81,638,625,-13,-2.04,LINDOIA DO SUL SC,-27.0521919,-52.0831502,23,4458
SC,LUIZ ALVES,286,273,-13,-4.55,2706,2720,14,0.52,45,62,17,37.78,716,722,6,0.84,816,874,58,7.11,4569,4651,82,1.79,LUIZ ALVES SC,-26.7118577,-48.9126756,23,4460
SC,MACIEIRA,118,102,-16,-13.56,70,71,1,1.43,0,0,0,0.0,22,19,-3,-13.64,150,123,-27,-18.0,360,315,-45,-12.5,MACIEIRA SC,-26.8541639,-51.3763845,23,4462
SC,MAJOR GERCINO,9,6,-3,-33.33,149,113,-36,-24.16,29,30,1,3.45,54,49,-5,-9.26,237,214,-23,-9.7,478,412,-66,-13.81,MAJOR GERCINO SC,-27.419236,-48.94878,23,4464
SC,MAJOR VIEIRA,111,122,11,9.91,219,221,2,0.91,2,4,2,100.0,207,218,11,5.31,343,323,-20,-5.83,882,888,6,0.68,MAJOR VIEIRA SC,-26.3654856,-50.3272634,23,4465
SC,MARACAJA,7,5,-2,-28.57,609,638,29,4.76,25,28,3,12.0,432,436,4,0.93,570,618,48,8.42,1643,1725,82,4.99,MARACAJA SC,-28.8628566,-49.449388,23,4466
SC,MARAVILHA,2,0,-2,-100.0,1,1,0,0.0,0,0,0,0.0,30,31,1,3.33,280,280,0,0.0,313,312,-1,-0.32,MARAVILHA SC,-26.7623898,-53.1747387,23,4467
SC,MAREMA,50,24,-26,-52.0,20,21,1,5.0,1,1,0,0.0,43,42,-1,-2.33,177,137,-40,-22.6,291,225,-66,-22.68,MAREMA SC,-26.802361,-52.626445,23,4468
SC,MASSARANDUBA,12,15,3,25.0,34,26,-8,-23.53,10,8,-2,-20.0,49,48,-1,-2.04,622,659,37,5.95,727,756,29,3.99,MASSARANDUBA SC,-26.610868,-49.005351,23,4469
SC,MATOS COSTA,55,70,15,27.27,81,43,-38,-46.91,7,0,-7,-100.0,42,51,9,21.43,212,194,-18,-8.49,397,358,-39,-9.82,MATOS COSTA SC,-26.4739837,-51.1509787,23,4470
SC,MELEIRO,7,4,-3,-42.86,400,362,-38,-9.5,48,23,-25,-52.08,295,296,1,0.34,645,645,0,0.0,1395,1330,-65,-4.66,MELEIRO SC,-28.8303183,-49.6349851,23,4471
SC,MIRIM DOCE,25,35,10,40.0,252,257,5,1.98,1,1,0,0.0,41,35,-6,-14.63,237,221,-16,-6.75,556,549,-7,-1.26,MIRIM DOCE SC,-27.2003527,-50.0697185,23,4472
SC,MODELO,51,53,2,3.92,375,378,3,0.8,112,114,2,1.79,129,116,-13,-10.08,292,254,-38,-13.01,959,915,-44,-4.59,MODELO SC,-26.7752383,-53.0525513,23,4473
SC,MONDAI,73,48,-25,-34.25,1588,1746,158,9.95,39,44,5,12.82,373,381,8,2.14,629,682,53,8.43,2702,2901,199,7.36,MONDAI SC,-27.1020777,-53.399242,23,4474
SC,MONTE CARLO,439,693,254,57.86,400,387,-13,-3.25,18,25,7,38.89,219,231,12,5.48,572,638,66,11.54,1648,1974,326,19.78,MONTE CARLO SC,-27.2216645,-50.9784032,23,4475
SC,MONTE CASTELO,144,149,5,3.47,55,55,0,0.0,4,1,-3,-75.0,53,51,-2,-3.77,262,261,-1,-0.38,518,517,-1,-0.19,MONTE CASTELO SC,-26.460989,-50.232724,23,4476
SC,NOVA ERECHIM,58,51,-7,-12.07,795,866,71,8.93,13,21,8,61.54,173,185,12,6.94,283,280,-3,-1.06,1322,1403,81,6.13,NOVA ERECHIM SC,-26.9027688,-52.9071258,23,4480
SC,NOVA ITABERABA,8,8,0,0.0,278,295,17,6.12,45,40,-5,-11.11,99,103,4,4.04,207,206,-1,-0.48,637,652,15,2.35,NOVA ITABERABA SC,-26.9406956,-52.8132923,23,4481
SC,NOVA TRENTO,11,9,-2,-18.18,2521,2419,-102,-4.05,1925,1896,-29,-1.51,516,511,-5,-0.97,1196,1062,-134,-11.2,6169,5897,-272,-4.41,NOVA TRENTO SC,-27.2862616,-48.9302652,23,4482
SC,NOVO HORIZONTE,0,0,0,0.0,1,0,-1,-100.0,0,1,1,0.0,26,24,-2,-7.69,455,404,-51,-11.21,482,429,-53,-11.0,NOVO HORIZONTE SC,-26.4465656,-52.8319931,23,4484
SC,ORLEANS,67,58,-9,-13.43,2914,2949,35,1.2,358,367,9,2.51,1499,1485,-14,-0.93,2641,2632,-9,-0.34,7479,7491,12,0.16,ORLEANS SC,-28.3572698,-49.2872434,23,4485
SC,OTACILIO COSTA,125,138,13,10.4,2352,2422,70,2.98,237,138,-99,-41.77,854,915,61,7.14,1598,856,-742,-46.43,5166,4469,-697,-13.49,OTACILIO COSTA SC,-27.4832304,-50.1195204,23,4486
SC,OURO VERDE,75,86,11,14.67,37,44,7,18.92,25,25,0,0.0,155,155,0,0.0,415,433,18,4.34,707,743,36,5.09,OURO VERDE SC,-26.6941871,-52.3103928,23,4488
SC,PAIAL,5,4,-1,-20.0,36,64,28,77.78,0,0,0,0.0,37,34,-3,-8.11,145,137,-8,-5.52,223,239,16,7.17,PAIAL SC,-27.2564715,-52.4998045,23,4489
SC,PAINEL,139,224,85,61.15,2,7,5,250.0,0,0,0,0.0,15,21,6,40.0,183,169,-14,-7.65,339,421,82,24.19,PAINEL SC,-27.9214849,-50.0994933,23,4490
SC,PALMA SOLA,202,187,-15,-7.43,136,153,17,12.5,7,9,2,28.57,296,292,-4,-1.35,1006,1058,52,5.17,1647,1699,52,3.16,PALMA SOLA SC,-26.3482487,-53.2775974,23,4492
SC,PALMITOS,58,52,-6,-10.34,601,637,36,5.99,130,148,18,13.85,910,924,14,1.54,2567,2684,117,4.56,4266,4445,179,4.2,PALMITOS SC,-27.0711023,-53.1596594,23,4494
SC,PAPANDUVA,432,465,33,7.64,1064,1154,90,8.46,42,86,44,104.76,878,1046,168,19.13,1073,1132,59,5.5,3489,3883,394,11.29,PAPANDUVA SC,-26.4065885,-50.1457369,23,4495
SC,PARAISO,135,139,4,2.96,1128,1207,79,7.0,11,2,-9,-81.82,164,186,22,13.41,439,404,-35,-7.97,1877,1938,61,3.25,PARAISO SC,-26.6180705,-53.6743943,23,4496
SC,PASSOS MAIA,159,157,-2,-1.26,200,200,0,0.0,2,2,0,0.0,82,79,-3,-3.66,436,348,-88,-20.18,879,786,-93,-10.58,PASSOS MAIA SC,-26.7806434,-52.0611058,23,4498
SC,PEDRAS GRANDES,38,37,-1,-2.63,580,817,237,40.86,0,0,0,0.0,124,118,-6,-4.84,317,275,-42,-13.25,1059,1247,188,17.75,PEDRAS GRANDES SC,-28.4357866,-49.1864128,23,4500
SC,PERITIBA,10,10,0,0.0,141,146,5,3.55,2,7,5,250.0,128,123,-5,-3.91,299,295,-4,-1.34,580,581,1,0.17,PERITIBA SC,-27.3736365,-51.9050311,23,4502
SC,PETROLANDIA,233,215,-18,-7.73,164,171,7,4.27,6,8,2,33.33,969,1016,47,4.85,3232,2367,-865,-26.76,4604,3777,-827,-17.96,PETROLANDIA SC,-27.5329615,-49.6984597,23,4504
SC,PINHALZINHO,129,112,-17,-13.18,530,494,-36,-6.79,18,12,-6,-33.33,647,638,-9,-1.39,808,839,31,3.84,2132,2095,-37,-1.74,PINHALZINHO SC,-26.852586,-52.9872478,23,4506
SC,PINHEIRO PRETO,82,87,5,6.1,835,869,34,4.07,1,15,14,1400.0,98,100,2,2.04,406,523,117,28.82,1422,1594,172,12.1,PINHEIRO PRETO SC,-27.0457296,-51.2296306,23,4507
SC,PLANALTO ALEGRE,47,39,-8,-17.02,190,193,3,1.58,16,10,-6,-37.5,94,93,-1,-1.06,235,241,6,2.55,582,576,-6,-1.03,PLANALTO ALEGRE SC,-27.0721133,-52.8667023,23,4509
SC,POMERODE,22,22,0,0.0,9247,9057,-190,-2.05,252,262,10,3.97,1664,1694,30,1.8,2691,2597,-94,-3.49,13876,13632,-244,-1.76,POMERODE SC,-26.7356218,-49.1770095,23,4510
SC,PONTE ALTA,124,105,-19,-15.32,239,245,6,2.51,8,2,-6,-75.0,72,71,-1,-1.39,315,310,-5,-1.59,758,733,-25,-3.3,PONTE ALTA SC,-27.483497,-50.376404,23,4511
SC,PONTE ALTA DO NORTE,135,159,24,17.78,287,323,36,12.54,6,4,-2,-33.33,125,121,-4,-3.2,347,312,-35,-10.09,900,919,19,2.11,PONTE ALTA DO NORTE SC,-27.1626096,-50.4684028,23,4512
SC,PONTE SERRADA,327,318,-9,-2.75,277,352,75,27.08,11,12,1,9.09,384,442,58,15.1,789,693,-96,-12.17,1788,1817,29,1.62,PONTE SERRADA SC,-26.8708566,-52.0164089,23,4513
SC,POUSO REDONDO,138,148,10,7.25,2598,2665,67,2.58,103,154,51,49.51,792,799,7,0.88,1095,1161,66,6.03,4726,4927,201,4.25,POUSO REDONDO SC,-27.2567443,-49.9331593,23,4516
SC,PRAIA GRANDE,16,2,-14,-87.5,1543,1498,-45,-2.92,4118,4074,-44,-1.07,15680,15722,42,0.27,30587,29943,-644,-2.11,51944,51239,-705,-1.36,PRAIA GRANDE SC,-29.1966831,-49.9491971,23,4517
SC,PRESIDENTE CASTELLO BRANCO,12,13,1,8.33,25,17,-8,-32.0,0,0,0,0.0,44,51,7,15.91,185,203,18,9.73,266,284,18,6.77,PRESIDENTE CASTELLO BRANCO SC,-27.2217868,-51.8089482,23,4518
SC,PRESIDENTE GETULIO,22,21,-1,-4.55,4861,4935,74,1.52,45,45,0,0.0,926,872,-54,-5.83,1149,1188,39,3.39,7003,7061,58,0.83,PRESIDENTE GETULIO SC,-27.0426247,-49.6210429,23,4519
SC,PRESIDENTE NEREU,23,20,-3,-13.04,71,65,-6,-8.45,0,0,0,0.0,38,36,-2,-5.26,209,199,-10,-4.78,341,320,-21,-6.16,PRESIDENTE NEREU SC,-27.278277,-49.3890424,23,4520
SC,PRINCESA,5,4,-1,-20.0,380,389,9,2.37,0,0,0,0.0,52,50,-2,-3.85,204,213,9,4.41,641,656,15,2.34,PRINCESA SC,-26.4452737,-53.599913,23,4521
SC,QUILOMBO,132,139,7,5.3,1621,2060,439,27.08,35,40,5,14.29,303,302,-1,-0.33,741,732,-9,-1.21,2832,3273,441,15.57,QUILOMBO SC,-26.7253683,-52.7193084,23,4522
SC,RANCHO QUEIMADO,26,23,-3,-11.54,166,161,-5,-3.01,14,12,-2,-14.29,94,100,6,6.38,273,262,-11,-4.03,573,558,-15,-2.62,RANCHO QUEIMADO SC,-27.6727911,-49.0124197,23,4523
SC,RIO DAS ANTAS,203,208,5,2.46,440,509,69,15.68,1,5,4,400.0,99,102,3,3.03,378,247,-131,-34.66,1121,1071,-50,-4.46,RIO DAS ANTAS SC,-26.8998189,-51.0748324,23,4524
SC,RIO DO CAMPO,19,18,-1,-5.26,509,512,3,0.59,62,51,-11,-17.74,195,199,4,2.05,344,329,-15,-4.36,1129,1109,-20,-1.77,RIO DO CAMPO SC,-26.946807,-50.1412936,23,4525
SC,RIO DO OESTE,139,136,-3,-2.16,760,704,-56,-7.37,2,16,14,700.0,188,203,15,7.98,403,387,-16,-3.97,1492,1446,-46,-3.08,RIO DO OESTE SC,-27.193267,-49.7984595,23,4526
SC,RIO DOS CEDROS,42,47,5,11.9,2300,2418,118,5.13,51,61,10,19.61,515,503,-12,-2.33,472,497,25,5.3,3380,3526,146,4.32,RIO DOS CEDROS SC,-26.739777,-49.271828,23,4527
SC,RIO DO SUL,87,69,-18,-20.69,8727,9300,573,6.57,486,519,33,6.79,5836,5943,107,1.83,9873,10061,188,1.9,25009,25892,883,3.53,RIO DO SUL SC,-27.2162607,-49.643654,23,4528
SC,RIO FORTUNA,40,39,-1,-2.5,293,318,25,8.53,16,9,-7,-43.75,312,340,28,8.97,400,383,-17,-4.25,1061,1089,28,2.64,RIO FORTUNA SC,-28.1335539,-49.1048223,23,4529
SC,RIO RUFINO,29,22,-7,-24.14,108,113,5,4.63,0,1,1,0.0,30,29,-1,-3.33,228,230,2,0.88,395,395,0,0.0,RIO RUFINO SC,-27.861691,-49.7806323,23,4531
SC,RIQUEZA,25,28,3,12.0,199,240,41,20.6,14,10,-4,-28.57,139,143,4,2.88,301,307,6,1.99,678,728,50,7.37,RIQUEZA SC,-27.0697574,-53.3225281,23,4532
SC,RODEIO,18,14,-4,-22.22,1835,1710,-125,-6.81,28,29,1,3.57,375,418,43,11.47,603,554,-49,-8.13,2859,2725,-134,-4.69,RODEIO SC,-26.9233304,-49.3685354,23,4533
SC,ROMELANDIA,10,12,2,20.0,11,39,28,254.55,4,4,0,0.0,80,79,-1,-1.25,236,225,-11,-4.66,341,359,18,5.28,ROMELANDIA SC,-26.6783317,-53.3189986,23,4534
SC,SALETE,81,73,-8,-9.88,1369,1251,-118,-8.62,17,18,1,5.88,200,200,0,0.0,207,421,214,103.38,1874,1963,89,4.75,SALETE SC,-26.9841891,-50.0076205,23,4535
SC,SALTINHO,28,30,2,7.14,418,475,57,13.64,30,51,21,70.0,590,605,15,2.54,429,453,24,5.59,1495,1614,119,7.96,SALTINHO SC,-26.604932,-53.057763,23,4536
SC,SALTO VELOSO,67,75,8,11.94,842,909,67,7.96,31,22,-9,-29.03,149,149,0,0.0,486,499,13,2.67,1575,1654,79,5.02,SALTO VELOSO SC,-26.9071647,-51.406771,23,4537
SC,SANGAO,4,4,0,0.0,2625,2648,23,0.88,103,50,-53,-51.46,364,396,32,8.79,790,851,61,7.72,3886,3949,63,1.62,SANGAO SC,-28.6397512,-49.1266106,23,4538
SC,SANTA CECILIA,0,0,0,0.0,8,15,7,87.5,0,0,0,0.0,23,21,-2,-8.7,393,382,-11,-2.8,424,418,-6,-1.42,SANTA CECILIA SC,-26.9658952,-50.4182571,23,4539
SC,SANTA HELENA,0,0,0,0.0,16,14,-2,-12.5,0,0,0,0.0,243,203,-40,-16.46,1329,1616,287,21.6,1588,1833,245,15.43,SANTA HELENA SC,-26.9389432,-53.6176263,23,4540
SC,SANTA ROSA DE LIMA,39,40,1,2.56,3,3,0,0.0,0,0,0,0.0,1,1,0,0.0,330,268,-62,-18.79,373,312,-61,-16.35,SANTA ROSA DE LIMA SC,-28.0404239,-49.1280356,23,4541
SC,SANTA ROSA DO SUL,3,1,-2,-66.67,198,204,6,3.03,15,19,4,26.67,353,360,7,1.98,570,382,-188,-32.98,1139,966,-173,-15.19,SANTA ROSA DO SUL SC,-29.1354955,-49.7154188,23,4542
SC,SANTA TEREZINHA,1,1,0,0.0,4,3,-1,-25.0,24,16,-8,-33.33,56,75,19,33.93,735,455,-280,-38.1,820,550,-270,-32.93,SANTA TEREZINHA SC,-26.7813,-50.009017,23,4543
SC,SANTA TEREZINHA DO PROGRESSO,4,3,-1,-25.0,38,41,3,7.89,8,6,-2,-25.0,43,38,-5,-11.63,180,158,-22,-12.22,273,246,-27,-9.89,SANTA TEREZINHA DO PROGRESSO SC,-26.6197384,-53.1986638,23,4544
SC,SANTIAGO DO SUL,3,3,0,0.0,59,85,26,44.07,3,2,-1,-33.33,33,31,-2,-6.06,147,147,0,0.0,245,268,23,9.39,SANTIAGO DO SUL SC,-26.6346323,-52.6753323,23,4545
SC,SAO BERNARDINO,8,7,-1,-12.5,183,179,-4,-2.19,1,1,0,0.0,32,36,4,12.5,184,162,-22,-11.96,408,385,-23,-5.64,SAO BERNARDINO SC,-26.4712934,-52.9658921,23,4547
SC,SAO BONIFACIO,10,12,2,20.0,188,184,-4,-2.13,0,1,1,0.0,80,89,9,11.25,220,199,-21,-9.55,498,485,-13,-2.61,SAO BONIFACIO SC,-27.900907,-48.932608,23,4549
SC,SAO DOMINGOS,2,3,1,50.0,27,38,11,40.74,0,0,0,0.0,3,4,1,33.33,248,225,-23,-9.27,280,270,-10,-3.57,SAO DOMINGOS SC,-26.5593237,-52.5311718,23,4552
SC,SAO FRANCISCO DO SUL,17,12,-5,-29.41,1455,1488,33,2.27,451,535,84,18.63,2563,2497,-66,-2.58,6869,7063,194,2.82,11355,11595,240,2.11,SAO FRANCISCO DO SUL SC,-26.2495087,-48.6308087,23,4553
SC,SAO JOAO DO OESTE,71,71,0,0.0,543,653,110,20.26,45,65,20,44.44,314,288,-26,-8.28,479,462,-17,-3.55,1452,1539,87,5.99,SAO JOAO DO OESTE SC,-27.095202,-53.5950257,23,4554
SC,SAO JOAO BATISTA,0,0,0,0.0,0,0,0,0.0,0,0,0,0.0,51,51,0,0.0,1052,941,-111,-10.55,1103,992,-111,-10.06,SAO JOAO BATISTA SC,-27.277547,-48.8496101,23,4555
SC,SAO JOAO DO ITAPERIU,139,122,-17,-12.23,702,744,42,5.98,24,28,4,16.67,121,108,-13,-10.74,331,349,18,5.44,1317,1351,34,2.58,SAO JOAO DO ITAPERIU SC,-26.6186415,-48.7670219,23,4556
SC,SAO JOAO DO SUL,3,4,1,33.33,223,231,8,3.59,8,9,1,12.5,423,409,-14,-3.31,330,267,-63,-19.09,987,920,-67,-6.79,SAO JOAO DO SUL SC,-29.2246601,-49.8081785,23,4557
SC,SAO JOAQUIM,3292,3083,-209,-6.35,275,315,40,14.55,93,59,-34,-36.56,1136,1103,-33,-2.9,1846,1700,-146,-7.91,6642,6260,-382,-5.75,SAO JOAQUIM SC,-28.2924972,-49.9353255,23,4558
SC,SAO JOSE DO CEDRO,54,55,1,1.85,1187,1069,-118,-9.94,61,55,-6,-9.84,659,659,0,0.0,1106,1073,-33,-2.98,3067,2911,-156,-5.09,SAO JOSE DO CEDRO SC,-26.4555904,-53.4954785,23,4560
SC,SAO JOSE DO CERRITO,109,98,-11,-10.09,64,51,-13,-20.31,11,13,2,18.18,153,155,2,1.31,434,390,-44,-10.14,771,707,-64,-8.3,SAO JOSE DO CERRITO SC,-27.6627041,-50.5791762,23,4561
SC,SAO LOURENCO DO OESTE,52,54,2,3.85,6183,5888,-295,-4.77,213,193,-20,-9.39,1288,1325,37,2.87,2187,2220,33,1.51,9923,9680,-243,-2.45,SAO LOURENCO DO OESTE SC,-26.35566,-52.849837,23,4562
SC,SAO LUDGERO,191,161,-30,-15.71,2963,3135,172,5.8,194,155,-39,-20.1,744,749,5,0.67,829,819,-10,-1.21,4921,5019,98,1.99,SAO LUDGERO SC,-28.3243832,-49.174819,23,4563
SC,SAO MARTINHO,15,16,1,6.67,277,267,-10,-3.61,5,6,1,20.0,141,155,14,9.93,297,307,10,3.37,735,751,16,2.18,SAO MARTINHO SC,-28.165018,-48.9793424,23,4564
SC,SAO MIGUEL DA BOA VISTA,1,0,-1,-100.0,0,0,0,0.0,0,2,2,0.0,28,25,-3,-10.71,121,112,-9,-7.44,150,139,-11,-7.33,SAO MIGUEL DA BOA VISTA SC,-26.6911028,-53.2522818,23,4565
SC,SAO MIGUEL DO OESTE,212,211,-1,-0.47,4034,4400,366,9.07,1041,1153,112,10.76,3187,3162,-25,-0.78,5686,5713,27,0.47,14160,14639,479,3.38,SAO MIGUEL DO OESTE SC,-26.7278977,-53.5176689,23,4566
SC,SAUDADES,43,46,3,6.98,2076,2195,119,5.73,22,24,2,9.09,325,320,-5,-1.54,514,477,-37,-7.2,2980,3062,82,2.75,SAUDADES SC,-26.6976713,-52.638293,23,4568
SC,SEARA,407,527,120,29.48,4153,5023,870,20.95,127,146,19,14.96,805,862,57,7.08,1604,1803,199,12.41,7096,8361,1265,17.83,SEARA SC,-27.1528578,-52.3096985,23,4570
SC,SERRA ALTA,18,14,-4,-22.22,393,397,4,1.02,21,19,-2,-9.52,128,133,5,3.91,188,167,-21,-11.17,748,730,-18,-2.41,SERRA ALTA SC,-26.7291439,-53.0440668,23,4571
SC,SOMBRIO,34,31,-3,-8.82,2750,2356,-394,-14.33,105,103,-2,-1.9,2154,2108,-46,-2.14,2134,2029,-105,-4.92,7177,6627,-550,-7.66,SOMBRIO SC,-29.107985,-49.632776,23,4573
SC,SUL BRASIL,2,2,0,0.0,163,165,2,1.23,1,3,2,200.0,45,45,0,0.0,119,105,-14,-11.76,330,320,-10,-3.03,SUL BRASIL SC,-26.7379101,-52.9650177,23,4574
SC,TAIO,91,99,8,8.79,2780,2766,-14,-0.5,50,42,-8,-16.0,909,914,5,0.55,1595,1521,-74,-4.64,5425,5342,-83,-1.53,TAIO SC,-27.1167574,-50.0002159,23,4575
SC,TANGARA,14,21,7,50.0,169,187,18,10.65,0,1,1,0.0,211,218,7,3.32,658,607,-51,-7.75,1052,1034,-18,-1.71,TANGARA SC,-27.0997957,-51.2477143,23,4576
SC,TIGRINHOS,3,4,1,33.33,35,39,4,11.43,3,0,-3,-100.0,28,29,1,3.57,136,140,4,2.94,205,212,7,3.41,TIGRINHOS SC,-26.6869135,-53.1570085,23,4577
SC,TIJUCAS,59,102,43,72.88,4936,5297,361,7.31,557,605,48,8.62,3362,3472,110,3.27,4632,4807,175,3.78,13546,14283,737,5.44,TIJUCAS SC,-27.239404,-48.6353696,23,4578
SC,TIMBE DO SUL,8,4,-4,-50.0,140,159,19,13.57,70,47,-23,-32.86,150,143,-7,-4.67,358,323,-35,-9.78,726,676,-50,-6.89,TIMBE DO SUL SC,-28.8300122,-49.8466056,23,4579
SC,TIMBO,57,58,1,1.75,9857,10205,348,3.53,274,275,1,0.36,2961,2995,34,1.15,4577,4729,152,3.32,17726,18262,536,3.02,TIMBO SC,-26.8282737,-49.270641,23,4580
SC,TIMBO GRANDE,181,157,-24,-13.26,920,905,-15,-1.63,5,4,-1,-20.0,89,90,1,1.12,358,303,-55,-15.36,1553,1459,-94,-6.05,TIMBO GRANDE SC,-26.6170507,-50.6742579,23,4581
SC,TREZE DE MAIO,3,4,1,33.33,1264,1155,-109,-8.62,13,12,-1,-7.69,198,222,24,12.12,497,477,-20,-4.02,1975,1870,-105,-5.32,TREZE DE MAIO SC,-28.5574415,-49.1447586,23,4584
SC,TREZE TILIAS,103,88,-15,-14.56,2367,2620,253,10.69,43,40,-3,-6.98,461,478,17,3.69,952,835,-117,-12.29,3926,4061,135,3.44,TREZE TILIAS SC,-26.9996788,-51.4073067,23,4585
SC,TROMBUDO CENTRAL,52,50,-2,-3.85,1239,1291,52,4.2,12,20,8,66.67,209,225,16,7.66,515,541,26,5.05,2027,2127,100,4.93,TROMBUDO CENTRAL SC,-27.3040981,-49.79316,23,4586
SC,TUNAPOLIS,150,143,-7,-4.67,158,154,-4,-2.53,6,6,0,0.0,174,181,7,4.02,352,362,10,2.84,840,846,6,0.71,TUNAPOLIS SC,-26.97073,-53.6382084,23,4588
SC,TURVO,140,230,90,64.29,775,831,56,7.23,21,17,-4,-19.05,451,446,-5,-1.11,833,828,-5,-0.6,2220,2352,132,5.95,TURVO SC,-28.9277445,-49.6792206,23,4589
SC,UNIAO DO OESTE,24,22,-2,-8.33,75,79,4,5.33,0,0,0,0.0,41,41,0,0.0,165,144,-21,-12.73,305,286,-19,-6.23,UNIAO DO OESTE SC,-26.7642155,-52.8515985,23,4590
SC,URUBICI,263,267,4,1.52,57,57,0,0.0,15,22,7,46.67,405,436,31,7.65,937,915,-22,-2.35,1677,1697,20,1.19,URUBICI SC,-28.015663,-49.592547,23,4591
SC,URUPEMA,108,149,41,37.96,2,2,0,0.0,1,1,0,0.0,30,34,4,13.33,240,227,-13,-5.42,381,413,32,8.4,URUPEMA SC,-27.9557716,-49.875957,23,4592
SC,VARGEAO,181,189,8,4.42,435,439,4,0.92,9,4,-5,-55.56,136,134,-2,-1.47,366,348,-18,-4.92,1127,1114,-13,-1.15,VARGEAO SC,-26.861277,-52.1544966,23,4594
SC,VARGEM,98,80,-18,-18.37,223,162,-61,-27.35,13,32,19,146.15,203,200,-3,-1.48,397,436,39,9.82,934,910,-24,-2.57,VARGEM SC,-27.4909659,-50.9781096,23,4595
SC,VARGEM BONITA,92,117,25,27.17,10,10,0,0.0,3,5,2,66.67,36,38,2,5.56,198,183,-15,-7.58,339,353,14,4.13,VARGEM BONITA SC,-27.005456,-51.740238,23,4596
SC,VIDAL RAMOS,26,19,-7,-26.92,280,306,26,9.29,18,18,0,0.0,198,183,-15,-7.58,423,396,-27,-6.38,945,922,-23,-2.43,VIDAL RAMOS SC,-27.3908814,-49.3615664,23,4597
SC,VIDEIRA,1531,1613,82,5.36,7176,7432,256,3.57,933,1029,96,10.29,4588,4740,152,3.31,7456,7598,142,1.9,21684,22412,728,3.36,VIDEIRA SC,-27.00544,-51.1533733,23,4598
SC,VITOR MEIRELES,30,33,3,10.0,561,521,-40,-7.13,1,3,2,200.0,131,138,7,5.34,299,301,2,0.67,1022,996,-26,-2.54,VITOR MEIRELES SC,-26.879731,-49.833243,23,4599
SC,WITMARSUM,21,13,-8,-38.1,841,851,10,1.19,2,2,0,0.0,129,128,-1,-0.78,271,273,2,0.74,1264,1267,3,0.24,WITMARSUM SC,-26.927487,-49.794675,23,4600
SC,XANXERE,459,485,26,5.66,3472,3680,208,5.99,909,754,-155,-17.05,3678,3724,46,1.25,6034,5730,-304,-5.04,14552,14373,-179,-1.23,XANXERE SC,-26.8748603,-52.4035964,23,4601
SC,XAVANTINA,97,23,-74,-76.29,32,29,-3,-9.38,3,1,-2,-66.67,79,54,-25,-31.65,282,237,-45,-15.96,493,344,-149,-30.22,XAVANTINA SC,-27.0702363,-52.3431086,23,4602
SC,XAXIM,435,378,-57,-13.1,4083,4565,482,11.81,482,471,-11,-2.28,1467,1487,20,1.36,4102,4403,301,7.34,10569,11304,735,6.95,XAXIM SC,-26.9605363,-52.5335505,23,4603
RS,AGUA SANTA,57,68,11,19.3,103,84,-19,-18.45,4,3,-1,-25.0,195,206,11,5.64,275,271,-4,-1.45,634,632,-2,-0.32,AGUA SANTA RS,-28.1775297,-52.0360304,22,4607
RS,AGUDO,27,23,-4,-14.81,677,604,-73,-10.78,107,101,-6,-5.61,807,803,-4,-0.5,974,898,-76,-7.8,2592,2429,-163,-6.29,AGUDO RS,-29.6423259,-53.2494005,22,4608
RS,AJURICABA,78,73,-5,-6.41,111,107,-4,-3.6,80,91,11,13.75,384,397,13,3.39,495,511,16,3.23,1148,1179,31,2.7,AJURICABA RS,-28.239654,-53.7693013,22,4609
RS,ALECRIM,16,18,2,12.5,40,38,-2,-5.0,1,1,0,0.0,186,173,-13,-6.99,289,268,-21,-7.27,532,498,-34,-6.39,ALECRIM RS,-27.6566142,-54.7653195,22,4610
RS,ALEGRETE,1836,1519,-317,-17.27,1868,1872,4,0.21,598,636,38,6.35,3497,3461,-36,-1.03,5631,5243,-388,-6.89,13430,12731,-699,-5.2,ALEGRETE RS,-29.790166,-55.794862,22,4611
RS,ALEGRIA,22,21,-1,-4.55,13,13,0,0.0,0,0,0,0.0,121,111,-10,-8.26,254,215,-39,-15.35,410,360,-50,-12.2,ALEGRIA RS,-27.8332103,-54.0574959,22,4612
RS,ALMIRANTE TAMANDARE DO SUL,87,81,-6,-6.9,209,222,13,6.22,0,0,0,0.0,85,82,-3,-3.53,168,143,-25,-14.88,549,528,-21,-3.83,ALMIRANTE TAMANDARE DO SUL RS,-28.1141129,-52.9134874,22,4613
RS,ALPESTRE,1,1,0,0.0,72,63,-9,-12.5,3,4,1,33.33,193,204,11,5.7,524,496,-28,-5.34,793,768,-25,-3.15,ALPESTRE RS,-27.2512339,-53.0349646,22,4614
RS,ALTO ALEGRE,101,104,3,2.97,0,0,0,0.0,0,1,1,0.0,38,46,8,21.05,709,640,-69,-9.73,848,791,-57,-6.72,ALTO ALEGRE RS,-28.78345515,-53.00191079167412,22,4615
RS,ALTO FELIZ,123,136,13,10.57,394,400,6,1.52,1,0,-1,-100.0,59,35,-24,-40.68,217,259,42,19.35,794,830,36,4.53,ALTO FELIZ RS,-29.3785943,-51.3123751,22,4616
RS,AMARAL FERRADOR,12,7,-5,-41.67,3,9,6,200.0,0,0,0,0.0,41,42,1,2.44,419,347,-72,-17.18,475,405,-70,-14.74,AMARAL FERRADOR RS,-30.8750633,-52.2542051,22,4618
RS,AMETISTA DO SUL,1,0,-1,-100.0,479,355,-124,-25.89,19,12,-7,-36.84,242,174,-68,-28.1,432,378,-54,-12.5,1173,919,-254,-21.65,AMETISTA DO SUL RS,-27.3617341,-53.1826575,22,4619
RS,ANDRE DA ROCHA,117,120,3,2.56,42,34,-8,-19.05,0,0,0,0.0,25,31,6,24.0,113,118,5,4.42,297,303,6,2.02,ANDRE DA ROCHA RS,-28.6309124,-51.5733328,22,4620
RS,ANTA GORDA,45,40,-5,-11.11,408,314,-94,-23.04,17,14,-3,-17.65,381,409,28,7.35,482,431,-51,-10.58,1333,1208,-125,-9.38,ANTA GORDA RS,-28.9718745,-52.0069187,22,4621
RS,ANTONIO PRADO,99,72,-27,-27.27,1983,2017,34,1.71,32,46,14,43.75,675,657,-18,-2.67,1063,993,-70,-6.59,3852,3785,-67,-1.74,ANTONIO PRADO RS,-28.8567806,-51.2801355,22,4622
RS,ARAMBARE,236,226,-10,-4.24,7,7,0,0.0,0,0,0,0.0,89,105,16,17.98,288,249,-39,-13.54,620,587,-33,-5.32,ARAMBARE RS,-30.9132252,-51.4994625,22,4623
RS,ARATIBA,135,127,-8,-5.93,276,259,-17,-6.16,67,49,-18,-26.87,188,181,-7,-3.72,621,498,-123,-19.81,1287,1114,-173,-13.44,ARATIBA RS,-27.3955734,-52.3024325,22,4625
RS,ARROIO DO SAL,3,5,2,66.67,77,65,-12,-15.58,39,37,-2,-5.13,835,904,69,8.26,1001,934,-67,-6.69,1955,1945,-10,-0.51,ARROIO DO SAL RS,-29.549852,-49.8874395,22,4627
RS,ARROIO DOS RATOS,81,70,-11,-13.58,250,241,-9,-3.6,10,7,-3,-30.0,500,520,20,4.0,934,896,-38,-4.07,1775,1734,-41,-2.31,ARROIO DOS RATOS RS,-30.0894524,-51.7265541,22,4629
RS,ARROIO DO TIGRE,0,1,1,0.0,475,424,-51,-10.74,12,12,0,0.0,552,550,-2,-0.36,826,823,-3,-0.36,1865,1810,-55,-2.95,ARROIO DO TIGRE RS,-29.334158,-53.0888935,22,4630
RS,ARROIO GRANDE,909,877,-32,-3.52,69,88,19,27.54,4,5,1,25.0,636,642,6,0.94,939,784,-155,-16.51,2557,2396,-161,-6.3,ARROIO GRANDE RS,-29.548078,-52.0971166,22,4631
RS,ARVOREZINHA,5,3,-2,-40.0,489,493,4,0.82,51,64,13,25.49,365,390,25,6.85,711,633,-78,-10.97,1621,1583,-38,-2.34,ARVOREZINHA RS,-28.8731093,-52.1757917,22,4632
RS,AUGUSTO PESTANA,66,79,13,19.7,129,128,-1,-0.78,65,95,30,46.15,420,408,-12,-2.86,543,522,-21,-3.87,1223,1232,9,0.74,AUGUSTO PESTANA RS,-28.5148413,-53.9906433,22,4633
RS,AUREA,11,8,-3,-27.27,108,103,-5,-4.63,9,5,-4,-44.44,85,85,0,0.0,256,250,-6,-2.34,469,451,-18,-3.84,AUREA RS,-27.6970921,-52.0521778,22,4634
RS,BAGE,1337,1224,-113,-8.45,2008,2018,10,0.5,495,517,22,4.44,6347,6400,53,0.84,11587,11387,-200,-1.73,21774,21546,-228,-1.05,BAGE RS,-31.3314264,-54.1062808,22,4635
RS,BARAO,28,29,1,3.57,1084,1059,-25,-2.31,209,241,32,15.31,121,131,10,8.26,330,317,-13,-3.94,1772,1777,5,0.28,BARAO RS,-29.372474,-51.494908,22,4637
RS,BARAO DE COTEGIPE,40,28,-12,-30.0,440,418,-22,-5.0,34,67,33,97.06,321,329,8,2.49,516,540,24,4.65,1351,1382,31,2.29,BARAO DE COTEGIPE RS,-27.6214694,-52.3765316,22,4638
RS,BARAO DO TRIUNFO,12,2,-10,-83.33,6,6,0,0.0,0,0,0,0.0,104,98,-6,-5.77,278,302,24,8.63,400,408,8,2.0,BARAO DO TRIUNFO RS,-30.3909877,-51.7375349,22,4639
RS,BARRACAO,35,49,14,40.0,265,254,-11,-4.15,43,48,5,11.63,778,761,-17,-2.19,942,874,-68,-7.22,2063,1986,-77,-3.73,BARRACAO RS,-27.6722339,-51.4583497,22,4640
RS,BARRA DO QUARAI,110,181,71,64.55,16,16,0,0.0,2,2,0,0.0,347,332,-15,-4.32,367,343,-24,-6.54,842,874,32,3.8,BARRA DO QUARAI RS,-30.208947,-57.5505128,22,4642
RS,BARRA DO RIBEIRO,792,756,-36,-4.55,349,296,-53,-15.19,19,16,-3,-15.79,310,340,30,9.68,651,633,-18,-2.76,2121,2041,-80,-3.77,BARRA DO RIBEIRO RS,-30.2930206,-51.301437,22,4643
RS,BARRA DO RIO AZUL,10,11,1,10.0,2,2,0,0.0,2,0,-2,-100.0,13,17,4,30.77,165,178,13,7.88,192,208,16,8.33,BARRA DO RIO AZUL RS,-27.4086573,-52.41305,22,4644
RS,BARRA FUNDA,6,4,-2,-33.33,267,271,4,1.5,213,176,-37,-17.37,135,127,-8,-5.93,249,233,-16,-6.43,870,811,-59,-6.78,BARRA FUNDA RS,-27.9230048,-53.0401045,22,4645
RS,BARROS CASSAL,13,11,-2,-15.38,32,22,-10,-31.25,5,2,-3,-60.0,250,249,-1,-0.4,526,513,-13,-2.47,826,797,-29,-3.51,BARROS CASSAL RS,-29.094938,-52.5832366,22,4646
RS,BENJAMIN CONSTANT DO SUL,0,1,1,0.0,11,19,8,72.73,0,0,0,0.0,18,20,2,11.11,177,125,-52,-29.38,206,165,-41,-19.9,BENJAMIN CONSTANT DO SUL RS,-27.5105555,-52.6007689,22,4647
RS,BENTO GONCALVES,108,95,-13,-12.04,16604,17473,869,5.23,2273,2185,-88,-3.87,6707,6782,75,1.12,17965,17059,-906,-5.04,43657,43594,-63,-0.14,BENTO GONCALVES RS,-29.1654014,-51.5197627,22,4648
RS,BOA VISTA DAS MISSOES,54,58,4,7.41,13,9,-4,-30.77,3,3,0,0.0,91,94,3,3.3,226,201,-25,-11.06,387,365,-22,-5.68,BOA VISTA DAS MISSOES RS,-27.6677983,-53.3127622,22,4649
RS,BOA VISTA DO BURICA,12,11,-1,-8.33,469,404,-65,-13.86,29,29,0,0.0,421,433,12,2.85,741,699,-42,-5.67,1672,1576,-96,-5.74,BOA VISTA DO BURICA RS,-27.6687782,-54.1111913,22,4650
RS,BOA VISTA DO CADEADO,144,151,7,4.86,4,0,-4,-100.0,0,0,0,0.0,71,63,-8,-11.27,188,157,-31,-16.49,407,371,-36,-8.85,BOA VISTA DO CADEADO RS,-28.5783827,-53.8123759,22,4651
RS,BOA VISTA DO INCRA,112,113,1,0.89,3,1,-2,-66.67,0,0,0,0.0,53,56,3,5.66,269,269,0,0.0,437,439,2,0.46,BOA VISTA DO INCRA RS,-28.8195551,-53.3866624,22,4652
RS,BOA VISTA DO SUL,26,29,3,11.54,320,310,-10,-3.12,8,7,-1,-12.5,47,48,1,2.13,221,206,-15,-6.79,622,600,-22,-3.54,BOA VISTA DO SUL RS,-29.3510488,-51.6779679,22,4653
RS,BOM JESUS,438,424,-14,-3.2,117,144,27,23.08,60,53,-7,-11.67,1206,1243,37,3.07,1703,1381,-322,-18.91,3524,3245,-279,-7.92,BOM JESUS RS,-28.6692723,-50.4346894,22,4654
RS,BOM PRINCIPIO,11,14,3,27.27,2745,3012,267,9.73,363,411,48,13.22,649,611,-38,-5.86,962,556,-406,-42.2,4730,4604,-126,-2.66,BOM PRINCIPIO RS,-29.489788,-51.3566782,22,4655
RS,BOM PROGRESSO,14,9,-5,-35.71,65,62,-3,-4.62,0,0,0,0.0,53,53,0,0.0,224,194,-30,-13.39,356,318,-38,-10.67,BOM PROGRESSO RS,-27.5490948,-53.8655601,22,4656
RS,BOQUEIRAO DO LEAO,26,23,-3,-11.54,39,31,-8,-20.51,97,3,-94,-96.91,119,108,-11,-9.24,359,290,-69,-19.22,640,455,-185,-28.91,BOQUEIRAO DO LEAO RS,-29.30332,-52.4296817,22,4658
RS,BOSSOROCA,274,273,-1,-0.36,3,3,0,0.0,4,0,-4,-100.0,237,234,-3,-1.27,505,513,8,1.58,1023,1023,0,0.0,BOSSOROCA RS,-28.7278885,-54.9120278,22,4659
RS,BOZANO,28,28,0,0.0,6,6,0,0.0,0,4,4,0.0,59,57,-2,-3.39,135,117,-18,-13.33,228,212,-16,-7.02,BOZANO RS,-28.3669953,-53.7705165,22,4660
RS,BRAGA,13,14,1,7.69,16,16,0,0.0,0,0,0,0.0,70,74,4,5.71,239,239,0,0.0,338,343,5,1.48,BRAGA RS,-27.617348,-53.740514,22,4661
RS,BROCHIER,44,38,-6,-13.64,161,164,3,1.86,8,3,-5,-62.5,188,216,28,14.89,274,251,-23,-8.39,675,672,-3,-0.44,BROCHIER RS,-29.556766,-51.5963047,22,4662
RS,BUTIA,667,574,-93,-13.94,356,324,-32,-8.99,41,41,0,0.0,710,688,-22,-3.1,1902,1863,-39,-2.05,3676,3490,-186,-5.06,BUTIA RS,-30.1256795,-51.9692224,22,4663
RS,CACAPAVA DO SUL,429,378,-51,-11.89,1444,1445,1,0.07,68,119,51,75.0,1582,1624,42,2.65,2721,2278,-443,-16.28,6244,5844,-400,-6.41,CACAPAVA DO SUL RS,-30.5113286,-53.4916761,22,4664
RS,CACEQUI,404,375,-29,-7.18,23,30,7,30.43,42,33,-9,-21.43,311,315,4,1.29,631,668,37,5.86,1411,1421,10,0.71,CACEQUI RS,-29.8838059,-54.8273443,22,4665
RS,CACHOEIRA DO SUL,1150,1091,-59,-5.13,2285,2634,349,15.27,257,348,91,35.41,4091,3889,-202,-4.94,6570,5867,-703,-10.7,14353,13829,-524,-3.65,CACHOEIRA DO SUL RS,-30.0482234,-52.8901686,22,4666
RS,CACIQUE DOBLE,1,1,0,0.0,38,29,-9,-23.68,6,5,-1,-16.67,89,98,9,10.11,297,291,-6,-2.02,431,424,-7,-1.62,CACIQUE DOBLE RS,-27.7700117,-51.6616409,22,4668
RS,CAIBATE,62,60,-2,-3.23,228,235,7,3.07,18,19,1,5.56,205,217,12,5.85,409,394,-15,-3.67,922,925,3,0.33,CAIBATE RS,-28.290475,-54.645407,22,4669
RS,CAICARA,5,5,0,0.0,23,20,-3,-13.04,3,2,-1,-33.33,28,29,1,3.57,375,329,-46,-12.27,434,385,-49,-11.29,CAICARA RS,-27.2750478,-53.4310053,22,4670
RS,CAMAQUA,693,697,4,0.58,2176,2304,128,5.88,306,366,60,19.61,4085,3857,-228,-5.58,4539,4414,-125,-2.75,11799,11638,-161,-1.36,CAMAQUA RS,-30.8524752,-51.8075619,22,4671
RS,CAMARGO,27,29,2,7.41,234,185,-49,-20.94,2,0,-2,-100.0,107,121,14,13.08,267,260,-7,-2.62,637,595,-42,-6.59,CAMARGO RS,-28.5865661,-52.2031474,22,4672
RS,CAMBARA DO SUL,127,114,-13,-10.24,550,437,-113,-20.55,5,0,-5,-100.0,176,179,3,1.7,666,628,-38,-5.71,1524,1358,-166,-10.89,CAMBARA DO SUL RS,-29.0489517,-50.145412,22,4673
RS,CAMPESTRE DA SERRA,111,117,6,5.41,80,78,-2,-2.5,0,0,0,0.0,55,60,5,9.09,240,247,7,2.92,486,502,16,3.29,CAMPESTRE DA SERRA RS,-28.7188986,-51.10637993712327,22,4674
RS,CAMPINA DAS MISSOES,6,6,0,0.0,93,98,5,5.38,44,43,-1,-2.27,201,205,4,1.99,396,376,-20,-5.05,740,728,-12,-1.62,CAMPINA DAS MISSOES RS,-27.9910517,-54.8404714,22,4675
RS,CAMPINAS DO SUL,139,144,5,3.6,118,114,-4,-3.39,7,4,-3,-42.86,278,255,-23,-8.27,447,423,-24,-5.37,989,940,-49,-4.95,CAMPINAS DO SUL RS,-27.7167968,-52.6257885,22,4676
RS,CAMPO NOVO,98,93,-5,-5.1,156,134,-22,-14.1,21,24,3,14.29,413,367,-46,-11.14,412,412,0,0.0,1100,1030,-70,-6.36,CAMPO NOVO RS,-27.65048725,-53.81568759295091,22,4678
RS,CAMPOS BORGES,21,21,0,0.0,74,72,-2,-2.7,3,5,2,66.67,190,174,-16,-8.42,229,241,12,5.24,517,513,-4,-0.77,CAMPOS BORGES RS,-28.8852198,-52.999098,22,4679
RS,CANDELARIA,74,73,-1,-1.35,2139,897,-1242,-58.06,71,57,-14,-19.72,1247,1322,75,6.01,1544,1518,-26,-1.68,5075,3867,-1208,-23.8,CANDELARIA RS,-29.668391,-52.789495,22,4680
RS,CANDIDO GODOI,19,23,4,21.05,370,426,56,15.14,24,21,-3,-12.5,276,307,31,11.23,463,440,-23,-4.97,1152,1217,65,5.64,CANDIDO GODOI RS,-27.951509,-54.751722,22,4681
RS,CANGUCU,386,349,-37,-9.59,261,217,-44,-16.86,39,30,-9,-23.08,1834,1824,-10,-0.55,2666,2557,-109,-4.09,5186,4977,-209,-4.03,CANGUCU RS,-31.398276,-52.6773522,22,4684
RS,CANUDOS DO VALE,2,1,-1,-50.0,38,35,-3,-7.89,0,1,1,0.0,15,12,-3,-20.0,123,117,-6,-4.88,178,166,-12,-6.74,CANUDOS DO VALE RS,-29.3240418,-52.2348494,22,4686
RS,CAPAO DA CANOA,12,15,3,25.0,465,421,-44,-9.46,1325,1284,-41,-3.09,4398,4586,188,4.27,6911,6462,-449,-6.5,13111,12768,-343,-2.62,CAPAO DA CANOA RS,-29.7508278,-50.0210729,22,4688
RS,CAPAO DO CIPO,144,173,29,20.14,1,1,0,0.0,2,3,1,50.0,100,99,-1,-1.0,216,221,5,2.31,463,497,34,7.34,CAPAO DO CIPO RS,-28.9317296,-54.5555783,22,4689
RS,CAPIVARI DO SUL,248,236,-12,-4.84,141,165,24,17.02,15,9,-6,-40.0,317,349,32,10.09,381,376,-5,-1.31,1102,1135,33,2.99,CAPIVARI DO SUL RS,-30.1437605,-50.5129169,22,4691
RS,CAPITAO,102,96,-6,-5.88,151,103,-48,-31.79,55,41,-14,-25.45,48,44,-4,-8.33,223,236,13,5.83,579,520,-59,-10.19,CAPITAO RS,-29.2718294,-51.9869716,22,4693
RS,CARAZINHO,683,652,-31,-4.54,2265,2514,249,10.99,470,517,47,10.0,4556,4560,4,0.09,6563,6329,-234,-3.57,14537,14572,35,0.24,CARAZINHO RS,-28.2981634,-52.7942363,22,4694
RS,CARAA,3,5,2,66.67,657,550,-107,-16.29,9,10,1,11.11,78,79,1,1.28,288,256,-32,-11.11,1035,900,-135,-13.04,CARAA RS,-29.7900698,-50.4302307,22,4695
RS,CARLOS GOMES,0,0,0,0.0,6,6,0,0.0,20,30,10,50.0,11,8,-3,-27.27,148,132,-16,-10.81,185,176,-9,-4.86,CARLOS GOMES RS,-27.7161093,-51.9135613,22,4697
RS,CASCA,69,81,12,17.39,833,938,105,12.61,54,43,-11,-20.37,684,696,12,1.75,1301,1121,-180,-13.84,2941,2879,-62,-2.11,CASCA RS,-28.5634054,-51.9741902,22,4698
RS,CASEIROS,60,51,-9,-15.0,32,49,17,53.12,6,8,2,33.33,131,127,-4,-3.05,206,221,15,7.28,435,456,21,4.83,CASEIROS RS,-28.2721149,-51.6873536,22,4699
RS,CATUIPE,185,174,-11,-5.95,64,62,-2,-3.12,1,4,3,300.0,395,403,8,2.03,622,588,-34,-5.47,1267,1231,-36,-2.84,CATUIPE RS,-28.255356,-54.013215,22,4700
RS,CAXIAS DO SUL,1650,1958,308,18.67,62793,62222,-571,-0.91,4459,3901,-558,-12.51,27238,26351,-887,-3.26,60165,57977,-2188,-3.64,156305,152409,-3896,-2.49,CAXIAS DO SUL RS,-29.1684951,-51.1796197,22,4701
RS,CENTENARIO,55,45,-10,-18.18,0,0,0,0.0,0,0,0,0.0,13,12,-1,-7.69,178,173,-5,-2.81,246,230,-16,-6.5,CENTENARIO RS,-29.16500905,-51.19661284321356,22,4702
RS,CERRO BRANCO,3,3,0,0.0,15,14,-1,-6.67,1,2,1,100.0,87,92,5,5.75,296,249,-47,-15.88,402,360,-42,-10.45,CERRO BRANCO RS,-29.6359134,-52.949799,22,4704
RS,CERRO GRANDE,1,1,0,0.0,0,0,0,0.0,0,0,0,0.0,40,43,3,7.5,203,239,36,17.73,244,283,39,15.98,CERRO GRANDE RS,-27.6088939,-53.1663055,22,4705
RS,CERRO GRANDE DO SUL,27,27,0,0.0,159,156,-3,-1.89,5,2,-3,-60.0,331,345,14,4.23,448,437,-11,-2.46,970,967,-3,-0.31,CERRO GRANDE DO SUL RS,-30.5962963,-51.7517196,22,4706
RS,CERRO LARGO,68,66,-2,-2.94,521,508,-13,-2.5,56,45,-11,-19.64,1175,1144,-31,-2.64,1380,1337,-43,-3.12,3200,3100,-100,-3.12,CERRO LARGO RS,-28.147498,-54.7383681,22,4707
RS,CHAPADA,134,136,2,1.49,677,671,-6,-0.89,13,17,4,30.77,590,558,-32,-5.42,823,775,-48,-5.83,2237,2157,-80,-3.58,CHAPADA RS,-28.0587829,-53.0657459,22,4708
RS,CHARRUA,43,45,2,4.65,1,1,0,0.0,0,0,0,0.0,51,53,2,3.92,153,146,-7,-4.58,248,245,-3,-1.21,CHARRUA RS,-27.9533747,-52.0312591,22,4710
RS,CHIAPETTA,146,158,12,8.22,11,20,9,81.82,10,13,3,30.0,152,162,10,6.58,437,320,-117,-26.77,756,673,-83,-10.98,CHIAPETTA RS,-27.923162,-53.9419052,22,4711
RS,CHUI,23,15,-8,-34.78,13,13,0,0.0,8,12,4,50.0,1087,1014,-73,-6.72,807,673,-134,-16.6,1938,1727,-211,-10.89,CHUI RS,-33.6895237,-53.454704,22,4712
RS,CHUVISCA,3,3,0,0.0,43,47,4,9.3,0,0,0,0.0,27,28,1,3.7,268,279,11,4.1,341,357,16,4.69,CHUVISCA RS,-30.7557984,-51.9784928,22,4713
RS,CIRIACO,58,51,-7,-12.07,68,125,57,83.82,9,6,-3,-33.33,151,81,-70,-46.36,312,268,-44,-14.1,598,531,-67,-11.2,CIRIACO RS,-28.3429139,-51.8763682,22,4715
RS,COLINAS,43,35,-8,-18.6,163,134,-29,-17.79,219,194,-25,-11.42,615,562,-53,-8.62,1592,1980,388,24.37,2632,2905,273,10.37,COLINAS RS,-29.3866023,-51.8697911,22,4716
RS,COLORADO,69,65,-4,-5.8,3896,3785,-111,-2.85,42,29,-13,-30.95,1043,999,-44,-4.22,1808,1835,27,1.49,6858,6713,-145,-2.11,COLORADO RS,-28.525842,-52.99282,22,4717
RS,CONDOR,322,288,-34,-10.56,501,496,-5,-1.0,22,27,5,22.73,505,526,21,4.16,428,388,-40,-9.35,1778,1725,-53,-2.98,CONDOR RS,-28.2058277,-53.4844696,22,4718
RS,CONSTANTINA,21,21,0,0.0,546,543,-3,-0.55,56,53,-3,-5.36,649,598,-51,-7.86,774,680,-94,-12.14,2046,1895,-151,-7.38,CONSTANTINA RS,-27.7331711,-52.9929561,22,4719
RS,COQUEIRO BAIXO,5,3,-2,-40.0,3,3,0,0.0,4,5,1,25.0,10,9,-1,-10.0,110,109,-1,-0.91,132,129,-3,-2.27,COQUEIRO BAIXO RS,-29.181566,-52.097034,22,4720
RS,COQUEIROS DO SUL,21,25,4,19.05,21,43,22,104.76,2,0,-2,-100.0,64,66,2,3.12,177,161,-16,-9.04,285,295,10,3.51,COQUEIROS DO SUL RS,-28.1184032,-52.7824375,22,4721
RS,CORONEL BARROS,17,20,3,17.65,75,87,12,16.0,7,6,-1,-14.29,95,93,-2,-2.11,173,152,-21,-12.14,367,358,-9,-2.45,CORONEL BARROS RS,-28.3826325,-54.0704116,22,4722
RS,CORONEL BICACO,133,101,-32,-24.06,48,44,-4,-8.33,0,2,2,0.0,310,325,15,4.84,458,480,22,4.8,949,952,3,0.32,CORONEL BICACO RS,-27.7174002,-53.705821,22,4723
RS,CORONEL PILAR,1,1,0,0.0,14,14,0,0.0,9,11,2,22.22,7,5,-2,-28.57,109,100,-9,-8.26,140,131,-9,-6.43,CORONEL PILAR RS,-29.27318,-51.6852347,22,4724
RS,COTIPORA,1,1,0,0.0,418,441,23,5.5,6,9,3,50.0,68,67,-1,-1.47,210,177,-33,-15.71,703,695,-8,-1.14,COTIPORA RS,-28.9950719,-51.696359,22,4725
RS,COXILHA,194,209,15,7.73,72,78,6,8.33,0,0,0,0.0,105,137,32,30.48,303,237,-66,-21.78,674,661,-13,-1.93,COXILHA RS,-28.1255645,-52.2976394,22,4726
RS,CRISSIUMAL,46,39,-7,-15.22,693,630,-63,-9.09,59,65,6,10.17,624,600,-24,-3.85,997,1013,16,1.6,2419,2347,-72,-2.98,CRISSIUMAL RS,-27.4982242,-54.1024643,22,4727
RS,CRISTAL,270,257,-13,-4.81,37,47,10,27.03,22,18,-4,-18.18,264,269,5,1.89,1863,1766,-97,-5.21,2456,2357,-99,-4.03,CRISTAL RS,-31.00166,-52.0491777,22,4728
RS,CRISTAL DO SUL,7,10,3,42.86,3,1,-2,-66.67,0,0,0,0.0,25,30,5,20.0,180,141,-39,-21.67,215,182,-33,-15.35,CRISTAL DO SUL RS,-27.454386,-53.2482974,22,4729
RS,CRUZ ALTA,980,977,-3,-0.31,1442,1499,57,3.95,257,376,119,46.3,3880,3759,-121,-3.12,5970,5665,-305,-5.11,12529,12276,-253,-2.02,CRUZ ALTA RS,-28.645056,-53.6058047,22,4730
RS,CRUZALTENSE,0,7,7,0.0,8,7,-1,-12.5,0,0,0,0.0,31,33,2,6.45,156,128,-28,-17.95,195,175,-20,-10.26,CRUZALTENSE RS,-27.667414,-52.6487833,22,4731
RS,DAVID CANABARRO,12,12,0,0.0,112,91,-21,-18.75,1,2,1,100.0,165,166,1,0.61,375,355,-20,-5.33,665,626,-39,-5.86,DAVID CANABARRO RS,-28.3878667,-51.8472645,22,4733
RS,DERRUBADAS,5,5,0,0.0,28,28,0,0.0,1,1,0,0.0,72,66,-6,-8.33,224,204,-20,-8.93,330,304,-26,-7.88,DERRUBADAS RS,-27.2657279,-53.8618488,22,4734
RS,DEZESSEIS DE NOVEMBRO,18,21,3,16.67,1,1,0,0.0,0,0,0,0.0,21,16,-5,-23.81,158,124,-34,-21.52,198,162,-36,-18.18,DEZESSEIS DE NOVEMBRO RS,-28.2248993,-55.0480474,22,4735
RS,DILERMANDO DE AGUIAR,88,84,-4,-4.55,0,2,2,0.0,31,27,-4,-12.9,41,52,11,26.83,191,190,-1,-0.52,351,355,4,1.14,DILERMANDO DE AGUIAR RS,-29.7049966,-54.2078988,22,4736
RS,DOIS IRMAOS DAS MISSOES,124,126,2,1.61,1,0,-1,-100.0,0,0,0,0.0,54,52,-2,-3.7,211,206,-5,-2.37,390,384,-6,-1.54,DOIS IRMAOS DAS MISSOES RS,-27.6598825,-53.5330891,22,4738
RS,DOIS LAJEADOS,26,29,3,11.54,151,163,12,7.95,6,4,-2,-33.33,71,63,-8,-11.27,289,280,-9,-3.11,543,539,-4,-0.74,DOIS LAJEADOS RS,-28.984916,-51.8366385,22,4739
RS,DOM FELICIANO,35,44,9,25.71,42,41,-1,-2.38,0,0,0,0.0,262,273,11,4.2,640,603,-37,-5.78,979,961,-18,-1.84,DOM FELICIANO RS,-30.70214,-52.1080845,22,4740
RS,DOM PEDRO DE ALCANTARA,30,32,2,6.67,48,50,2,4.17,7,7,0,0.0,96,94,-2,-2.08,205,182,-23,-11.22,386,365,-21,-5.44,DOM PEDRO DE ALCANTARA RS,-29.3698329,-49.8479971,22,4741
RS,DOM PEDRITO,1879,1813,-66,-3.51,480,506,26,5.42,35,27,-8,-22.86,1847,1787,-60,-3.25,2483,2503,20,0.81,6724,6636,-88,-1.31,DOM PEDRITO RS,-30.983755,-54.6746483,22,4742
RS,DONA FRANCISCA,0,0,0,0.0,77,81,4,5.19,89,58,-31,-34.83,34,31,-3,-8.82,155,153,-2,-1.29,355,323,-32,-9.01,DONA FRANCISCA RS,-29.623063,-53.3560585,22,4743
RS,DOUTOR MAURICIO CARDOSO,46,46,0,0.0,28,25,-3,-10.71,6,3,-3,-50.0,219,193,-26,-11.87,292,277,-15,-5.14,591,544,-47,-7.95,DOUTOR MAURICIO CARDOSO RS,-27.5067264,-54.3626756,22,4744
RS,DOUTOR RICARDO,11,9,-2,-18.18,173,166,-7,-4.05,5,6,1,20.0,35,33,-2,-5.71,109,111,2,1.83,333,325,-8,-2.4,DOUTOR RICARDO RS,-29.0901549,-51.9894847,22,4745
RS,ENCANTADO,108,124,16,14.81,3518,3604,86,2.44,407,412,5,1.23,1575,1584,9,0.57,2083,2048,-35,-1.68,7691,7772,81,1.05,ENCANTADO RS,-29.2392716,-51.8744817,22,4747
RS,ENCRUZILHADA DO SUL,963,825,-138,-14.33,660,714,54,8.18,11,10,-1,-9.09,791,808,17,2.15,1312,1258,-54,-4.12,3737,3615,-122,-3.26,ENCRUZILHADA DO SUL RS,-30.5361752,-52.51560417047334,22,4748
RS,ENGENHO VELHO,1,0,-1,-100.0,7,7,0,0.0,5,2,-3,-60.0,25,27,2,8.0,135,131,-4,-2.96,173,167,-6,-3.47,ENGENHO VELHO RS,-27.7114504,-52.9125692,22,4749
RS,ENTRE RIOS DO SUL,4,4,0,0.0,76,69,-7,-9.21,3,1,-2,-66.67,92,84,-8,-8.7,227,190,-37,-16.3,402,348,-54,-13.43,ENTRE RIOS DO SUL RS,-27.5299266,-52.7325438,22,4751
RS,EREBANGO,74,57,-17,-22.97,37,51,14,37.84,0,1,1,0.0,36,34,-2,-5.56,208,185,-23,-11.06,355,328,-27,-7.61,EREBANGO RS,-27.8542708,-52.3029274,22,4752
RS,ERECHIM,188,208,20,10.64,12559,13532,973,7.75,2117,1836,-281,-13.27,7785,7783,-2,-0.03,13206,12995,-211,-1.6,35855,36354,499,1.39,ERECHIM RS,-27.6350709,-52.2738654,22,4753
RS,ERNESTINA,75,57,-18,-24.0,54,49,-5,-9.26,4,2,-2,-50.0,126,131,5,3.97,311,279,-32,-10.29,570,518,-52,-9.12,ERNESTINA RS,-28.498434,-52.5702451,22,4754
RS,HERVAL,166,158,-8,-4.82,12,12,0,0.0,0,0,0,0.0,149,165,16,10.74,444,451,7,1.58,771,786,15,1.95,HERVAL RS,-32.0260806,-53.3951333,22,4755
RS,ERVAL GRANDE,118,125,7,5.93,119,135,16,13.45,26,31,5,19.23,72,72,0,0.0,347,359,12,3.46,682,722,40,5.87,ERVAL GRANDE RS,-27.3910282,-52.5703742,22,4756
RS,ERVAL SECO,48,48,0,0.0,88,77,-11,-12.5,6,7,1,16.67,254,260,6,2.36,399,384,-15,-3.76,795,776,-19,-2.39,ERVAL SECO RS,-27.5511418,-53.506851,22,4757
RS,ESMERALDA,156,134,-22,-14.1,13,14,1,7.69,4,5,1,25.0,124,116,-8,-6.45,268,230,-38,-14.18,565,499,-66,-11.68,ESMERALDA RS,-28.0543707,-51.1921896,22,4758
RS,ESPERANCA DO SUL,2,1,-1,-50.0,79,75,-4,-5.06,1,1,0,0.0,33,30,-3,-9.09,220,168,-52,-23.64,335,275,-60,-17.91,ESPERANCA DO SUL RS,-27.3617442,-53.9909736,22,4759
RS,ESPUMOSO,164,185,21,12.8,418,332,-86,-20.57,112,92,-20,-17.86,1378,1359,-19,-1.38,1096,991,-105,-9.58,3168,2959,-209,-6.6,ESPUMOSO RS,-28.7256962,-52.8453751,22,4760
RS,ESTRELA VELHA,44,43,-1,-2.27,2,2,0,0.0,0,1,1,0.0,156,144,-12,-7.69,300,258,-42,-14.0,502,448,-54,-10.76,ESTRELA VELHA RS,-29.1775802,-53.1597523,22,4765
RS,EUGENIO DE CASTRO,78,75,-3,-3.85,6,5,-1,-16.67,1,1,0,0.0,82,84,2,2.44,188,176,-12,-6.38,355,341,-14,-3.94,EUGENIO DE CASTRO RS,-28.5286033,-54.1475172,22,4766
RS,FAGUNDES VARELA,6,7,1,16.67,263,307,44,16.73,0,10,10,0.0,60,43,-17,-28.33,176,172,-4,-2.27,505,539,34,6.73,FAGUNDES VARELA RS,-28.8807515,-51.6987798,22,4767
RS,FAXINAL DO SOTURNO,2,2,0,0.0,314,285,-29,-9.24,32,54,22,68.75,434,425,-9,-2.07,607,634,27,4.45,1389,1400,11,0.79,FAXINAL DO SOTURNO RS,-29.5771687,-53.445804,22,4769
RS,FAXINALZINHO,36,33,-3,-8.33,13,17,4,30.77,5,10,5,100.0,51,48,-3,-5.88,181,160,-21,-11.6,286,268,-18,-6.29,FAXINALZINHO RS,-27.4240501,-52.6738684,22,4770
RS,FELIZ,27,26,-1,-3.7,1627,1663,36,2.21,131,134,3,2.29,843,888,45,5.34,1248,1249,1,0.08,3876,3960,84,2.17,FELIZ RS,-29.4523254,-51.3069785,22,4772
RS,FLORES DA CUNHA,312,323,11,3.53,5512,5816,304,5.52,562,573,11,1.96,1785,1769,-16,-0.9,2578,2587,9,0.35,10749,11068,319,2.97,FLORES DA CUNHA RS,-29.030129,-51.1833349,22,4773
RS,FLORIANO PEIXOTO,1,2,1,100.0,11,10,-1,-9.09,0,0,0,0.0,24,21,-3,-12.5,165,165,0,0.0,201,198,-3,-1.49,FLORIANO PEIXOTO RS,-27.8603248,-52.0856015,22,4774
RS,FONTOURA XAVIER,61,61,0,0.0,297,297,0,0.0,13,14,1,7.69,233,217,-16,-6.87,805,918,113,14.04,1409,1507,98,6.96,FONTOURA XAVIER RS,-28.981655,-52.344455,22,4775
RS,FORMIGUEIRO,94,96,2,2.13,142,132,-10,-7.04,26,3,-23,-88.46,174,197,23,13.22,362,332,-30,-8.29,798,760,-38,-4.76,FORMIGUEIRO RS,-29.9982245,-53.5029931,22,4776
RS,FORTALEZA DOS VALOS,187,186,-1,-0.53,13,21,8,61.54,1,0,-1,-100.0,224,220,-4,-1.79,361,340,-21,-5.82,786,767,-19,-2.42,FORTALEZA DOS VALOS RS,-28.7959241,-53.2246622,22,4778
RS,FREDERICO WESTPHALEN,76,82,6,7.89,1756,2119,363,20.67,478,487,9,1.88,2635,2668,33,1.25,3524,3396,-128,-3.63,8469,8752,283,3.34,FREDERICO WESTPHALEN RS,-27.35711,-53.3964117,22,4779
RS,GARRUCHOS,77,91,14,18.18,36,27,-9,-25.0,1,1,0,0.0,55,50,-5,-9.09,195,164,-31,-15.9,364,333,-31,-8.52,GARRUCHOS RS,-28.1892458,-55.6382958,22,4781
RS,GAURAMA,87,102,15,17.24,328,332,4,1.22,32,36,4,12.5,142,148,6,4.23,396,387,-9,-2.27,985,1005,20,2.03,GAURAMA RS,-27.5879319,-52.0927073,22,4782
RS,GENERAL CAMARA,49,39,-10,-20.41,46,41,-5,-10.87,7,10,3,42.86,180,163,-17,-9.44,356,361,5,1.4,638,614,-24,-3.76,GENERAL CAMARA RS,-29.9059611,-51.7626198,22,4783
RS,GENTIL,65,72,7,10.77,53,45,-8,-15.09,0,0,0,0.0,53,49,-4,-7.55,176,173,-3,-1.7,347,339,-8,-2.31,GENTIL RS,-28.4319165,-52.0348748,22,4784
RS,GETULIO VARGAS,67,62,-5,-7.46,1025,1096,71,6.93,129,171,42,32.56,974,950,-24,-2.46,1770,1574,-196,-11.07,3965,3853,-112,-2.82,GETULIO VARGAS RS,-27.8871493,-52.2257967,22,4785
RS,GIRUA,190,196,6,3.16,322,304,-18,-5.59,207,191,-16,-7.73,1033,1039,6,0.58,1359,1371,12,0.88,3111,3101,-10,-0.32,GIRUA RS,-28.0299396,-54.3506855,22,4786
RS,GRAMADO DOS LOUREIROS,11,11,0,0.0,11,19,8,72.73,3,5,2,66.67,25,27,2,8.0,163,119,-44,-26.99,213,181,-32,-15.02,GRAMADO DOS LOUREIROS RS,-27.4439526,-52.9183699,22,4789
RS,GRAMADO XAVIER,3,5,2,66.67,24,24,0,0.0,0,1,1,0.0,40,37,-3,-7.5,209,163,-46,-22.01,276,230,-46,-16.67,GRAMADO XAVIER RS,-29.2702991,-52.5785872,22,4790
RS,GUABIJU,21,19,-2,-9.52,59,43,-16,-27.12,0,2,2,0.0,23,22,-1,-4.35,148,141,-7,-4.73,251,227,-24,-9.56,GUABIJU RS,-28.5417413,-51.6910921,22,4792
RS,GUAPORE,30,38,8,26.67,4783,3862,-921,-19.26,395,453,58,14.68,1263,1241,-22,-1.74,2290,2224,-66,-2.88,8761,7818,-943,-10.76,GUAPORE RS,-28.8471928,-51.8907881,22,4794
RS,GUARANI DAS MISSOES,25,28,3,12.0,164,126,-38,-23.17,2,1,-1,-50.0,278,279,1,0.36,583,555,-28,-4.8,1052,989,-63,-5.99,GUARANI DAS MISSOES RS,-28.1445277,-54.5570355,22,4795
RS,HARMONIA,39,42,3,7.69,785,839,54,6.88,19,10,-9,-47.37,210,208,-2,-0.95,308,290,-18,-5.84,1361,1389,28,2.06,HARMONIA RS,-29.549989,-51.422308,22,4796
RS,HERVEIRAS,0,0,0,0.0,2,3,1,50.0,0,0,0,0.0,33,35,2,6.06,174,152,-22,-12.64,209,190,-19,-9.09,HERVEIRAS RS,-29.4544867,-52.6529235,22,4797
RS,HORIZONTINA,40,39,-1,-2.5,2269,2337,68,3.0,86,79,-7,-8.14,1194,1014,-180,-15.08,2080,1997,-83,-3.99,5669,5466,-203,-3.58,HORIZONTINA RS,-27.627931,-54.3090256,22,4798
RS,HUMAITA,29,64,35,120.69,180,228,48,26.67,11,12,1,9.09,929,952,23,2.48,1892,1702,-190,-10.04,3041,2958,-83,-2.73,HUMAITA RS,-27.5660564,-53.9719817,22,4800
RS,IBARAMA,0,0,0,0.0,64,60,-4,-6.25,0,0,0,0.0,43,32,-11,-25.58,254,216,-38,-14.96,361,308,-53,-14.68,IBARAMA RS,-29.4203176,-53.1313179,22,4801
RS,IBIACA,154,149,-5,-3.25,73,87,14,19.18,14,15,1,7.14,210,217,7,3.33,298,256,-42,-14.09,749,724,-25,-3.34,IBIACA RS,-28.0564247,-51.8566036,22,4802
RS,IBIRAIARAS,59,71,12,20.34,83,86,3,3.61,13,8,-5,-38.46,435,425,-10,-2.3,561,495,-66,-11.76,1151,1085,-66,-5.73,IBIRAIARAS RS,-28.3705672,-51.6366969,22,4803
RS,IBIRAPUITA,21,17,-4,-19.05,2,3,1,50.0,2,2,0,0.0,101,112,11,10.89,283,171,-112,-39.58,409,305,-104,-25.43,IBIRAPUITA RS,-28.6226503,-52.5170577,22,4804
RS,IBIRUBA,199,180,-19,-9.55,1930,2409,479,24.82,253,141,-112,-44.27,1846,1662,-184,-9.97,2042,2024,-18,-0.88,6270,6416,146,2.33,IBIRUBA RS,-28.630161,-53.096124,22,4805
RS,IJUI,246,254,8,3.25,3141,3420,279,8.88,1036,1155,119,11.49,6745,6552,-193,-2.86,11501,11644,143,1.24,22669,23025,356,1.57,IJUI RS,-28.3878734,-53.9201692,22,4807
RS,ILOPOLIS,16,20,4,25.0,231,240,9,3.9,4,2,-2,-50.0,84,79,-5,-5.95,328,314,-14,-4.27,663,655,-8,-1.21,ILOPOLIS RS,-28.92825,-52.125816,22,4808
RS,IMIGRANTE,3,2,-1,-33.33,717,751,34,4.74,1,1,0,0.0,80,85,5,6.25,258,224,-34,-13.18,1059,1063,4,0.38,IMIGRANTE RS,-29.354229,-51.7773242,22,4810
RS,INDEPENDENCIA,0,0,0,0.0,8,8,0,0.0,21,39,18,85.71,162,148,-14,-8.64,1383,1396,13,0.94,1574,1591,17,1.08,INDEPENDENCIA RS,-27.8523717,-54.1909592,22,4811
RS,INHACORA,37,33,-4,-10.81,2,0,-2,-100.0,1,1,0,0.0,19,19,0,0.0,211,178,-33,-15.64,270,231,-39,-14.44,INHACORA RS,-27.8812321,-54.021433,22,4812
RS,IPIRANGA DO SUL,29,26,-3,-10.34,19,21,2,10.53,2,2,0,0.0,38,40,2,5.26,165,127,-38,-23.03,253,216,-37,-14.62,IPIRANGA DO SUL RS,-27.9367583,-52.4251556,22,4814
RS,IRAI,3,6,3,100.0,36,38,2,5.56,3,5,2,66.67,209,201,-8,-3.83,523,550,27,5.16,774,800,26,3.36,IRAI RS,-27.1955392,-53.256791,22,4815
RS,ITACURUBI,135,134,-1,-0.74,0,0,0,0.0,0,7,7,0.0,35,44,9,25.71,248,217,-31,-12.5,418,402,-16,-3.83,ITACURUBI RS,-28.7962478,-55.2360598,22,4817
RS,ITAPUCA,2,1,-1,-50.0,7,11,4,57.14,7,9,2,28.57,8,8,0,0.0,165,155,-10,-6.06,189,184,-5,-2.65,ITAPUCA RS,-28.901861,-52.03804791071079,22,4818
RS,ITAQUI,1552,1648,96,6.19,1235,1308,73,5.91,40,154,114,285.0,1687,1730,43,2.55,2507,2267,-240,-9.57,7021,7107,86,1.22,ITAQUI RS,-29.1222037,-56.5551258,22,4819
RS,ITATI,26,22,-4,-15.38,42,39,-3,-7.14,4,6,2,50.0,17,21,4,23.53,214,254,40,18.69,303,342,39,12.87,ITATI RS,-29.4918877,-50.102071,22,4820
RS,ITATIBA DO SUL,4,7,3,75.0,35,24,-11,-31.43,0,0,0,0.0,43,41,-2,-4.65,214,199,-15,-7.01,296,271,-25,-8.45,ITATIBA DO SUL RS,-27.3859383,-52.4559831,22,4821
RS,IVORA,6,7,1,16.67,13,13,0,0.0,2,0,-2,-100.0,25,26,1,4.0,136,133,-3,-2.21,182,179,-3,-1.65,IVORA RS,-29.5196814,-53.5804505,22,4822
RS,JABOTICABA,8,12,4,50.0,10,11,1,10.0,0,0,0,0.0,66,64,-2,-3.03,316,303,-13,-4.11,400,390,-10,-2.5,JABOTICABA RS,-27.6311203,-53.2794089,22,4824
RS,JACUIZINHO,70,68,-2,-2.86,0,0,0,0.0,0,0,0,0.0,22,21,-1,-4.55,202,170,-32,-15.84,294,259,-35,-11.9,JACUIZINHO RS,-29.0342213,-53.0534957,22,4825
RS,JACUTINGA,505,461,-44,-8.71,3038,3244,206,6.78,75,68,-7,-9.33,1058,1077,19,1.8,2112,1980,-132,-6.25,6788,6830,42,0.62,JACUTINGA RS,-27.729135,-52.53724,22,4826
RS,JAGUARAO,790,744,-46,-5.82,74,76,2,2.7,22,23,1,4.55,1252,1218,-34,-2.72,1930,1718,-212,-10.98,4068,3779,-289,-7.1,JAGUARAO RS,-32.5662724,-53.3765705,22,4827
RS,JAGUARI,54,46,-8,-14.81,159,167,8,5.03,29,19,-10,-34.48,412,433,21,5.1,767,723,-44,-5.74,1421,1388,-33,-2.32,JAGUARI RS,-29.4980313,-54.6919404,22,4828
RS,JAQUIRANA,93,106,13,13.98,251,263,12,4.78,0,0,0,0.0,98,92,-6,-6.12,219,186,-33,-15.07,661,647,-14,-2.12,JAQUIRANA RS,-28.8836757,-50.3580098,22,4829
RS,JARI,154,149,-5,-3.25,0,0,0,0.0,0,0,0,0.0,58,52,-6,-10.34,219,208,-11,-5.02,431,409,-22,-5.1,JARI RS,-29.292234,-54.223711,22,4830
RS,JOIA,262,245,-17,-6.49,12,8,-4,-33.33,0,0,0,0.0,235,229,-6,-2.55,357,379,22,6.16,866,861,-5,-0.58,JOIA RS,-28.6465036,-54.1199165,22,4831
RS,JULIO DE CASTILHOS,559,529,-30,-5.37,90,336,246,273.33,97,75,-22,-22.68,1097,1083,-14,-1.28,1313,1277,-36,-2.74,3156,3300,144,4.56,JULIO DE CASTILHOS RS,-29.2286575,-53.6825217,22,4832
RS,LAGOA BONITA DO SUL,5,5,0,0.0,1,0,-1,-100.0,0,0,0,0.0,29,27,-2,-6.9,159,127,-32,-20.13,194,159,-35,-18.04,LAGOA BONITA DO SUL RS,-29.4903817,-53.0145712,22,4833
RS,LAGOAO,7,6,-1,-14.29,7,7,0,0.0,0,0,0,0.0,69,70,1,1.45,279,275,-4,-1.43,362,358,-4,-1.1,LAGOAO RS,-29.2242092,-52.7738611,22,4834
RS,LAGOA DOS TRES CANTOS,29,33,4,13.79,33,36,3,9.09,0,0,0,0.0,56,59,3,5.36,190,147,-43,-22.63,308,275,-33,-10.71,LAGOA DOS TRES CANTOS RS,-28.5668647,-52.8581637,22,4835
RS,LAGOA VERMELHA,216,209,-7,-3.24,2069,2067,-2,-0.1,160,153,-7,-4.38,1640,1582,-58,-3.54,1869,1801,-68,-3.64,5954,5812,-142,-2.38,LAGOA VERMELHA RS,-28.2087034,-51.527499,22,4836
RS,LAJEADO,18,22,4,22.22,26,27,1,3.85,42,38,-4,-9.52,41,44,3,7.32,310,257,-53,-17.1,437,388,-49,-11.21,LAJEADO RS,-29.4671522,-51.9624046,22,4837
RS,LAJEADO DO BUGRE,2,2,0,0.0,16,19,3,18.75,0,4,4,0.0,27,29,2,7.41,205,197,-8,-3.9,250,251,1,0.4,LAJEADO DO BUGRE RS,-27.6903262,-53.1811907,22,4838
RS,LAVRAS DO SUL,384,345,-39,-10.16,16,16,0,0.0,14,0,-14,-100.0,201,218,17,8.46,609,578,-31,-5.09,1224,1157,-67,-5.47,LAVRAS DO SUL RS,-30.8118057,-53.8982856,22,4839
RS,LIBERATO SALZANO,0,0,0,0.0,95,100,5,5.26,1,1,0,0.0,107,113,6,5.61,295,240,-55,-18.64,498,454,-44,-8.84,LIBERATO SALZANO RS,-27.6003296,-53.0714815,22,4840
RS,LINHA NOVA,15,16,1,6.67,84,81,-3,-3.57,5,7,2,40.0,20,20,0,0.0,111,108,-3,-2.7,235,232,-3,-1.28,LINHA NOVA RS,-29.467709,-51.2001125,22,4842
RS,MACHADINHO,35,38,3,8.57,52,52,0,0.0,44,40,-4,-9.09,189,193,4,2.12,525,447,-78,-14.86,845,770,-75,-8.88,MACHADINHO RS,-27.5658904,-51.6677057,22,4843
RS,MACAMBARA,256,231,-25,-9.77,8,4,-4,-50.0,1,1,0,0.0,35,35,0,0.0,380,348,-32,-8.42,680,619,-61,-8.97,MACAMBARA RS,-29.144485,-56.067444,22,4844
RS,MANOEL VIANA,201,204,3,1.49,38,44,6,15.79,0,3,3,0.0,199,192,-7,-3.52,379,385,6,1.58,817,828,11,1.35,MANOEL VIANA RS,-29.585935,-55.484112,22,4846
RS,MAQUINE,111,125,14,12.61,194,175,-19,-9.79,1,1,0,0.0,136,178,42,30.88,386,396,10,2.59,828,875,47,5.68,MAQUINE RS,-29.6756372,-50.2056317,22,4847
RS,MARATA,13,18,5,38.46,184,141,-43,-23.37,4,7,3,75.0,77,41,-36,-46.75,205,166,-39,-19.02,483,373,-110,-22.77,MARATA RS,-29.549349,-51.5546411,22,4848
RS,MARAU,232,217,-15,-6.47,26,20,-6,-23.08,18,18,0,0.0,215,204,-11,-5.12,1396,1160,-236,-16.91,1887,1619,-268,-14.2,MARAU RS,-28.4493053,-52.2002156,22,4849
RS,MARCELINO RAMOS,15,11,-4,-26.67,106,101,-5,-4.72,33,25,-8,-24.24,99,94,-5,-5.05,443,410,-33,-7.45,696,641,-55,-7.9,MARCELINO RAMOS RS,-27.4622708,-51.9081009,22,4850
RS,MARIANA PIMENTEL,30,33,3,10.0,37,40,3,8.11,0,0,0,0.0,44,48,4,9.09,240,257,17,7.08,351,378,27,7.69,MARIANA PIMENTEL RS,-30.3536856,-51.5832775,22,4851
RS,MARIANO MORO,16,17,1,6.25,28,28,0,0.0,5,5,0,0.0,24,25,1,4.17,243,228,-15,-6.17,316,303,-13,-4.11,MARIANO MORO RS,-27.3541972,-52.1469053,22,4852
RS,MARQUES DE SOUZA,16,17,1,6.25,138,112,-26,-18.84,34,24,-10,-29.41,98,106,8,8.16,315,297,-18,-5.71,601,556,-45,-7.49,MARQUES DE SOUZA RS,-29.3275642,-52.0961801,22,4853
RS,MATA,16,19,3,18.75,72,82,10,13.89,4,0,-4,-100.0,110,101,-9,-8.18,304,299,-5,-1.64,506,501,-5,-0.99,MATA RS,-29.5637643,-54.4590898,22,4854
RS,MATO CASTELHANO,32,29,-3,-9.38,18,17,-1,-5.56,0,0,0,0.0,53,66,13,24.53,264,46,-218,-82.58,367,158,-209,-56.95,MATO CASTELHANO RS,-28.2782729,-52.1948111,22,4855
RS,MATO QUEIMADO,12,7,-5,-41.67,17,14,-3,-17.65,0,0,0,0.0,30,32,2,6.67,156,135,-21,-13.46,215,188,-27,-12.56,MATO QUEIMADO RS,-28.257822,-54.61709,22,4857
RS,MAXIMILIANO DE ALMEIDA,11,10,-1,-9.09,79,76,-3,-3.8,13,5,-8,-61.54,151,145,-6,-3.97,347,301,-46,-13.26,601,537,-64,-10.65,MAXIMILIANO DE ALMEIDA RS,-27.6326512,-51.8046768,22,4858
RS,MINAS DO LEAO,260,243,-17,-6.54,111,84,-27,-24.32,33,48,15,45.45,202,175,-27,-13.37,504,428,-76,-15.08,1110,978,-132,-11.89,MINAS DO LEAO RS,-30.1334499,-52.0455962,22,4859
RS,MIRAGUAI,2,4,2,100.0,837,1268,431,51.49,3,3,0,0.0,106,110,4,3.77,324,295,-29,-8.95,1272,1680,408,32.08,MIRAGUAI RS,-27.4943651,-53.6874223,22,4860
RS,MONTAURI,0,0,0,0.0,97,98,1,1.03,0,0,0,0.0,42,39,-3,-7.14,168,189,21,12.5,307,326,19,6.19,MONTAURI RS,-28.6501657,-52.0757639,22,4861
RS,MONTE ALEGRE DOS CAMPOS,107,107,0,0.0,10,13,3,30.0,0,0,0,0.0,15,16,1,6.67,216,199,-17,-7.87,348,335,-13,-3.74,MONTE ALEGRE DOS CAMPOS RS,-28.6840498,-50.7820322,22,4862
RS,MONTENEGRO,518,624,106,20.46,7376,7734,358,4.85,521,829,308,59.12,3335,3529,194,5.82,7879,7466,-413,-5.24,19629,20182,553,2.82,MONTENEGRO RS,-29.6826112,-51.4687455,22,4864
RS,MORMACO,22,18,-4,-18.18,33,30,-3,-9.09,3,1,-2,-66.67,76,82,6,7.89,199,168,-31,-15.58,333,299,-34,-10.21,MORMACO RS,-28.6935499,-52.6925978,22,4865
RS,MORRINHOS DO SUL,4,4,0,0.0,21,19,-2,-9.52,0,1,1,0.0,122,112,-10,-8.2,153,152,-1,-0.65,300,288,-12,-4.0,MORRINHOS DO SUL RS,-29.3653782,-49.9314425,22,4866
RS,MORRO REDONDO,42,44,2,4.76,756,760,4,0.53,1,1,0,0.0,118,121,3,2.54,286,285,-1,-0.35,1203,1211,8,0.67,MORRO REDONDO RS,-31.5921148,-52.6257669,22,4867
RS,MOSTARDAS,902,893,-9,-1.0,246,337,91,36.99,0,3,3,0.0,359,393,34,9.47,768,712,-56,-7.29,2275,2338,63,2.77,MOSTARDAS RS,-31.10538,-50.916692,22,4869
RS,MUCUM,27,29,2,7.41,945,1013,68,7.2,10,16,6,60.0,179,157,-22,-12.29,953,914,-39,-4.09,2114,2129,15,0.71,MUCUM RS,-29.1666714,-51.8747726,22,4870
RS,MUITOS CAPOES,340,349,9,2.65,93,100,7,7.53,0,0,0,0.0,47,51,4,8.51,248,234,-14,-5.65,728,734,6,0.82,MUITOS CAPOES RS,-28.3162856,-51.1836226,22,4871
RS,MULITERNO,0,0,0,0.0,34,29,-5,-14.71,0,0,0,0.0,34,36,2,5.88,170,143,-27,-15.88,238,208,-30,-12.61,MULITERNO RS,-28.3295989,-51.7682438,22,4872
RS,NAO-ME-TOQUE,223,231,8,3.59,3760,4352,592,15.74,213,237,24,11.27,1588,1553,-35,-2.2,1759,1638,-121,-6.88,7543,8011,468,6.2,NAO-ME-TOQUE RS,-28.4575507,-52.8196547,22,4873
RS,NICOLAU VERGUEIRO,36,34,-2,-5.56,6,8,2,33.33,0,0,0,0.0,80,74,-6,-7.5,128,137,9,7.03,250,253,3,1.2,NICOLAU VERGUEIRO RS,-28.5361987,-52.4631712,22,4874
RS,NONOAI,61,55,-6,-9.84,202,212,10,4.95,5,5,0,0.0,751,744,-7,-0.93,792,684,-108,-13.64,1811,1700,-111,-6.13,NONOAI RS,-27.3660882,-52.7717853,22,4875
RS,NOVA ALVORADA,19,18,-1,-5.26,104,109,5,4.81,23,27,4,17.39,661,652,-9,-1.36,251,224,-27,-10.76,1058,1030,-28,-2.65,NOVA ALVORADA RS,-28.6774191,-52.1663732,22,4876
RS,NOVA ARACA,19,23,4,21.05,1844,1936,92,4.99,16,46,30,187.5,120,123,3,2.5,330,319,-11,-3.33,2329,2447,118,5.07,NOVA ARACA RS,-28.6604116,-51.7424776,22,4877
RS,NOVA BASSANO,131,125,-6,-4.58,1319,1272,-47,-3.56,1426,1326,-100,-7.01,335,366,31,9.25,807,743,-64,-7.93,4018,3832,-186,-4.63,NOVA BASSANO RS,-28.7304074,-51.7034689,22,4878
RS,NOVA BOA VISTA,13,17,4,30.77,292,288,-4,-1.37,0,1,1,0.0,68,73,5,7.35,153,149,-4,-2.61,526,528,2,0.38,NOVA BOA VISTA RS,-27.993207,-52.9798023,22,4879
RS,NOVA BRESCIA,23,22,-1,-4.35,147,165,18,12.24,15,19,4,26.67,86,79,-7,-8.14,269,263,-6,-2.23,540,548,8,1.48,NOVA BRESCIA RS,-29.2158737,-52.0290188,22,4880
RS,NOVA CANDELARIA,37,35,-2,-5.41,531,545,14,2.64,37,34,-3,-8.11,127,128,1,0.79,227,200,-27,-11.89,959,942,-17,-1.77,NOVA CANDELARIA RS,-27.6110759,-54.1065402,22,4881
RS,NOVA ESPERANCA DO SUL,13,16,3,23.08,1213,1157,-56,-4.62,18,16,-2,-11.11,153,144,-9,-5.88,307,245,-62,-20.2,1704,1578,-126,-7.39,NOVA ESPERANCA DO SUL RS,-29.4102156,-54.8287783,22,4882
RS,NOVA PADUA,24,23,-1,-4.17,114,114,0,0.0,7,0,-7,-100.0,39,37,-2,-5.13,169,155,-14,-8.28,353,329,-24,-6.8,NOVA PADUA RS,-29.0283514,-51.3075981,22,4884
RS,NOVA PALMA,14,10,-4,-28.57,170,149,-21,-12.35,34,27,-7,-20.59,325,318,-7,-2.15,452,417,-35,-7.74,995,921,-74,-7.44,NOVA PALMA RS,-29.4711081,-53.4693751,22,4885
RS,NOVA PETROPOLIS,206,189,-17,-8.25,2819,2748,-71,-2.52,326,349,23,7.06,1241,1145,-96,-7.74,2456,2255,-201,-8.18,7048,6686,-362,-5.14,NOVA PETROPOLIS RS,-29.3759836,-51.1123342,22,4886
RS,NOVA PRATA,109,107,-2,-1.83,3700,3660,-40,-1.08,393,413,20,5.09,1431,1488,57,3.98,2816,2664,-152,-5.4,8449,8332,-117,-1.38,NOVA PRATA RS,-28.7849383,-51.6091999,22,4887
RS,NOVA RAMADA,21,23,2,9.52,25,43,18,72.0,5,8,3,60.0,80,87,7,8.75,140,141,1,0.71,271,302,31,11.44,NOVA RAMADA RS,-28.0820908,-53.7063919,22,4888
RS,NOVA ROMA DO SUL,0,0,0,0.0,305,326,21,6.89,3,2,-1,-33.33,84,89,5,5.95,189,182,-7,-3.7,581,599,18,3.1,NOVA ROMA DO SUL RS,-28.9884663,-51.4086514,22,4889
RS,NOVO CABRAIS,33,34,1,3.03,27,31,4,14.81,0,0,0,0.0,83,94,11,13.25,241,242,1,0.41,384,401,17,4.43,NOVO CABRAIS RS,-29.7347439,-52.9499851,22,4891
RS,NOVO MACHADO,10,9,-1,-10.0,2,2,0,0.0,0,1,1,0.0,106,95,-11,-10.38,204,193,-11,-5.39,322,300,-22,-6.83,NOVO MACHADO RS,-27.5780463,-54.5010396,22,4893
RS,NOVO TIRADENTES,0,0,0,0.0,10,8,-2,-20.0,0,0,0,0.0,54,53,-1,-1.85,182,162,-20,-10.99,246,223,-23,-9.35,NOVO TIRADENTES RS,-27.5628338,-53.1827183,22,4894
RS,NOVO XINGU,0,0,0,0.0,14,14,0,0.0,2,2,0,0.0,48,46,-2,-4.17,144,151,7,4.86,208,213,5,2.4,NOVO XINGU RS,-27.7482333,-53.0629707,22,4895
RS,NOVO BARREIRO,1,4,3,300.0,41,19,-22,-53.66,21,26,5,23.81,85,83,-2,-2.35,279,243,-36,-12.9,427,375,-52,-12.18,NOVO BARREIRO RS,-27.9075461,-53.1095554,22,4896
RS,PAIM FILHO,32,41,9,28.12,40,38,-2,-5.0,1,0,-1,-100.0,178,188,10,5.62,335,317,-18,-5.37,586,584,-2,-0.34,PAIM FILHO RS,-27.7099371,-51.7586234,22,4898
RS,PALMARES DO SUL,381,390,9,2.36,212,248,36,16.98,9,9,0,0.0,530,480,-50,-9.43,819,859,40,4.88,1951,1986,35,1.79,PALMARES DO SUL RS,-30.2580247,-50.5097954,22,4899
RS,PALMEIRA DAS MISSOES,729,730,1,0.14,362,399,37,10.22,179,163,-16,-8.94,1995,1936,-59,-2.96,2564,2211,-353,-13.77,5829,5439,-390,-6.69,PALMEIRA DAS MISSOES RS,-27.9010519,-53.3135927,22,4900
RS,PALMITINHO,5,4,-1,-20.0,229,197,-32,-13.97,257,299,42,16.34,307,297,-10,-3.26,553,555,2,0.36,1351,1352,1,0.07,PALMITINHO RS,-27.3553374,-53.5575968,22,4901
RS,PANAMBI,169,169,0,0.0,6486,6519,33,0.51,516,425,-91,-17.64,2606,2618,12,0.46,3379,3273,-106,-3.14,13156,13004,-152,-1.16,PANAMBI RS,-28.2898542,-53.501822,22,4902
RS,PANTANO GRANDE,248,210,-38,-15.32,812,820,8,0.99,33,23,-10,-30.3,512,466,-46,-8.98,1027,629,-398,-38.75,2632,2148,-484,-18.39,PANTANO GRANDE RS,-30.1907942,-52.3721771,22,4903
RS,PARAI,14,11,-3,-21.43,1217,1325,108,8.87,139,143,4,2.88,502,494,-8,-1.59,631,643,12,1.9,2503,2616,113,4.51,PARAI RS,-28.5966772,-51.7851426,22,4904
RS,PARAISO DO SUL,12,8,-4,-33.33,90,88,-2,-2.22,0,0,0,0.0,143,137,-6,-4.2,345,335,-10,-2.9,590,568,-22,-3.73,PARAISO DO SUL RS,-29.7311548,-53.1777338,22,4905
RS,PARECI NOVO,136,120,-16,-11.76,147,138,-9,-6.12,7,6,-1,-14.29,188,193,5,2.66,381,380,-1,-0.26,859,837,-22,-2.56,PARECI NOVO RS,-29.6386722,-51.3961969,22,4906
RS,PASSA SETE,0,1,1,0.0,18,14,-4,-22.22,0,0,0,0.0,32,31,-1,-3.12,179,144,-35,-19.55,229,190,-39,-17.03,PASSA SETE RS,-29.4498383,-52.9652172,22,4908
RS,PASSO DO SOBRADO,55,58,3,5.45,214,217,3,1.4,3,6,3,100.0,133,219,86,64.66,412,336,-76,-18.45,817,836,19,2.33,PASSO DO SOBRADO RS,-29.7477243,-52.2734293,22,4909
RS,PASSO FUNDO,899,845,-54,-6.01,8765,9497,732,8.35,2836,2871,35,1.23,18217,17980,-237,-1.3,30689,29267,-1422,-4.63,61406,60460,-946,-1.54,PASSO FUNDO RS,-28.2550598,-52.3966606,22,4910
RS,PAULO BENTO,8,11,3,37.5,298,307,9,3.02,0,0,0,0.0,39,38,-1,-2.56,179,179,0,0.0,524,535,11,2.1,PAULO BENTO RS,-27.7034385,-52.4220174,22,4911
RS,PEDRAS ALTAS,124,128,4,3.23,11,11,0,0.0,0,0,0,0.0,9,16,7,77.78,249,257,8,3.21,393,412,19,4.83,PEDRAS ALTAS RS,-31.7324042,-53.585424,22,4913
RS,PEJUCARA,171,167,-4,-2.34,31,27,-4,-12.9,0,0,0,0.0,176,170,-6,-3.41,350,289,-61,-17.43,728,653,-75,-10.3,PEJUCARA RS,-28.4217646,-53.6554254,22,4915
RS,PELOTAS,904,770,-134,-14.82,7727,7778,51,0.66,3199,3223,24,0.75,18812,18110,-702,-3.73,41402,39432,-1970,-4.76,72044,69313,-2731,-3.79,PELOTAS RS,-31.7699736,-52.3410161,22,4916
RS,PINHAL,44,47,3,6.82,382,374,-8,-2.09,91,93,2,2.2,62,61,-1,-1.61,221,234,13,5.88,800,809,9,1.12,PINHAL RS,-27.5114158,-53.2163814,22,4918
RS,PINHAL DA SERRA,38,36,-2,-5.26,36,35,-1,-2.78,4,1,-3,-75.0,35,34,-1,-2.86,233,198,-35,-15.02,346,304,-42,-12.14,PINHAL DA SERRA RS,-27.8743529,-51.1706149,22,4919
RS,PINHAL GRANDE,52,42,-10,-19.23,39,40,1,2.56,4,5,1,25.0,74,68,-6,-8.11,309,289,-20,-6.47,478,444,-34,-7.11,PINHAL GRANDE RS,-29.3472446,-53.3343023,22,4920
RS,PINHEIRINHO DO VALE,40,32,-8,-20.0,68,59,-9,-13.24,13,13,0,0.0,89,94,5,5.62,268,258,-10,-3.73,478,456,-22,-4.6,PINHEIRINHO DO VALE RS,-27.2111177,-53.6144253,22,4921
RS,PINHEIRO MACHADO,181,191,10,5.52,99,101,2,2.02,0,2,2,0.0,352,329,-23,-6.53,640,603,-37,-5.78,1272,1226,-46,-3.62,PINHEIRO MACHADO RS,-31.5792646,-53.3822191,22,4922
RS,PIRATINI,701,705,4,0.57,382,457,75,19.63,3,6,3,100.0,465,443,-22,-4.73,1122,1086,-36,-3.21,2673,2697,24,0.9,PIRATINI RS,-31.448451,-53.1039931,22,4925
RS,PLANALTO,122,133,11,9.02,24,19,-5,-20.83,10,15,5,50.0,396,376,-20,-5.05,1107,967,-140,-12.65,1659,1510,-149,-8.98,PLANALTO RS,-27.3297033,-53.0575473,22,4926
RS,POCO DAS ANTAS,14,12,-2,-14.29,722,783,61,8.45,7,7,0,0.0,74,78,4,5.41,176,161,-15,-8.52,993,1041,48,4.83,POCO DAS ANTAS RS,-29.4512516,-51.6690936,22,4927
RS,PONTAO,100,109,9,9.0,17,20,3,17.65,1,1,0,0.0,100,93,-7,-7.0,322,272,-50,-15.53,540,495,-45,-8.33,PONTAO RS,-28.0599735,-52.6779378,22,4928
RS,PONTE PRETA,6,6,0,0.0,44,38,-6,-13.64,0,1,1,0.0,33,34,1,3.03,137,133,-4,-2.92,220,212,-8,-3.64,PONTE PRETA RS,-27.6577598,-52.4895431,22,4929
RS,PORTO ALEGRE,1356,1182,-174,-12.83,31330,29276,-2054,-6.56,26495,26447,-48,-0.18,103814,97177,-6637,-6.39,516511,497601,-18910,-3.66,679506,651683,-27823,-4.09,PORTO ALEGRE RS,-30.0324999,-51.2303767,22,4931
RS,PORTO LUCENA,12,12,0,0.0,34,31,-3,-8.82,1,1,0,0.0,132,133,1,0.76,289,294,5,1.73,468,471,3,0.64,PORTO LUCENA RS,-27.8532622,-55.0198385,22,4932
RS,PORTO MAUA,4,3,-1,-25.0,0,0,0,0.0,0,3,3,0.0,63,60,-3,-4.76,166,160,-6,-3.61,233,226,-7,-3.0,PORTO MAUA RS,-27.5740153,-54.6690808,22,4933
RS,PORTO VERA CRUZ,10,7,-3,-30.0,0,0,0,0.0,1,1,0,0.0,18,18,0,0.0,137,110,-27,-19.71,166,136,-30,-18.07,PORTO VERA CRUZ RS,-27.7354566,-54.9009622,22,4934
RS,PORTO XAVIER,34,31,-3,-8.82,58,51,-7,-12.07,25,26,1,4.0,377,389,12,3.18,843,827,-16,-1.9,1337,1324,-13,-0.97,PORTO XAVIER RS,-27.9061459,-55.1395757,22,4935
RS,POUSO NOVO,31,38,7,22.58,30,29,-1,-3.33,0,0,0,0.0,38,34,-4,-10.53,209,161,-48,-22.97,308,262,-46,-14.94,POUSO NOVO RS,-29.1695872,-52.2085122,22,4936
RS,PROGRESSO,3,6,3,100.0,157,118,-39,-24.84,7,9,2,28.57,93,87,-6,-6.45,456,422,-34,-7.46,716,642,-74,-10.34,PROGRESSO RS,-29.2419958,-52.3108869,22,4938
RS,PROTASIO ALVES,50,57,7,14.0,78,62,-16,-20.51,2,1,-1,-50.0,37,41,4,10.81,137,126,-11,-8.03,304,287,-17,-5.59,PROTASIO ALVES RS,-28.7586297,-51.4741516,22,4939
RS,PUTINGA,16,19,3,18.75,264,289,25,9.47,0,0,0,0.0,77,51,-26,-33.77,245,241,-4,-1.63,602,600,-2,-0.33,PUTINGA RS,-29.0017469,-52.1566367,22,4940
RS,QUARAI,579,574,-5,-0.86,100,89,-11,-11.0,11,16,5,45.45,1384,1352,-32,-2.31,1207,1079,-128,-10.6,3281,3110,-171,-5.21,QUARAI RS,-30.3818093,-56.4526576,22,4941
RS,QUATRO IRMAOS,75,75,0,0.0,12,12,0,0.0,0,0,0,0.0,39,42,3,7.69,191,161,-30,-15.71,317,290,-27,-8.52,QUATRO IRMAOS RS,-27.8229301,-52.4427548,22,4942
RS,QUEVEDOS,83,80,-3,-3.61,6,8,2,33.33,0,0,0,0.0,38,42,4,10.53,25,196,171,684.0,152,326,174,114.47,QUEVEDOS RS,-29.3529828,-54.0687208,22,4943
RS,QUINZE DE NOVEMBRO,53,55,2,3.77,79,94,15,18.99,8,9,1,12.5,204,222,18,8.82,280,272,-8,-2.86,624,652,28,4.49,QUINZE DE NOVEMBRO RS,-28.742279,-53.0951692,22,4944
RS,REDENTORA,41,39,-2,-4.88,9,8,-1,-11.11,0,0,0,0.0,158,153,-5,-3.16,418,417,-1,-0.24,626,617,-9,-1.44,REDENTORA RS,-27.6616073,-53.6421338,22,4945
RS,RELVADO,9,10,1,11.11,63,60,-3,-4.76,2,0,-2,-100.0,29,31,2,6.9,162,127,-35,-21.6,265,228,-37,-13.96,RELVADO RS,-29.1121081,-52.0713979,22,4946
RS,RIO DOS INDIOS,7,6,-1,-14.29,13,22,9,69.23,0,0,0,0.0,39,39,0,0.0,211,176,-35,-16.59,270,243,-27,-10.0,RIO DOS INDIOS RS,-27.3010535,-52.8406196,22,4948
RS,RIO GRANDE,924,865,-59,-6.39,6282,6824,542,8.63,2215,1883,-332,-14.99,8876,8499,-377,-4.25,25479,24487,-992,-3.89,43776,42558,-1218,-2.78,RIO GRANDE RS,-32.0334252,-52.0991297,22,4949
RS,RIO PARDO,314,337,23,7.32,1656,1865,209,12.62,30,54,24,80.0,1258,1355,97,7.71,1860,1813,-47,-2.53,5118,5424,306,5.98,RIO PARDO RS,-29.9820554,-52.3702447,22,4950
RS,RIOZINHO,24,14,-10,-41.67,934,863,-71,-7.6,4,2,-2,-50.0,95,90,-5,-5.26,319,214,-105,-32.92,1376,1183,-193,-14.03,RIOZINHO RS,-29.6404582,-50.4596262,22,4951
RS,ROCA SALES,54,64,10,18.52,2492,1447,-1045,-41.93,24,19,-5,-20.83,213,224,11,5.16,730,745,15,2.05,3513,2499,-1014,-28.86,ROCA SALES RS,-29.2872555,-51.8724318,22,4952
RS,RODEIO BONITO,203,220,17,8.37,215,228,13,6.05,34,32,-2,-5.88,330,350,20,6.06,552,556,4,0.72,1334,1386,52,3.9,RODEIO BONITO RS,-27.4725021,-53.1705906,22,4953
RS,ROLADOR,24,28,4,16.67,0,0,0,0.0,0,0,0,0.0,31,26,-5,-16.13,175,146,-29,-16.57,230,200,-30,-13.04,ROLADOR RS,-28.2558989,-54.8179212,22,4954
RS,ROLANTE,59,62,3,5.08,4534,3900,-634,-13.98,12,11,-1,-8.33,941,910,-31,-3.29,1571,1502,-69,-4.39,7117,6385,-732,-10.29,ROLANTE RS,-29.6527945,-50.5769391,22,4955
RS,RONDA ALTA,65,73,8,12.31,173,174,1,0.58,3,4,1,33.33,493,486,-7,-1.42,668,623,-45,-6.74,1402,1360,-42,-3.0,RONDA ALTA RS,-27.782064,-52.8078036,22,4956
RS,RONDINHA,37,39,2,5.41,42,36,-6,-14.29,9,8,-1,-11.11,165,177,12,7.27,322,270,-52,-16.15,575,530,-45,-7.83,RONDINHA RS,-27.8295534,-52.9084074,22,4957
RS,ROQUE GONZALES,48,51,3,6.25,53,65,12,22.64,5,6,1,20.0,226,226,0,0.0,451,403,-48,-10.64,783,751,-32,-4.09,ROQUE GONZALES RS,-28.1324578,-55.0263416,22,4958
RS,ROSARIO DO SUL,1170,1114,-56,-4.79,445,404,-41,-9.21,41,62,21,51.22,1820,1834,14,0.77,2204,2027,-177,-8.03,5680,5441,-239,-4.21,ROSARIO DO SUL RS,-30.2527151,-54.9179382,22,4959
RS,SAGRADA FAMILIA,1,1,0,0.0,62,65,3,4.84,0,0,0,0.0,77,76,-1,-1.3,179,182,3,1.68,319,324,5,1.57,SAGRADA FAMILIA RS,-27.7085454,-53.1364113,22,4960
RS,SALDANHA MARINHO,38,49,11,28.95,21,13,-8,-38.1,0,0,0,0.0,141,156,15,10.64,242,222,-20,-8.26,442,440,-2,-0.45,SALDANHA MARINHO RS,-28.3966396,-53.0952929,22,4961
RS,SALTO DO JACUI,140,148,8,5.71,194,197,3,1.55,16,19,3,18.75,535,510,-25,-4.67,693,667,-26,-3.75,1578,1541,-37,-2.34,SALTO DO JACUI RS,-29.0899771,-53.2111244,22,4962
RS,SALVADOR DO SUL,485,505,20,4.12,754,676,-78,-10.34,253,338,85,33.6,462,459,-3,-0.65,591,584,-7,-1.18,2545,2562,17,0.67,SALVADOR DO SUL RS,-29.4395698,-51.5103295,22,4964
RS,SANANDUVA,113,112,-1,-0.88,1099,1193,94,8.55,66,61,-5,-7.58,1184,1175,-9,-0.76,1260,1201,-59,-4.68,3722,3742,20,0.54,SANANDUVA RS,-27.9499376,-51.8074435,22,4965
RS,SANTA BARBARA DO SUL,365,337,-28,-7.67,81,77,-4,-4.94,73,123,50,68.49,632,633,1,0.16,672,664,-8,-1.19,1823,1834,11,0.6,SANTA BARBARA DO SUL RS,-28.3654722,-53.2510995,22,4966
RS,SANTA CECILIA DO SUL,30,28,-2,-6.67,7,4,-3,-42.86,3,0,-3,-100.0,48,51,3,6.25,133,93,-40,-30.08,221,176,-45,-20.36,SANTA CECILIA DO SUL RS,-28.1625105,-51.9297926,22,4967
RS,SANTA CRUZ DO SUL,543,408,-135,-24.86,10394,10844,450,4.33,2409,2173,-236,-9.8,9609,9128,-481,-5.01,19299,18313,-986,-5.11,42254,40866,-1388,-3.28,SANTA CRUZ DO SUL RS,-29.7141869,-52.4285914,22,4969
RS,SANTA MARIA,20,20,0,0.0,7,3,-4,-57.14,1,2,1,100.0,66,71,5,7.58,347,227,-120,-34.58,441,323,-118,-26.76,SANTA MARIA RS,-29.6860512,-53.8069214,22,4970
RS,SANTA MARIA DO HERVAL,29,30,1,3.45,1260,1130,-130,-10.32,64,95,31,48.44,187,199,12,6.42,434,392,-42,-9.68,1974,1846,-128,-6.48,SANTA MARIA DO HERVAL RS,-29.4977269,-50.9919419,22,4971
RS,SANTANA DA BOA VISTA,70,47,-23,-32.86,13,12,-1,-7.69,0,3,3,0.0,148,167,19,12.84,466,430,-36,-7.73,697,659,-38,-5.45,SANTANA DA BOA VISTA RS,-30.8736867,-53.1148304,22,4973
RS,SANTA ROSA,541,537,-4,-0.74,5784,6227,443,7.66,1468,1654,186,12.67,5790,5700,-90,-1.55,8807,8895,88,1.0,22390,23013,623,2.78,SANTA ROSA RS,-27.8643546,-54.4779287,22,4975
RS,SANTA TEREZA,30,26,-4,-13.33,34,44,10,29.41,0,0,0,0.0,18,19,1,5.56,113,97,-16,-14.16,195,186,-9,-4.62,SANTA TEREZA RS,-29.1697808,-51.7363155,22,4976
RS,SANTA VITORIA DO PALMAR,2453,2455,2,0.08,148,191,43,29.05,73,40,-33,-45.21,985,1024,39,3.96,2402,2305,-97,-4.04,6061,6015,-46,-0.76,SANTA VITORIA DO PALMAR RS,-33.5195569,-53.3692659,22,4977
RS,SANTIAGO,484,457,-27,-5.58,679,702,23,3.39,330,315,-15,-4.55,2897,3050,153,5.28,3804,3617,-187,-4.92,8194,8141,-53,-0.65,SANTIAGO RS,-29.189675,-54.866624,22,4978
RS,SANTO ANGELO,309,277,-32,-10.36,4085,4560,475,11.63,1071,940,-131,-12.23,5335,5126,-209,-3.92,7908,7540,-368,-4.65,18708,18443,-265,-1.42,SANTO ANGELO RS,-28.3000481,-54.2669971,22,4979
RS,SANTO ANTONIO DO PALMA,90,95,5,5.56,71,78,7,9.86,0,2,2,0.0,36,34,-2,-5.56,133,94,-39,-29.32,330,303,-27,-8.18,SANTO ANTONIO DO PALMA RS,-28.4946558,-52.0254769,22,4980
RS,SANTO ANTONIO DA PATRULHA,175,153,-22,-12.57,4002,3892,-110,-2.75,160,202,42,26.25,1888,1717,-171,-9.06,3374,3777,403,11.94,9599,9741,142,1.48,SANTO ANTONIO DA PATRULHA RS,-29.826768,-50.517489,22,4981
RS,SANTO ANTONIO DAS MISSOES,263,265,2,0.76,31,26,-5,-16.13,3,1,-2,-66.67,396,400,4,1.01,618,591,-27,-4.37,1311,1283,-28,-2.14,SANTO ANTONIO DAS MISSOES RS,-28.5117897,-55.2290047,22,4982
RS,SANTO ANTONIO DO PLANALTO,40,41,1,2.5,77,105,28,36.36,1,1,0,0.0,72,82,10,13.89,162,185,23,14.2,352,414,62,17.61,SANTO ANTONIO DO PLANALTO RS,-28.3991804,-52.6910319,22,4983
RS,SANTO AUGUSTO,345,356,11,3.19,332,343,11,3.31,36,15,-21,-58.33,916,893,-23,-2.51,1095,1095,0,0.0,2724,2702,-22,-0.81,SANTO AUGUSTO RS,-27.852577,-53.777605,22,4984
RS,SANTO CRISTO,216,225,9,4.17,817,774,-43,-5.26,41,40,-1,-2.44,887,927,40,4.51,1490,1448,-42,-2.82,3451,3414,-37,-1.07,SANTO CRISTO RS,-27.826259,-54.661963,22,4985
RS,SANTO EXPEDITO DO SUL,1,2,1,100.0,14,37,23,164.29,2,8,6,300.0,49,46,-3,-6.12,199,173,-26,-13.07,265,266,1,0.38,SANTO EXPEDITO DO SUL RS,-27.9098613,-51.6433072,22,4986
RS,SAO BORJA,1383,1364,-19,-1.37,1136,1140,4,0.35,940,831,-109,-11.6,2898,2981,83,2.86,4779,4378,-401,-8.39,11136,10694,-442,-3.97,SAO BORJA RS,-28.6592237,-56.0044295,22,4987
RS,SAO DOMINGOS DO SUL,2,0,-2,-100.0,265,266,1,0.38,24,6,-18,-75.0,74,58,-16,-21.62,202,193,-9,-4.46,567,523,-44,-7.76,SAO DOMINGOS DO SUL RS,-28.5297239,-51.8905306,22,4988
RS,SAO FRANCISCO DE ASSIS,241,228,-13,-5.39,34,30,-4,-11.76,11,19,8,72.73,584,562,-22,-3.77,1046,1024,-22,-2.1,1916,1863,-53,-2.77,SAO FRANCISCO DE ASSIS RS,-29.559214,-55.1209843,22,4989
RS,SAO FRANCISCO DE PAULA,216,226,10,4.63,105,129,24,22.86,4,7,3,75.0,171,199,28,16.37,412,302,-110,-26.7,908,863,-45,-4.96,SAO FRANCISCO DE PAULA RS,-29.448454,-50.5833027,22,4990
RS,SAO GABRIEL,7,4,-3,-42.86,2,1,-1,-50.0,1,1,0,0.0,111,126,15,13.51,839,757,-82,-9.77,960,889,-71,-7.4,SAO GABRIEL RS,-30.334214,-54.3227149,22,4991
RS,SAO JOAO DA URTIGA,7,7,0,0.0,50,50,0,0.0,12,9,-3,-25.0,250,256,6,2.4,265,229,-36,-13.58,584,551,-33,-5.65,SAO JOAO DA URTIGA RS,-27.8162722,-51.8297741,22,4993
RS,SAO JOAO DO POLESINE,14,16,2,14.29,164,142,-22,-13.41,7,49,42,600.0,74,66,-8,-10.81,319,350,31,9.72,578,623,45,7.79,SAO JOAO DO POLESINE RS,-29.6156424,-53.4455412,22,4994
RS,SAO JORGE,33,37,4,12.12,211,200,-11,-5.21,11,4,-7,-63.64,63,58,-5,-7.94,144,141,-3,-2.08,462,440,-22,-4.76,SAO JORGE RS,-28.5006499,-51.7050503,22,4995
RS,SAO JOSE DAS MISSOES,0,0,0,0.0,4,7,3,75.0,2,3,1,50.0,43,40,-3,-6.98,225,203,-22,-9.78,274,253,-21,-7.66,SAO JOSE DAS MISSOES RS,-27.7783652,-53.1185847,22,4996
RS,SAO JOSE DO HERVAL,35,40,5,14.29,44,52,8,18.18,0,0,0,0.0,47,51,4,8.51,213,178,-35,-16.43,339,321,-18,-5.31,SAO JOSE DO HERVAL RS,-29.0448214,-52.2948783,22,4997
RS,SAO JOSE DO INHACORA,2,5,3,150.0,358,451,93,25.98,3,4,1,33.33,60,55,-5,-8.33,231,218,-13,-5.63,654,733,79,12.08,SAO JOSE DO INHACORA RS,-27.725055,-54.127462,22,4999
RS,SAO JOSE DO NORTE,525,597,72,13.71,1596,2097,501,31.39,35,29,-6,-17.14,701,712,11,1.57,1295,1480,185,14.29,4152,4915,763,18.38,SAO JOSE DO NORTE RS,-32.0145182,-52.0406082,22,5000
RS,SAO JOSE DO OURO,94,92,-2,-2.13,169,168,-1,-0.59,26,37,11,42.31,420,398,-22,-5.24,637,679,42,6.59,1346,1374,28,2.08,SAO JOSE DO OURO RS,-27.7736185,-51.5947672,22,5001
RS,SAO JOSE DO SUL,20,15,-5,-25.0,94,108,14,14.89,4,4,0,0.0,61,61,0,0.0,192,180,-12,-6.25,371,368,-3,-0.81,SAO JOSE DO SUL RS,-29.537476,-51.4828905,22,5002
RS,SAO JOSE DOS AUSENTES,362,384,22,6.08,41,119,78,190.24,3,1,-2,-66.67,56,62,6,10.71,285,281,-4,-1.4,747,847,100,13.39,SAO JOSE DOS AUSENTES RS,-28.747731,-50.0645582,22,5003
RS,SAO LOURENCO DO SUL,388,415,27,6.96,536,525,-11,-2.05,39,42,3,7.69,1934,1917,-17,-0.88,2684,2477,-207,-7.71,5581,5376,-205,-3.67,SAO LOURENCO DO SUL RS,-31.3669286,-51.9814839,22,5005
RS,SAO LUIZ GONZAGA,596,576,-20,-3.36,1108,1086,-22,-1.99,89,145,56,62.92,2130,2135,5,0.23,2564,2424,-140,-5.46,6487,6366,-121,-1.87,SAO LUIZ GONZAGA RS,-28.4074546,-54.9609081,22,5006
RS,SAO MARCOS,64,48,-16,-25.0,3960,4057,97,2.45,65,65,0,0.0,976,969,-7,-0.72,1980,1956,-24,-1.21,7045,7095,50,0.71,SAO MARCOS RS,-29.515627,-56.841496,22,5007
RS,SAO MARTINHO,15,16,1,6.67,277,267,-10,-3.61,5,6,1,20.0,141,155,14,9.93,297,307,10,3.37,735,751,16,2.18,SAO MARTINHO RS,-27.7075144,-53.9663489,22,5008
RS,SAO MARTINHO DA SERRA,75,65,-10,-13.33,6,6,0,0.0,2,1,-1,-50.0,28,34,6,21.43,187,182,-5,-2.67,298,288,-10,-3.36,SAO MARTINHO DA SERRA RS,-29.5380766,-53.8544925,22,5009
RS,SAO MIGUEL DAS MISSOES,374,375,1,0.27,13,16,3,23.08,4,15,11,275.0,257,278,21,8.17,612,533,-79,-12.91,1260,1217,-43,-3.41,SAO MIGUEL DAS MISSOES RS,-28.5451471,-54.5469209,22,5010
RS,SAO NICOLAU,87,85,-2,-2.3,9,9,0,0.0,0,0,0,0.0,111,118,7,6.31,300,275,-25,-8.33,507,487,-20,-3.94,SAO NICOLAU RS,-28.1857386,-55.2615035,22,5011
RS,SAO PAULO DAS MISSOES,39,37,-2,-5.13,48,53,5,10.42,49,41,-8,-16.33,165,163,-2,-1.21,406,377,-29,-7.14,707,671,-36,-5.09,SAO PAULO DAS MISSOES RS,-28.0225895,-54.936466,22,5012
RS,SAO PEDRO DAS MISSOES,4,5,1,25.0,0,8,8,0.0,0,0,0,0.0,30,34,4,13.33,215,205,-10,-4.65,249,252,3,1.2,SAO PEDRO DAS MISSOES RS,-27.7729041,-53.2478857,22,5014
RS,SAO PEDRO DO BUTIA,205,209,4,1.95,114,137,23,20.18,1,28,27,2700.0,112,115,3,2.68,235,230,-5,-2.13,667,719,52,7.8,SAO PEDRO DO BUTIA RS,-28.12425,-54.892603,22,5015
RS,SAO PEDRO DO SUL,117,115,-2,-1.71,218,208,-10,-4.59,84,89,5,5.95,719,683,-36,-5.01,905,923,18,1.99,2043,2018,-25,-1.22,SAO PEDRO DO SUL RS,-29.6152729,-54.1790311,22,5016
RS,SAO SEPE,380,415,35,9.21,482,442,-40,-8.3,82,75,-7,-8.54,1037,1050,13,1.25,1568,1505,-63,-4.02,3549,3487,-62,-1.75,SAO SEPE RS,-30.167219,-53.5690914,22,5018
RS,SAO VALENTIM,6,5,-1,-16.67,48,48,0,0.0,7,7,0,0.0,114,107,-7,-6.14,283,262,-21,-7.42,458,429,-29,-6.33,SAO VALENTIM RS,-27.5588628,-52.5241756,22,5019
RS,SAO VALENTIM DO SUL,21,20,-1,-4.76,232,270,38,16.38,3,5,2,66.67,20,14,-6,-30.0,144,144,0,0.0,420,453,33,7.86,SAO VALENTIM DO SUL RS,-29.0503352,-51.7675031,22,5020
RS,SAO VALERIO DO SUL,2,5,3,150.0,7,9,2,28.57,0,0,0,0.0,19,27,8,42.11,207,176,-31,-14.98,235,217,-18,-7.66,SAO VALERIO DO SUL RS,-27.7881823,-53.9348211,22,5021
RS,SAO VENDELINO,6,7,1,16.67,254,275,21,8.27,110,116,6,5.45,69,65,-4,-5.8,187,181,-6,-3.21,626,644,18,2.88,SAO VENDELINO RS,-29.3684935,-51.3790426,22,5022
RS,SAO VICENTE DO SUL,331,318,-13,-3.93,38,39,1,2.63,11,9,-2,-18.18,295,321,26,8.81,465,409,-56,-12.04,1140,1096,-44,-3.86,SAO VICENTE DO SUL RS,-29.688161,-54.682643,22,5023
RS,SARANDI,30,30,0,0.0,3359,4093,734,21.85,669,833,164,24.51,3031,3126,95,3.13,5820,5850,30,0.52,12909,13932,1023,7.92,SARANDI RS,-27.942,-52.923085,22,5026
RS,SEBERI,149,134,-15,-10.07,1076,1422,346,32.16,42,47,5,11.9,642,614,-28,-4.36,891,885,-6,-0.67,2800,3102,302,10.79,SEBERI RS,-27.4828134,-53.4013251,22,5027
RS,SEDE NOVA,16,16,0,0.0,21,17,-4,-19.05,23,7,-16,-69.57,98,85,-13,-13.27,218,195,-23,-10.55,376,320,-56,-14.89,SEDE NOVA RS,-27.636739,-53.94929,22,5028
RS,SEGREDO,2,2,0,0.0,15,24,9,60.0,5,4,-1,-20.0,88,86,-2,-2.27,299,274,-25,-8.36,409,390,-19,-4.65,SEGREDO RS,-29.3431272,-52.9793788,22,5029
RS,SELBACH,90,81,-9,-10.0,279,297,18,6.45,0,0,0,0.0,293,288,-5,-1.71,421,371,-50,-11.88,1083,1037,-46,-4.25,SELBACH RS,-28.6299869,-52.9530657,22,5030
RS,SENADOR SALGADO FILHO,32,33,1,3.12,1,5,4,400.0,0,0,0,0.0,95,91,-4,-4.21,179,176,-3,-1.68,307,305,-2,-0.65,SENADOR SALGADO FILHO RS,-28.0270233,-54.5435136,22,5031
RS,SENTINELA DO SUL,50,44,-6,-12.0,173,174,1,0.58,2,2,0,0.0,69,76,7,10.14,233,239,6,2.58,527,535,8,1.52,SENTINELA DO SUL RS,-30.6118857,-51.5817117,22,5032
RS,SERAFINA CORREA,209,326,117,55.98,2808,3124,316,11.25,150,141,-9,-6.0,946,971,25,2.64,1698,1620,-78,-4.59,5811,6182,371,6.38,SERAFINA CORREA RS,-28.7120266,-51.9343269,22,5033
RS,SERIO,4,6,2,50.0,18,13,-5,-27.78,12,3,-9,-75.0,39,40,1,2.56,152,122,-30,-19.74,225,184,-41,-18.22,SERIO RS,-29.3844988,-52.2685744,22,5034
RS,SERTAO,125,99,-26,-20.8,61,79,18,29.51,9,9,0,0.0,158,151,-7,-4.43,493,466,-27,-5.48,846,804,-42,-4.96,SERTAO RS,-27.9853815,-52.257587,22,5035
RS,SERTAO SANTANA,16,14,-2,-12.5,203,220,17,8.37,1,1,0,0.0,178,177,-1,-0.56,346,323,-23,-6.65,744,735,-9,-1.21,SERTAO SANTANA RS,-30.4617134,-51.6041992,22,5036
RS,SETE DE SETEMBRO,3,2,-1,-33.33,3,5,2,66.67,0,0,0,0.0,18,16,-2,-11.11,158,142,-16,-10.13,182,165,-17,-9.34,SETE DE SETEMBRO RS,-28.1297132,-54.462746,22,5037
RS,SEVERIANO DE ALMEIDA,14,17,3,21.43,57,52,-5,-8.77,4,2,-2,-50.0,113,115,2,1.77,314,315,1,0.32,502,501,-1,-0.2,SEVERIANO DE ALMEIDA RS,-27.4332178,-52.1155068,22,5038
RS,SILVEIRA MARTINS,22,29,7,31.82,43,44,1,2.33,0,0,0,0.0,45,52,7,15.56,201,199,-2,-1.0,311,324,13,4.18,SILVEIRA MARTINS RS,-29.643191,-53.5867044,22,5039
RS,SINIMBU,4,5,1,25.0,187,169,-18,-9.63,12,7,-5,-41.67,217,193,-24,-11.06,434,429,-5,-1.15,854,803,-51,-5.97,SINIMBU RS,-29.5346879,-52.5199906,22,5040
RS,SOBRADINHO,100,68,-32,-32.0,171,197,26,15.2,64,6,-58,-90.62,342,358,16,4.68,1462,931,-531,-36.32,2139,1560,-579,-27.07,SOBRADINHO RS,-29.4131826,-53.0256794,22,5041
RS,SOLEDADE,13,14,1,7.69,161,147,-14,-8.7,6,12,6,100.0,220,204,-16,-7.27,1008,1038,30,2.98,1408,1415,7,0.5,SOLEDADE RS,-28.8272467,-52.5109157,22,5042
RS,TABAI,63,51,-12,-19.05,149,167,18,12.08,11,36,25,227.27,116,119,3,2.59,371,326,-45,-12.13,710,699,-11,-1.55,TABAI RS,-29.6877843,-51.7180847,22,5043
RS,TAPEJARA,262,230,-32,-12.21,3285,3025,-260,-7.91,59,36,-23,-38.98,405,422,17,4.2,884,864,-20,-2.26,4895,4577,-318,-6.5,TAPEJARA RS,-28.069233,-52.0117161,22,5044
RS,TAPERA,113,112,-1,-0.88,423,489,66,15.6,111,112,1,0.9,762,695,-67,-8.79,768,723,-45,-5.86,2177,2131,-46,-2.11,TAPERA RS,-28.6262957,-52.8680873,22,5045
RS,TAPES,270,272,2,0.74,246,298,52,21.14,6,6,0,0.0,558,539,-19,-3.41,820,748,-72,-8.78,1900,1863,-37,-1.95,TAPES RS,-30.6747721,-51.3986199,22,5046
RS,TAQUARI,288,301,13,4.51,1510,1567,57,3.77,135,130,-5,-3.7,1120,1181,61,5.45,2143,2823,680,31.73,5196,6002,806,15.51,TAQUARI RS,-29.79433,-51.865346,22,5048
RS,TAVARES,5,3,-2,-40.0,6,8,2,33.33,7,5,-2,-28.57,72,68,-4,-5.56,551,672,121,21.96,641,756,115,17.94,TAVARES RS,-31.287471,-51.0897986,22,5050
RS,TENENTE PORTELA,94,93,-1,-1.06,273,266,-7,-2.56,54,59,5,9.26,828,768,-60,-7.25,1458,1349,-109,-7.48,2707,2535,-172,-6.35,TENENTE PORTELA RS,-27.371058,-53.758484,22,5051
RS,TEUTONIA,181,214,33,18.23,5602,3794,-1808,-32.27,211,193,-18,-8.53,1932,1989,57,2.95,3156,3204,48,1.52,11082,9394,-1688,-15.23,TEUTONIA RS,-29.4514561,-51.8087983,22,5053
RS,TIO HUGO,9,8,-1,-11.11,68,98,30,44.12,4,10,6,150.0,270,251,-19,-7.04,287,255,-32,-11.15,638,622,-16,-2.51,TIO HUGO RS,-28.5768433,-52.5969066,22,5054
RS,TIRADENTES DO SUL,5,5,0,0.0,35,41,6,17.14,5,7,2,40.0,144,147,3,2.08,258,237,-21,-8.14,447,437,-10,-2.24,TIRADENTES DO SUL RS,-27.402229,-54.081367,22,5055
RS,TOROPI,26,26,0,0.0,8,8,0,0.0,0,0,0,0.0,68,64,-4,-5.88,177,174,-3,-1.69,279,272,-7,-2.51,TOROPI RS,-29.478246,-54.224398,22,5056
RS,TORRES,14,9,-5,-35.71,583,553,-30,-5.15,842,774,-68,-8.08,3148,3362,214,6.8,5176,4828,-348,-6.72,9763,9526,-237,-2.43,TORRES RS,-29.3373663,-49.7299648,22,5057
RS,TRAVESSEIRO,29,20,-9,-31.03,324,286,-38,-11.73,0,0,0,0.0,16,13,-3,-18.75,143,133,-10,-6.99,512,452,-60,-11.72,TRAVESSEIRO RS,-29.2977561,-52.0562096,22,5059
RS,TRES ARROIOS,8,9,1,12.5,97,173,76,78.35,6,6,0,0.0,71,83,12,16.9,211,192,-19,-9.0,393,463,70,17.81,TRES ARROIOS RS,-27.4995057,-52.149354,22,5060
RS,TRES CACHOEIRAS,4,4,0,0.0,499,481,-18,-3.61,107,70,-37,-34.58,865,852,-13,-1.5,949,1038,89,9.38,2424,2445,21,0.87,TRES CACHOEIRAS RS,-29.4521243,-49.9190608,22,5061
RS,TRES DE MAIO,43,41,-2,-4.65,1502,1568,66,4.39,84,71,-13,-15.48,1945,1808,-137,-7.04,2601,2517,-84,-3.23,6175,6005,-170,-2.75,TRES DE MAIO RS,-27.7799415,-54.2356626,22,5063
RS,TRES FORQUILHAS,1,13,12,1200.0,3,3,0,0.0,5,5,0,0.0,41,28,-13,-31.71,252,226,-26,-10.32,302,275,-27,-8.94,TRES FORQUILHAS RS,-29.5375482,-50.0650535,22,5064
RS,TRES PALMEIRAS,65,64,-1,-1.54,61,68,7,11.48,16,17,1,6.25,145,152,7,4.83,245,254,9,3.67,532,555,23,4.32,TRES PALMEIRAS RS,-27.6166217,-52.8412626,22,5065
RS,TRES PASSOS,128,122,-6,-4.69,1629,1748,119,7.31,97,121,24,24.74,1889,1862,-27,-1.43,2289,2399,110,4.81,6032,6252,220,3.65,TRES PASSOS RS,-27.4556106,-53.9294399,22,5066
RS,TRINDADE DO SUL,31,36,5,16.13,1429,1712,283,19.8,125,139,14,11.2,199,230,31,15.58,417,458,41,9.83,2201,2575,374,16.99,TRINDADE DO SUL RS,-27.5218951,-52.8986017,22,5067
RS,TUCUNDUVA,38,36,-2,-5.26,136,123,-13,-9.56,4,6,2,50.0,326,296,-30,-9.2,466,474,8,1.72,970,935,-35,-3.61,TUCUNDUVA RS,-27.6581837,-54.4416605,22,5069
RS,TUNAS,2,4,2,100.0,1,0,-1,-100.0,9,4,-5,-55.56,96,95,-1,-1.04,235,181,-54,-22.98,343,284,-59,-17.2,TUNAS RS,-29.1053032,-52.9569329,22,5070
RS,TUPANCI DO SUL,5,4,-1,-20.0,9,10,1,11.11,0,0,0,0.0,25,23,-2,-8.0,139,132,-7,-5.04,178,169,-9,-5.06,TUPANCI DO SUL RS,-27.9239665,-51.5377991,22,5071
RS,TUPANCIRETA,974,914,-60,-6.16,84,92,8,9.52,40,38,-2,-5.0,1291,1294,3,0.23,1291,1196,-95,-7.36,3680,3534,-146,-3.97,TUPANCIRETA RS,-29.0798756,-53.8386668,22,5072
RS,TUPANDI,56,55,-1,-1.79,2055,2460,405,19.71,78,84,6,7.69,119,113,-6,-5.04,585,584,-1,-0.17,2893,3296,403,13.93,TUPANDI RS,-29.4779269,-51.4209232,22,5073
RS,TUPARENDI,73,73,0,0.0,241,233,-8,-3.32,14,10,-4,-28.57,540,469,-71,-13.15,515,460,-55,-10.68,1383,1245,-138,-9.98,TUPARENDI RS,-27.7622992,-54.4829323,22,5074
RS,TURUCU,83,78,-5,-6.02,28,31,3,10.71,6,7,1,16.67,61,62,1,1.64,265,250,-15,-5.66,443,428,-15,-3.39,TURUCU RS,-31.4191603,-52.1765159,22,5075
RS,UBIRETAMA,2,2,0,0.0,4,4,0,0.0,0,0,0,0.0,47,42,-5,-10.64,148,129,-19,-12.84,201,177,-24,-11.94,UBIRETAMA RS,-28.0455687,-54.68158,22,5076
RS,UNIAO DA SERRA,15,20,5,33.33,51,45,-6,-11.76,1,1,0,0.0,10,9,-1,-10.0,126,115,-11,-8.73,203,190,-13,-6.4,UNIAO DA SERRA RS,-28.7531756,-52.0152854,22,5077
RS,UNISTALDA,77,74,-3,-3.9,0,0,0,0.0,0,0,0,0.0,22,22,0,0.0,186,160,-26,-13.98,285,256,-29,-10.18,UNISTALDA RS,-29.0476115,-55.1503792,22,5078
RS,URUGUAIANA,2746,2741,-5,-0.18,957,930,-27,-2.82,631,694,63,9.98,6295,6247,-48,-0.76,10030,9160,-870,-8.67,20659,19772,-887,-4.29,URUGUAIANA RS,-29.7560726,-57.0867546,22,5079
RS,VACARIA,5624,5962,338,6.01,1987,2074,87,4.38,339,345,6,1.77,4148,4309,161,3.88,5302,5309,7,0.13,17400,17999,599,3.44,VACARIA RS,-28.5102901,-50.9356044,22,5080
RS,VALE VERDE,38,56,18,47.37,65,63,-2,-3.08,0,0,0,0.0,36,34,-2,-5.56,227,223,-4,-1.76,366,376,10,2.73,VALE VERDE RS,-29.7830651,-52.1843582,22,5081
RS,VALE DO SOL,6,9,3,50.0,58,51,-7,-12.07,4,2,-2,-50.0,141,145,4,2.84,479,409,-70,-14.61,688,616,-72,-10.47,VALE DO SOL RS,-29.6036459,-52.6867334,22,5082
RS,VANINI,6,5,-1,-16.67,90,89,-1,-1.11,0,1,1,0.0,42,37,-5,-11.9,290,272,-18,-6.21,428,404,-24,-5.61,VANINI RS,-28.4762692,-51.8452978,22,5084
RS,VENANCIO AIRES,59,61,2,3.39,7305,7988,683,9.35,373,342,-31,-8.31,3449,3366,-83,-2.41,4867,4645,-222,-4.56,16053,16402,349,2.17,VENANCIO AIRES RS,-29.614306,-52.193159,22,5085
RS,VERANOPOLIS,56,48,-8,-14.29,3789,3742,-47,-1.24,166,167,1,0.6,1167,1105,-62,-5.31,2275,2195,-80,-3.52,7453,7257,-196,-2.63,VERANOPOLIS RS,-28.9351293,-51.5516741,22,5087
RS,VIADUTOS,10,8,-2,-20.0,58,57,-1,-1.72,9,5,-4,-44.44,117,125,8,6.84,390,318,-72,-18.46,584,513,-71,-12.16,VIADUTOS RS,-27.5706489,-52.0210682,22,5089
RS,VICENTE DUTRA,2,2,0,0.0,17,9,-8,-47.06,0,0,0,0.0,58,51,-7,-12.07,224,206,-18,-8.04,301,268,-33,-10.96,VICENTE DUTRA RS,-27.1669307,-53.4048541,22,5091
RS,VICTOR GRAEFF,32,34,2,6.25,110,146,36,32.73,2,1,-1,-50.0,107,102,-5,-4.67,316,278,-38,-12.03,567,561,-6,-1.06,VICTOR GRAEFF RS,-28.563163,-52.749535,22,5092
RS,VILA LANGARO,14,17,3,21.43,272,293,21,7.72,6,6,0,0.0,56,62,6,10.71,149,119,-30,-20.13,497,497,0,0.0,VILA LANGARO RS,-28.1073953,-52.1446254,22,5094
RS,VILA MARIA,94,91,-3,-3.19,635,976,341,53.7,113,128,15,13.27,218,212,-6,-2.75,518,521,3,0.58,1578,1928,350,22.18,VILA MARIA RS,-28.53429,-52.1548439,22,5095
RS,VILA NOVA DO SUL,88,90,2,2.27,130,122,-8,-6.15,0,0,0,0.0,159,155,-4,-2.52,268,243,-25,-9.33,645,610,-35,-5.43,VILA NOVA DO SUL RS,-30.343232,-53.8833913,22,5096
RS,VISTA ALEGRE DO PRATA,15,9,-6,-40.0,74,74,0,0.0,2,2,0,0.0,28,26,-2,-7.14,131,127,-4,-3.05,250,238,-12,-4.8,VISTA ALEGRE DO PRATA RS,-28.8080826,-51.7868557,22,5098
RS,VISTA GAUCHA,31,37,6,19.35,64,53,-11,-17.19,1,1,0,0.0,88,76,-12,-13.64,267,265,-2,-0.75,451,432,-19,-4.21,VISTA GAUCHA RS,-27.2897171,-53.7024746,22,5099
RS,VITORIA DAS MISSOES,31,25,-6,-19.35,6,7,1,16.67,0,0,0,0.0,101,91,-10,-9.9,31,173,142,458.06,169,296,127,75.15,VITORIA DAS MISSOES RS,-28.3525794,-54.4995706,22,5100
MS,AGUA CLARA,1780,1834,54,3.03,980,1175,195,19.9,200,172,-28,-14.0,737,700,-37,-5.02,938,1339,401,42.75,4635,5220,585,12.62,AGUA CLARA MS,-20.4385757,-52.8797496,11,5103
MS,ALCINOPOLIS,321,329,8,2.49,6,6,0,0.0,1,3,2,200.0,91,111,20,21.98,371,300,-71,-19.14,790,749,-41,-5.19,ALCINOPOLIS MS,-18.3264121,-53.7094463,11,5104
MS,AMAMBAI,1237,1196,-41,-3.31,514,577,63,12.26,143,154,11,7.69,1578,1586,8,0.51,2615,2411,-204,-7.8,6087,5924,-163,-2.68,AMAMBAI MS,-23.1082701,-55.2284854,11,5105
MS,ANAURILANDIA,609,627,18,2.96,144,131,-13,-9.03,7,6,-1,-14.29,207,207,0,0.0,597,596,-1,-0.17,1564,1567,3,0.19,ANAURILANDIA MS,-22.185169,-52.719056,11,5107
MS,ANGELICA,294,301,7,2.38,4976,5242,266,5.35,1,12,11,1100.0,163,186,23,14.11,684,643,-41,-5.99,6118,6384,266,4.35,ANGELICA MS,-22.1588196,-53.7728504,11,5108
MS,ANTONIO JOAO,391,398,7,1.79,6,5,-1,-16.67,0,0,0,0.0,177,171,-6,-3.39,635,474,-161,-25.35,1209,1048,-161,-13.32,ANTONIO JOAO MS,-22.1892837,-55.9508227,11,5109
MS,APARECIDA DO TABOADO,728,718,-10,-1.37,4186,4365,179,4.28,207,88,-119,-57.49,692,694,2,0.29,1679,1821,142,8.46,7492,7686,194,2.59,APARECIDA DO TABOADO MS,-20.0840304,-51.1013943,11,5110
MS,ARAL MOREIRA,537,593,56,10.43,30,22,-8,-26.67,102,107,5,4.9,309,328,19,6.15,439,764,325,74.03,1417,1814,397,28.02,ARAL MOREIRA MS,-22.951141,-55.6268421,11,5112
MS,BANDEIRANTES,205,189,-16,-7.8,1905,1765,-140,-7.35,51,62,11,21.57,1420,1361,-59,-4.15,2586,2759,173,6.69,6167,6136,-31,-0.5,BANDEIRANTES MS,-19.9179623,-54.3646768,11,5113
MS,BATAGUASSU,595,571,-24,-4.03,3070,3425,355,11.56,43,49,6,13.95,812,849,37,4.56,1717,1575,-142,-8.27,6237,6469,232,3.72,BATAGUASSU MS,-21.715899,-52.422058,11,5114
MS,BATAYPORA,355,354,-1,-0.28,724,750,26,3.59,10,6,-4,-40.0,250,256,6,2.4,176,632,456,259.09,1515,1998,483,31.88,BATAYPORA MS,-22.2976466,-53.2685608,11,5115
MS,BELA VISTA,855,879,24,2.81,452,496,44,9.73,14,12,-2,-14.29,520,559,39,7.5,1056,1038,-18,-1.7,2897,2984,87,3.0,BELA VISTA MS,-22.107327,-56.5317344,11,5116
MS,BODOQUENA,376,293,-83,-22.07,131,254,123,93.89,16,32,16,100.0,189,192,3,1.59,705,712,7,0.99,1417,1483,66,4.66,BODOQUENA MS,-20.5508775,-56.6769653,11,5117
MS,BONITO,45,72,27,60.0,1119,1311,192,17.16,0,0,0,0.0,27,25,-2,-7.41,732,611,-121,-16.53,1923,2019,96,4.99,BONITO MS,-21.1264766,-56.4902208,11,5118
MS,BRASILANDIA,1193,1348,155,12.99,218,212,-6,-2.75,161,164,3,1.86,340,354,14,4.12,1089,1040,-49,-4.5,3001,3118,117,3.9,BRASILANDIA MS,-21.255575,-52.0365617,11,5119
MS,CAARAPO,1799,1721,-78,-4.34,1144,1562,418,36.54,29,78,49,168.97,1151,1219,68,5.91,2119,2253,134,6.32,6242,6833,591,9.47,CAARAPO MS,-22.6349267,-54.8240903,11,5120
MS,CAMAPUA,996,1014,18,1.81,59,59,0,0.0,32,15,-17,-53.12,578,586,8,1.38,990,869,-121,-12.22,2655,2543,-112,-4.22,CAMAPUA MS,-19.5291747,-54.0434641,11,5121
MS,CAMPO GRANDE,2,2,0,0.0,0,0,0,0.0,0,0,0,0.0,40,34,-6,-15.0,518,500,-18,-3.47,560,536,-24,-4.29,CAMPO GRANDE MS,-20.4845788,-54.6123204,11,5122
MS,CARACOL,0,0,0,0.0,6,6,0,0.0,0,1,1,0.0,88,92,4,4.55,405,285,-120,-29.63,499,384,-115,-23.05,CARACOL MS,-22.0169949,-57.0298349,11,5123
MS,CASSILANDIA,796,796,0,0.0,820,832,12,1.46,8,25,17,212.5,972,932,-40,-4.12,1489,1473,-16,-1.07,4085,4058,-27,-0.66,CASSILANDIA MS,-19.1128242,-51.7345354,11,5124
MS,CHAPADAO DO SUL,2997,2778,-219,-7.31,327,328,1,0.31,159,304,145,91.19,2232,2271,39,1.75,3204,2743,-461,-14.39,8919,8424,-495,-5.55,CHAPADAO DO SUL MS,-18.7949051,-52.6199512,11,5125
MS,CORGUINHO,311,312,1,0.32,27,22,-5,-18.52,12,10,-2,-16.67,57,52,-5,-8.77,322,290,-32,-9.94,729,686,-43,-5.9,CORGUINHO MS,-19.827429,-54.8322243,11,5126
MS,CORONEL SAPUCAIA,107,134,27,25.23,51,46,-5,-9.8,10,10,0,0.0,238,240,2,0.84,729,729,0,0.0,1135,1159,24,2.11,CORONEL SAPUCAIA MS,-23.27186,-55.5288174,11,5127
MS,COSTA RICA,1386,1391,5,0.36,1378,1183,-195,-14.15,94,73,-21,-22.34,1360,1408,48,3.53,1883,1580,-303,-16.09,6101,5635,-466,-7.64,COSTA RICA MS,-18.5333859,-53.1394286,11,5129
MS,COXIM,1049,1038,-11,-1.05,453,435,-18,-3.97,119,58,-61,-51.26,1671,1630,-41,-2.45,2312,2268,-44,-1.9,5604,5429,-175,-3.12,COXIM MS,-18.504915,-54.7450251,11,5130
MS,DEODAPOLIS,180,184,4,2.22,277,137,-140,-50.54,26,39,13,50.0,476,527,51,10.71,661,604,-57,-8.62,1620,1491,-129,-7.96,DEODAPOLIS MS,-22.276272,-54.168163,11,5131
MS,DOIS IRMAOS DO BURITI,508,521,13,2.56,312,297,-15,-4.81,1,0,-1,-100.0,166,168,2,1.2,615,574,-41,-6.67,1602,1560,-42,-2.62,DOIS IRMAOS DO BURITI MS,-20.6906107,-55.2760274,11,5132
MS,DOURADINA,196,184,-12,-6.12,698,681,-17,-2.44,25,9,-16,-64.0,914,1078,164,17.94,863,857,-6,-0.7,2696,2809,113,4.19,DOURADINA MS,-22.0402812,-54.6118292,11,5133
MS,DOURADOS,1863,1887,24,1.29,10899,12682,1783,16.36,1664,1703,39,2.34,15033,14582,-451,-3.0,33783,32436,-1347,-3.99,63242,63290,48,0.08,DOURADOS MS,-22.2206145,-54.812208,11,5134
MS,ELDORADO,854,1042,188,22.01,109,102,-7,-6.42,9,9,0,0.0,246,241,-5,-2.03,803,826,23,2.86,2021,2220,199,9.85,ELDORADO MS,-23.7838809,-54.2832024,11,5135
MS,FATIMA DO SUL,108,107,-1,-0.93,544,730,186,34.19,17,27,10,58.82,818,780,-38,-4.65,1570,1437,-133,-8.47,3057,3081,24,0.79,FATIMA DO SUL MS,-22.3750499,-54.516698,11,5136
MS,FIGUEIRAO,303,278,-25,-8.25,5,7,2,40.0,0,1,1,0.0,65,61,-4,-6.15,246,212,-34,-13.82,619,559,-60,-9.69,FIGUEIRAO MS,-18.67821,-53.6379864,11,5137
MS,GLORIA DE DOURADOS,177,191,14,7.91,106,104,-2,-1.89,5,4,-1,-20.0,225,217,-8,-3.56,753,730,-23,-3.05,1266,1246,-20,-1.58,GLORIA DE DOURADOS MS,-22.4173731,-54.2313391,11,5138
MS,IGUATEMI,528,535,7,1.33,505,597,92,18.22,9,20,11,122.22,471,468,-3,-0.64,865,789,-76,-8.79,2378,2409,31,1.3,IGUATEMI MS,-23.673555,-54.563731,11,5140
MS,INOCENCIA,727,684,-43,-5.91,190,152,-38,-20.0,36,35,-1,-2.78,202,195,-7,-3.47,643,556,-87,-13.53,1798,1622,-176,-9.79,INOCENCIA MS,-19.7310751,-51.9307502,11,5141
MS,ITAPORA,514,529,15,2.92,218,268,50,22.94,106,108,2,1.89,738,682,-56,-7.59,1260,1249,-11,-0.87,2836,2836,0,0.0,ITAPORA MS,-22.0799142,-54.7874239,11,5142
MS,ITAQUIRAI,739,758,19,2.57,2109,2415,306,14.51,29,47,18,62.07,430,405,-25,-5.81,1168,1183,15,1.28,4475,4808,333,7.44,ITAQUIRAI MS,-23.4801914,-54.1833692,11,5143
MS,IVINHEMA,609,602,-7,-1.15,421,428,7,1.66,129,83,-46,-35.66,1085,1155,70,6.45,2012,1908,-104,-5.17,4256,4176,-80,-1.88,IVINHEMA MS,-22.302254,-53.8276006,11,5144
MS,JAPORA,50,64,14,28.0,14,1,-13,-92.86,4,1,-3,-75.0,27,27,0,0.0,450,324,-126,-28.0,545,417,-128,-23.49,JAPORA MS,-23.8919161,-54.406888,11,5145
MS,JARAGUARI,624,560,-64,-10.26,35,38,3,8.57,13,10,-3,-23.08,52,80,28,53.85,366,361,-5,-1.37,1090,1049,-41,-3.76,JARAGUARI MS,-20.1019755,-54.4377423,11,5146
MS,JARDIM,0,0,0,0.0,57,52,-5,-8.77,10,14,4,40.0,153,168,15,9.8,1351,1300,-51,-3.77,1571,1534,-37,-2.36,JARDIM MS,-21.479941,-56.148902,11,5147
MS,JATEI,547,606,59,10.79,77,79,2,2.6,27,15,-12,-44.44,21,37,16,76.19,397,364,-33,-8.31,1069,1101,32,2.99,JATEI MS,-22.4815624,-54.307006,11,5148
MS,JUTI,235,210,-25,-10.64,304,370,66,21.71,6,3,-3,-50.0,114,121,7,6.14,461,400,-61,-13.23,1120,1104,-16,-1.43,JUTI MS,-22.8611994,-54.604793,11,5149
MS,LAGUNA CARAPA,702,717,15,2.14,8,8,0,0.0,13,24,11,84.62,183,218,35,19.13,506,436,-70,-13.83,1412,1403,-9,-0.64,LAGUNA CARAPA MS,-22.5549233,-55.1505549,11,5151
MS,MARACAJU,2374,2307,-67,-2.82,884,835,-49,-5.54,267,203,-64,-23.97,2286,2408,122,5.34,3810,3957,147,3.86,9621,9710,89,0.93,MARACAJU MS,-21.6163005,-55.164605,11,5152
MS,MIRANDA,1094,1002,-92,-8.41,119,172,53,44.54,40,23,-17,-42.5,677,759,82,12.11,2263,1803,-460,-20.33,4193,3759,-434,-10.35,MIRANDA MS,-20.2401082,-56.3844728,11,5153
MS,MUNDO NOVO,87,57,-30,-34.48,22,20,-2,-9.09,10,14,4,40.0,144,169,25,17.36,676,630,-46,-6.8,939,890,-49,-5.22,MUNDO NOVO MS,-23.9378876,-54.2859489,11,5154
MS,NAVIRAI,1229,1318,89,7.24,2574,2939,365,14.18,241,339,98,40.66,2813,2940,127,4.51,4002,2029,-1973,-49.3,10859,9565,-1294,-11.92,NAVIRAI MS,-23.0622152,-54.2018319,11,5155
MS,NIOAQUE,556,597,41,7.37,228,255,27,11.84,8,4,-4,-50.0,264,270,6,2.27,662,620,-42,-6.34,1718,1746,28,1.63,NIOAQUE MS,-21.1605528,-55.8283423,11,5156
MS,NOVA ALVORADA DO SUL,695,733,38,5.47,2064,1999,-65,-3.15,26,29,3,11.54,757,746,-11,-1.45,1641,1659,18,1.1,5183,5166,-17,-0.33,NOVA ALVORADA DO SUL MS,-21.4587274,-54.3760634,11,5157
MS,NOVA ANDRADINA,1124,1105,-19,-1.69,3247,3403,156,4.8,200,254,54,27.0,3062,3115,53,1.73,4132,4130,-2,-0.05,11765,12007,242,2.06,NOVA ANDRADINA MS,-22.2547041,-53.3513857,11,5158
MS,NOVO HORIZONTE DO SUL,105,111,6,5.71,53,84,31,58.49,0,0,0,0.0,124,137,13,10.48,371,302,-69,-18.6,653,634,-19,-2.91,NOVO HORIZONTE DO SUL MS,-22.6546565,-53.857078,11,5159
MS,PARANAIBA,1330,1431,101,7.59,1888,2106,218,11.55,211,218,7,3.32,1983,1997,14,0.71,3348,3408,60,1.79,8760,9160,400,4.57,PARANAIBA MS,-19.6751971,-51.1874986,11,5161
MS,PARANHOS,191,196,5,2.62,13,13,0,0.0,8,2,-6,-75.0,186,194,8,4.3,565,559,-6,-1.06,963,964,1,0.1,PARANHOS MS,-23.8927851,-55.4287213,11,5162
MS,PEDRO GOMES,443,444,1,0.23,6,18,12,200.0,0,1,1,0.0,175,160,-15,-8.57,438,421,-17,-3.88,1062,1044,-18,-1.69,PEDRO GOMES MS,-18.0990797,-54.550579,11,5163
MS,PONTA PORA,1441,1531,90,6.25,1544,1550,6,0.39,378,293,-85,-22.49,4325,4266,-59,-1.36,5938,6950,1012,17.04,13626,14590,964,7.07,PONTA PORA MS,-22.5286917,-55.723426,11,5164
MS,PORTO MURTINHO,1245,1230,-15,-1.2,17,23,6,35.29,2,1,-1,-50.0,204,202,-2,-0.98,796,700,-96,-12.06,2264,2156,-108,-4.77,PORTO MURTINHO MS,-21.698078,-57.883586,11,5165
MS,RIBAS DO RIO PARDO,2771,2905,134,4.84,544,557,13,2.39,11,13,2,18.18,700,733,33,4.71,1674,1553,-121,-7.23,5700,5761,61,1.07,RIBAS DO RIO PARDO MS,-20.4477984,-53.7609001,11,5166
MS,RIO BRILHANTE,1842,1987,145,7.87,3435,3367,-68,-1.98,50,42,-8,-16.0,1508,1555,47,3.12,3317,3060,-257,-7.75,10152,10011,-141,-1.39,RIO BRILHANTE MS,-21.8046467,-54.5433047,11,5167
MS,RIO NEGRO,188,193,5,2.66,3349,3590,241,7.2,135,123,-12,-8.89,1337,1289,-48,-3.59,2636,2563,-73,-2.77,7645,7758,113,1.48,RIO NEGRO MS,-19.4466984,-54.9860433,11,5168
MS,RIO VERDE DE MATO GROSSO,984,1032,48,4.88,208,212,4,1.92,248,59,-189,-76.21,555,594,39,7.03,1053,1075,22,2.09,3048,2972,-76,-2.49,RIO VERDE DE MATO GROSSO MS,-18.9169208,-54.8410727,11,5169
MS,ROCHEDO,310,333,23,7.42,774,859,85,10.98,0,0,0,0.0,81,90,9,11.11,298,295,-3,-1.01,1463,1577,114,7.79,ROCHEDO MS,-19.956488,-54.884769,11,5170
MS,SANTA RITA DO PARDO,979,1018,39,3.98,197,205,8,4.06,6,5,-1,-16.67,147,168,21,14.29,557,470,-87,-15.62,1886,1866,-20,-1.06,SANTA RITA DO PARDO MS,-21.3025544,-52.8262142,11,5171
MS,SAO GABRIEL DO OESTE,1691,1625,-66,-3.9,2728,3350,622,22.8,84,88,4,4.76,1612,1714,102,6.33,2907,2740,-167,-5.74,9022,9517,495,5.49,SAO GABRIEL DO OESTE MS,-19.3944843,-54.5755213,11,5172
MS,SETE QUEDAS,206,208,2,0.97,95,83,-12,-12.63,3,2,-1,-33.33,286,285,-1,-0.35,447,424,-23,-5.15,1037,1002,-35,-3.38,SETE QUEDAS MS,-23.978822,-55.0428349,11,5173
MS,SELVIRIA,386,345,-41,-10.62,775,984,209,26.97,5,5,0,0.0,111,91,-20,-18.02,840,834,-6,-0.71,2117,2259,142,6.71,SELVIRIA MS,-20.3616393,-51.4251863,11,5174
MS,SIDROLANDIA,1707,1831,124,7.26,3380,3845,465,13.76,132,173,41,31.06,1612,1625,13,0.81,3215,3078,-137,-4.26,10046,10552,506,5.04,SIDROLANDIA MS,-20.9361042,-54.9640262,11,5175
MS,SONORA,1758,1860,102,5.8,488,455,-33,-6.76,42,71,29,69.05,517,388,-129,-24.95,1643,1505,-138,-8.4,4448,4279,-169,-3.8,SONORA MS,-17.5852028,-54.7548288,11,5176
MS,TACURU,351,325,-26,-7.41,25,15,-10,-40.0,3,2,-1,-33.33,115,118,3,2.61,421,448,27,6.41,915,908,-7,-0.77,TACURU MS,-23.635954,-55.014137,11,5177
MS,TAQUARUSSU,164,189,25,15.24,3,1,-2,-66.67,2,2,0,0.0,43,43,0,0.0,354,307,-47,-13.28,566,542,-24,-4.24,TAQUARUSSU MS,-22.4870022,-53.3524041,11,5178
MS,TERENOS,894,979,85,9.51,867,887,20,2.31,153,102,-51,-33.33,362,320,-42,-11.6,911,789,-122,-13.39,3187,3077,-110,-3.45,TERENOS MS,-20.4409259,-54.8656049,11,5179
MS,TRES LAGOAS,4120,3464,-656,-15.92,9218,9859,641,6.95,1457,1461,4,0.27,6470,6576,106,1.64,14974,15102,128,0.85,36239,36462,223,0.62,TRES LAGOAS MS,-20.7866799,-51.7061247,11,5180
MS,VICENTINA,319,321,2,0.63,258,338,80,31.01,13,5,-8,-61.54,89,179,90,101.12,369,367,-2,-0.54,1048,1210,162,15.46,VICENTINA MS,-22.4093447,-54.4370921,11,5181
MT,ACORIZAL,147,131,-16,-10.88,177,174,-3,-1.69,14,8,-6,-42.86,51,58,7,13.73,184,148,-36,-19.57,573,519,-54,-9.42,ACORIZAL MT,-15.2001544,-56.3668953,12,5182
MT,AGUA BOA,164,158,-6,-3.66,6,5,-1,-16.67,10,4,-6,-60.0,182,188,6,3.3,531,486,-45,-8.47,893,841,-52,-5.82,AGUA BOA MT,-14.0522968,-52.1617625,12,5183
MT,ALTA FLORESTA,1350,1338,-12,-0.89,2000,1991,-9,-0.45,234,266,32,13.68,4104,4280,176,4.29,4040,3972,-68,-1.68,11728,11847,119,1.01,ALTA FLORESTA MT,-9.8698547,-56.0834993,12,5184
MT,ALTO ARAGUAIA,462,541,79,17.1,254,250,-4,-1.57,66,37,-29,-43.94,569,549,-20,-3.51,1330,1311,-19,-1.43,2681,2688,7,0.26,ALTO ARAGUAIA MT,-17.3156528,-53.2169365,12,5185
MT,ALTO BOA VISTA,116,151,35,30.17,1,1,0,0.0,0,0,0,0.0,78,96,18,23.08,299,278,-21,-7.02,494,526,32,6.48,ALTO BOA VISTA MT,-11.6723985,-51.3744431,12,5186
MT,ALTO GARCAS,1606,1665,59,3.67,42,36,-6,-14.29,5,8,3,60.0,471,494,23,4.88,678,644,-34,-5.01,2802,2847,45,1.61,ALTO GARCAS MT,-16.9469683,-53.529427,12,5187
MT,ALTO PARAGUAI,169,196,27,15.98,0,0,0,0.0,23,5,-18,-78.26,73,88,15,20.55,327,257,-70,-21.41,592,546,-46,-7.77,ALTO PARAGUAI MT,-14.513712,-56.4936374,12,5188
MT,ALTO TAQUARI,587,529,-58,-9.88,966,905,-61,-6.31,11,24,13,118.18,335,381,46,13.73,849,909,60,7.07,2748,2748,0,0.0,ALTO TAQUARI MT,-17.8269099,-53.2831736,12,5189
MT,APIACAS,216,216,0,0.0,108,105,-3,-2.78,11,6,-5,-45.45,332,358,26,7.83,440,425,-15,-3.41,1107,1110,3,0.27,APIACAS MT,-9.5678422,-57.394852,12,5190
MT,ARAGUAIANA,365,464,99,27.12,13,13,0,0.0,0,0,0,0.0,24,29,5,20.83,287,229,-58,-20.21,689,735,46,6.68,ARAGUAIANA MT,-15.729144,-51.834112,12,5191
MT,ARAGUAINHA,32,23,-9,-28.12,0,0,0,0.0,1,0,-1,-100.0,3,3,0,0.0,171,115,-56,-32.75,207,141,-66,-31.88,ARAGUAINHA MT,-16.857016,-53.031778,12,5192
MT,ARAPUTANGA,454,469,15,3.3,1416,1438,22,1.55,14,28,14,100.0,647,615,-32,-4.95,915,927,12,1.31,3446,3477,31,0.9,ARAPUTANGA MT,-15.4710868,-58.346796,12,5193
MT,ARIPUANA,570,531,-39,-6.84,1056,982,-74,-7.01,440,1418,978,222.27,727,836,109,14.99,1297,1522,225,17.35,4090,5289,1199,29.32,ARIPUANA MT,-10.175806,-59.4439663,12,5195
MT,BARAO DE MELGACO,129,119,-10,-7.75,1,1,0,0.0,0,0,0,0.0,37,35,-2,-5.41,305,284,-21,-6.89,472,439,-33,-6.99,BARAO DE MELGACO MT,-16.195776,-55.9668049,12,5196
MT,BARRA DO BUGRES,1518,1439,-79,-5.2,1814,1850,36,1.98,78,107,29,37.18,1366,1340,-26,-1.9,1426,1263,-163,-11.43,6202,5999,-203,-3.27,BARRA DO BUGRES MT,-15.0683712,-57.1853688,12,5197
MT,BARRA DO GARCAS,959,982,23,2.4,2642,2529,-113,-4.28,314,231,-83,-26.43,4188,4092,-96,-2.29,7656,7125,-531,-6.94,15759,14959,-800,-5.08,BARRA DO GARCAS MT,-15.8916033,-52.2615413,12,5198
MT,BOM JESUS DO ARAGUAIA,800,804,4,0.5,3,8,5,166.67,5,26,21,420.0,110,120,10,9.09,299,294,-5,-1.67,1217,1252,35,2.88,BOM JESUS DO ARAGUAIA MT,-12.1725897,-51.5074425,12,5199
MT,BRASNORTE,1727,1804,77,4.46,620,609,-11,-1.77,13,9,-4,-30.77,723,734,11,1.52,849,816,-33,-3.89,3932,3972,40,1.02,BRASNORTE MT,-12.1218837,-58.0042714,12,5200
MT,CACERES,2068,1987,-81,-3.92,839,879,40,4.77,146,232,86,58.9,4079,4015,-64,-1.57,7820,7808,-12,-0.15,14952,14921,-31,-0.21,CACERES MT,-16.0644315,-57.6879744,12,5201
MT,CAMPINAPOLIS,363,378,15,4.13,99,94,-5,-5.05,7,7,0,0.0,153,186,33,21.57,524,524,0,0.0,1146,1189,43,3.75,CAMPINAPOLIS MT,-14.5403731,-52.7970626,12,5202
MT,CAMPO NOVO DO PARECIS,5076,4629,-447,-8.81,2130,1975,-155,-7.28,576,562,-14,-2.43,3265,3495,230,7.04,2865,3172,307,10.72,13912,13833,-79,-0.57,CAMPO NOVO DO PARECIS MT,-13.658735,-57.890723,12,5203
MT,CAMPO VERDE,3778,3758,-20,-0.53,1322,1276,-46,-3.48,154,212,58,37.66,3187,3283,96,3.01,3173,3260,87,2.74,11614,11789,175,1.51,CAMPO VERDE MT,-15.5430787,-55.1590511,12,5204
MT,CAMPOS DE JULIO,2043,1825,-218,-10.67,371,274,-97,-26.15,7,10,3,42.86,478,472,-6,-1.26,763,761,-2,-0.26,3662,3342,-320,-8.74,CAMPOS DE JULIO MT,-13.7223646,-59.2645296,12,5205
MT,CANABRAVA DO NORTE,111,121,10,9.01,58,59,1,1.72,2,4,2,100.0,32,30,-2,-6.25,20,169,149,745.0,223,383,160,71.75,CANABRAVA DO NORTE MT,-11.0516481,-51.8301897,12,5206
MT,CANARANA,3,4,1,33.33,15,19,4,26.67,3,7,4,133.33,272,257,-15,-5.51,938,678,-260,-27.72,1231,965,-266,-21.61,CANARANA MT,-13.5564602,-52.2691167,12,5207
MT,CARLINDA,334,334,0,0.0,51,57,6,11.76,9,13,4,44.44,371,390,19,5.12,384,381,-3,-0.78,1149,1175,26,2.26,CARLINDA MT,-9.9690671,-55.8200191,12,5208
MT,CASTANHEIRA,393,376,-17,-4.33,104,70,-34,-32.69,19,14,-5,-26.32,196,174,-22,-11.22,240,230,-10,-4.17,952,864,-88,-9.24,CASTANHEIRA MT,-11.1391946,-58.6088547,12,5209
MT,CHAPADA DOS GUIMARAES,772,744,-28,-3.63,251,255,4,1.59,19,29,10,52.63,504,522,18,3.57,1504,1325,-179,-11.9,3050,2875,-175,-5.74,CHAPADA DOS GUIMARAES MT,-15.464343,-55.749857,12,5210
MT,CLAUDIA,494,533,39,7.89,326,332,6,1.84,12,14,2,16.67,367,413,46,12.53,574,593,19,3.31,1773,1885,112,6.32,CLAUDIA MT,-11.5057202,-54.8763166,12,5211
MT,COCALINHO,617,628,11,1.78,137,148,11,8.03,0,0,0,0.0,112,100,-12,-10.71,409,58,-351,-85.82,1275,934,-341,-26.75,COCALINHO MT,-14.390339,-51.00015,12,5212
MT,COLIDER,452,429,-23,-5.09,1509,1506,-3,-0.2,116,92,-24,-20.69,2263,2149,-114,-5.04,2040,1970,-70,-3.43,6380,6146,-234,-3.67,COLIDER MT,-10.8094999,-55.4540386,12,5213
MT,COLNIZA,514,486,-28,-5.45,687,560,-127,-18.49,7,12,5,71.43,720,776,56,7.78,1070,1134,64,5.98,2998,2968,-30,-1.0,COLNIZA MT,-9.4560637,-59.2197132,12,5214
MT,COMODORO,1016,1085,69,6.79,241,244,3,1.24,108,105,-3,-2.78,837,857,20,2.39,1301,1431,130,9.99,3503,3722,219,6.25,COMODORO MT,-13.6581107,-59.786883,12,5215
MT,CONFRESA,441,457,16,3.63,1264,1103,-161,-12.74,149,150,1,0.67,1467,1748,281,19.15,1514,1851,337,22.26,4835,5309,474,9.8,CONFRESA MT,-10.643695,-51.569873,12,5216
MT,COTRIGUACU,134,130,-4,-2.99,274,265,-9,-3.28,9,5,-4,-44.44,299,312,13,4.35,503,459,-44,-8.75,1219,1171,-48,-3.94,COTRIGUACU MT,-9.9034364,-58.5658915,12,5218
MT,CUIABA,3929,3902,-27,-0.69,15557,16361,804,5.17,10241,11729,1488,14.53,44903,43539,-1364,-3.04,172471,164175,-8296,-4.81,247101,239706,-7395,-2.99,CUIABA MT,-15.5986686,-56.0991301,12,5219
MT,CURVELANDIA,30,27,-3,-10.0,71,68,-3,-4.23,60,29,-31,-51.67,96,66,-30,-31.25,242,206,-36,-14.88,499,396,-103,-20.64,CURVELANDIA MT,-15.6108629,-57.9188924,12,5220
MT,DENISE,267,262,-5,-1.87,22,35,13,59.09,20,9,-11,-55.0,140,127,-13,-9.29,246,247,1,0.41,695,680,-15,-2.16,DENISE MT,-14.7292165,-57.0482981,12,5221
MT,DIAMANTINO,3261,3163,-98,-3.01,1399,1487,88,6.29,41,72,31,75.61,1135,1146,11,0.97,1862,1647,-215,-11.55,7698,7515,-183,-2.38,DIAMANTINO MT,-14.4036262,-56.4364488,12,5222
MT,DOM AQUINO,720,619,-101,-14.03,165,175,10,6.06,0,5,5,0.0,138,117,-21,-15.22,428,405,-23,-5.37,1451,1321,-130,-8.96,DOM AQUINO MT,-15.809899,-54.922298,12,5223
MT,FELIZ NATAL,609,645,36,5.91,549,491,-58,-10.56,26,24,-2,-7.69,373,361,-12,-3.22,710,681,-29,-4.08,2267,2202,-65,-2.87,FELIZ NATAL MT,-12.3802463,-54.9389793,12,5224
MT,GAUCHA DO NORTE,832,791,-41,-4.93,40,47,7,17.5,6,4,-2,-33.33,301,298,-3,-1.0,521,240,-281,-53.93,1700,1380,-320,-18.82,GAUCHA DO NORTE MT,-13.18136,-53.2543946,12,5226
MT,GENERAL CARNEIRO,278,293,15,5.4,276,260,-16,-5.8,164,148,-16,-9.76,543,564,21,3.87,622,578,-44,-7.07,1883,1843,-40,-2.12,GENERAL CARNEIRO MT,-15.7070922,-52.7606044,12,5227
MT,GUARANTA DO NORTE,274,296,22,8.03,1248,1155,-93,-7.45,174,218,44,25.29,1609,1565,-44,-2.73,2026,1955,-71,-3.5,5331,5189,-142,-2.66,GUARANTA DO NORTE MT,-9.9517992,-54.9098178,12,5229
MT,GUIRATINGA,651,705,54,8.29,63,62,-1,-1.59,0,7,7,0.0,239,248,9,3.77,640,652,12,1.88,1593,1674,81,5.08,GUIRATINGA MT,-16.3457422,-53.7595097,12,5230
MT,INDIAVAI,122,116,-6,-4.92,2,2,0,0.0,1,0,-1,-100.0,32,27,-5,-15.62,181,166,-15,-8.29,338,311,-27,-7.99,INDIAVAI MT,-15.4941405,-58.5765917,12,5231
MT,IPIRANGA DO NORTE,1487,1286,-201,-13.52,109,146,37,33.94,7,11,4,57.14,263,288,25,9.51,401,424,23,5.74,2267,2155,-112,-4.94,IPIRANGA DO NORTE MT,-12.2408004,-56.1531011,12,5232
MT,ITANHANGA,204,234,30,14.71,99,86,-13,-13.13,2,4,2,100.0,223,260,37,16.59,330,287,-43,-13.03,858,871,13,1.52,ITANHANGA MT,-12.2323038,-56.6418251,12,5233
MT,ITAUBA,454,434,-20,-4.41,221,313,92,41.63,11,2,-9,-81.82,113,107,-6,-5.31,390,426,36,9.23,1189,1282,93,7.82,ITAUBA MT,-11.0084948,-55.2480739,12,5234
MT,ITIQUIRA,2119,2089,-30,-1.42,93,96,3,3.23,15,16,1,6.67,336,315,-21,-6.25,1102,885,-217,-19.69,3665,3401,-264,-7.2,ITIQUIRA MT,-17.2033274,-54.1446924,12,5235
MT,JACIARA,627,653,26,4.15,906,997,91,10.04,90,125,35,38.89,1593,1644,51,3.2,2668,2570,-98,-3.67,5884,5989,105,1.78,JACIARA MT,-15.9520115,-54.9762106,12,5236
MT,JANGADA,183,181,-2,-1.09,212,135,-77,-36.32,3,3,0,0.0,153,149,-4,-2.61,386,312,-74,-19.17,937,780,-157,-16.76,JANGADA MT,-15.2309904,-56.4959264,12,5237
MT,JAURU,201,202,1,0.5,43,44,1,2.33,7,5,-2,-28.57,232,232,0,0.0,466,469,3,0.64,949,952,3,0.32,JAURU MT,-15.3407762,-58.8683137,12,5238
MT,JUARA,1579,1668,89,5.64,1399,1421,22,1.57,216,127,-89,-41.2,1899,1903,4,0.21,1818,1894,76,4.18,6911,7013,102,1.48,JUARA MT,-11.2535587,-57.5080072,12,5239
MT,JUINA,745,707,-38,-5.1,1417,1345,-72,-5.08,60,52,-8,-13.33,3027,3030,3,0.1,3191,2984,-207,-6.49,8440,8118,-322,-3.82,JUINA MT,-11.4230908,-58.7570212,12,5240
MT,JURUENA,201,193,-8,-3.98,759,622,-137,-18.05,15,16,1,6.67,376,414,38,10.11,528,513,-15,-2.84,1879,1758,-121,-6.44,JURUENA MT,-10.3282716,-58.4968918,12,5241
MT,JUSCIMEIRA,544,605,61,11.21,102,97,-5,-4.9,13,16,3,23.08,220,208,-12,-5.45,551,514,-37,-6.72,1430,1440,10,0.7,JUSCIMEIRA MT,-16.0517819,-54.8893514,12,5242
MT,LUCAS DO RIO VERDE,2532,2591,59,2.33,7326,7572,246,3.36,1774,1788,14,0.79,5970,6405,435,7.29,6915,7270,355,5.13,24517,25626,1109,4.52,LUCAS DO RIO VERDE MT,-13.0664609,-55.9196711,12,5244
MT,LUCIARA,40,31,-9,-22.5,0,0,0,0.0,0,0,0,0.0,19,17,-2,-10.53,196,152,-44,-22.45,255,200,-55,-21.57,LUCIARA MT,-11.2234472,-50.6680221,12,5245
MT,VILA BELA DA SANTISSIMA TRINDADE,1823,1816,-7,-0.38,22,10,-12,-54.55,10,9,-1,-10.0,243,241,-2,-0.82,978,1038,60,6.13,3076,3114,38,1.24,VILA BELA DA SANTISSIMA TRINDADE MT,-15.009904,-59.961115,12,5246
MT,MARCELANDIA,520,577,57,10.96,383,362,-21,-5.48,15,14,-1,-6.67,490,465,-25,-5.1,670,658,-12,-1.79,2078,2076,-2,-0.1,MARCELANDIA MT,-11.0794264,-54.5202451,12,5247
MT,MATUPA,627,632,5,0.8,1076,1064,-12,-1.12,70,107,37,52.86,1322,1364,42,3.18,1138,1144,6,0.53,4233,4311,78,1.84,MATUPA MT,-10.1683242,-54.9346194,12,5248
MT,NOBRES,275,249,-26,-9.45,787,815,28,3.56,31,51,20,64.52,557,526,-31,-5.57,1131,869,-262,-23.17,2781,2510,-271,-9.74,NOBRES MT,-14.7196233,-56.3351314,12,5250
MT,NOSSA SENHORA DO LIVRAMENTO,452,425,-27,-5.97,494,706,212,42.91,12,6,-6,-50.0,198,183,-15,-7.58,502,449,-53,-10.56,1658,1769,111,6.69,NOSSA SENHORA DO LIVRAMENTO MT,-15.7725185,-56.3442904,12,5252
MT,NOVA BANDEIRANTES,380,387,7,1.84,169,281,112,66.27,3,3,0,0.0,400,404,4,1.0,516,461,-55,-10.66,1468,1536,68,4.63,NOVA BANDEIRANTES MT,-9.8494172,-57.8139698,12,5253
MT,NOVA NAZARE,123,137,14,11.38,3,5,2,66.67,0,3,3,0.0,6,10,4,66.67,247,263,16,6.48,379,418,39,10.29,NOVA NAZARE MT,-13.9897745,-51.7998937,12,5254
MT,NOVA LACERDA,419,403,-16,-3.82,116,114,-2,-1.72,114,269,155,135.96,152,153,1,0.66,385,398,13,3.38,1186,1337,151,12.73,NOVA LACERDA MT,-14.4753855,-59.5881498,12,5255
MT,NOVA SANTA HELENA,254,264,10,3.94,71,86,15,21.13,4,6,2,50.0,90,121,31,34.44,308,283,-25,-8.12,727,760,33,4.54,NOVA SANTA HELENA MT,-10.8495357,-55.1780435,12,5256
MT,NOVA BRASILANDIA,245,213,-32,-13.06,7,16,9,128.57,10,9,-1,-10.0,54,49,-5,-9.26,253,223,-30,-11.86,569,510,-59,-10.37,NOVA BRASILANDIA MT,-14.9298622,-54.973665,12,5257
MT,NOVA CANAA DO NORTE,666,655,-11,-1.65,481,564,83,17.26,26,16,-10,-38.46,360,370,10,2.78,655,686,31,4.73,2188,2291,103,4.71,NOVA CANAA DO NORTE MT,-10.6367877,-55.709177,12,5258
MT,NOVA MUTUM,3377,3321,-56,-1.66,4135,4390,255,6.17,708,828,120,16.95,3818,3954,136,3.56,4556,4740,184,4.04,16594,17233,639,3.85,NOVA MUTUM MT,-13.8255015,-56.0849262,12,5259
MT,NOVA OLIMPIA,122,145,23,18.85,302,281,-21,-6.95,0,1,1,0.0,149,140,-9,-6.04,474,446,-28,-5.91,1047,1013,-34,-3.25,NOVA OLIMPIA MT,-14.7764648,-57.281316,12,5260
MT,NOVA UBIRATA,1927,1913,-14,-0.73,188,108,-80,-42.55,4,11,7,175.0,334,398,64,19.16,738,756,18,2.44,3191,3186,-5,-0.16,NOVA UBIRATA MT,-13.03484,-55.2539048,12,5261
MT,NOVA XAVANTINA,617,605,-12,-1.94,880,1335,455,51.7,166,85,-81,-48.8,858,946,88,10.26,1157,1158,1,0.09,3678,4129,451,12.26,NOVA XAVANTINA MT,-14.6794165,-52.351994,12,5262
MT,NOVO MUNDO,398,425,27,6.78,34,27,-7,-20.59,2,1,-1,-50.0,172,182,10,5.81,332,347,15,4.52,938,982,44,4.69,NOVO MUNDO MT,-9.9752901,-55.1779717,12,5263
MT,NOVO HORIZONTE DO NORTE,90,94,4,4.44,9,12,3,33.33,1,2,1,100.0,39,37,-2,-5.13,211,169,-42,-19.91,350,314,-36,-10.29,NOVO HORIZONTE DO NORTE MT,-11.3904019,-57.3159067,12,5264
MT,NOVO SAO JOAQUIM,913,873,-40,-4.38,30,25,-5,-16.67,0,0,0,0.0,166,151,-15,-9.04,372,325,-47,-12.63,1481,1374,-107,-7.22,NOVO SAO JOAQUIM MT,-14.9108231,-53.01775,12,5265
MT,PARANAITA,502,491,-11,-2.19,77,73,-4,-5.19,15,60,45,300.0,394,386,-8,-2.03,739,607,-132,-17.86,1727,1617,-110,-6.37,PARANAITA MT,-9.6655602,-56.4758122,12,5266
MT,PARANATINGA,1664,1848,184,11.06,1088,1131,43,3.95,27,27,0,0.0,877,934,57,6.5,1225,1534,309,25.22,4881,5474,593,12.15,PARANATINGA MT,-14.4297856,-54.0503432,12,5267
MT,NOVO SANTO ANTONIO,0,0,0,0.0,0,0,0,0.0,0,0,0,0.0,17,16,-1,-5.88,132,131,-1,-0.76,149,147,-2,-1.34,NOVO SANTO ANTONIO MT,-12.2909756,-50.97048,12,5268
MT,PEDRA PRETA,0,0,0,0.0,0,0,0,0.0,0,0,0,0.0,10,9,-1,-10.0,217,144,-73,-33.64,227,153,-74,-32.6,PEDRA PRETA MT,-16.6230015,-54.4761228,12,5269
MT,PEIXOTO DE AZEVEDO,429,479,50,11.66,361,385,24,6.65,62,70,8,12.9,1048,1078,30,2.86,1386,1314,-72,-5.19,3286,3326,40,1.22,PEIXOTO DE AZEVEDO MT,-10.2429203,-54.9919857,12,5270
MT,PLANALTO DA SERRA,251,266,15,5.98,3,6,3,100.0,1,5,4,400.0,38,44,6,15.79,184,217,33,17.93,477,538,61,12.79,PLANALTO DA SERRA MT,-14.6627994,-54.7756232,12,5271
MT,POCONE,731,699,-32,-4.38,632,755,123,19.46,20,4,-16,-80.0,768,681,-87,-11.33,1737,1603,-134,-7.71,3888,3742,-146,-3.76,POCONE MT,-16.2634094,-56.6229717,12,5272
MT,PONTE BRANCA,30,29,-1,-3.33,2,1,-1,-50.0,0,0,0,0.0,23,16,-7,-30.43,149,132,-17,-11.41,204,178,-26,-12.75,PONTE BRANCA MT,-16.758407,-52.836864,12,5274
MT,PORTO ALEGRE DO NORTE,423,374,-49,-11.58,130,147,17,13.08,22,58,36,163.64,219,222,3,1.37,427,415,-12,-2.81,1221,1216,-5,-0.41,PORTO ALEGRE DO NORTE MT,-10.8792851,-51.6391975,12,5276
MT,PORTO DOS GAUCHOS,961,1136,175,18.21,157,127,-30,-19.11,2,2,0,0.0,151,270,119,78.81,582,495,-87,-14.95,1853,2030,177,9.55,PORTO DOS GAUCHOS MT,-11.532999,-57.413233,12,5277
MT,PORTO ESPERIDIAO,883,854,-29,-3.28,144,137,-7,-4.86,4,13,9,225.0,200,176,-24,-12.0,412,520,108,26.21,1643,1700,57,3.47,PORTO ESPERIDIAO MT,-15.8521665,-58.4693093,12,5278
MT,PORTO ESTRELA,176,190,14,7.95,23,27,4,17.39,0,0,0,0.0,46,42,-4,-8.7,236,215,-21,-8.9,481,474,-7,-1.46,PORTO ESTRELA MT,-15.3331148,-57.2080992,12,5279
MT,PRIMAVERA DO LESTE,4193,3532,-661,-15.76,2199,3000,801,36.43,642,580,-62,-9.66,6231,6658,427,6.85,8080,8501,421,5.21,21345,22271,926,4.34,PRIMAVERA DO LESTE MT,-15.5614127,-54.2993946,12,5281
MT,QUERENCIA,2041,2359,318,15.58,266,276,10,3.76,162,201,39,24.07,1495,1673,178,11.91,1355,1322,-33,-2.44,5319,5831,512,9.63,QUERENCIA MT,-12.5944625,-52.2088505,12,5282
MT,SAO JOSE DOS QUATRO MARCOS,511,485,-26,-5.09,356,345,-11,-3.09,27,42,15,55.56,833,821,-12,-1.44,1044,951,-93,-8.91,2771,2644,-127,-4.58,SAO JOSE DOS QUATRO MARCOS MT,-15.627584,-58.177217,12,5283
MT,RESERVA DO CABACAL,38,31,-7,-18.42,3,4,1,33.33,0,0,0,0.0,28,19,-9,-32.14,207,183,-24,-11.59,276,237,-39,-14.13,RESERVA DO CABACAL MT,-15.1211207,-58.3836183,12,5284
MT,RIBEIRAO CASCALHEIRA,418,583,165,39.47,54,41,-13,-24.07,29,17,-12,-41.38,302,396,94,31.13,504,502,-2,-0.4,1307,1539,232,17.75,RIBEIRAO CASCALHEIRA MT,-12.936738,-51.824421,12,5285
MT,RIBEIRAOZINHO,81,86,5,6.17,7,10,3,42.86,1,1,0,0.0,38,50,12,31.58,198,180,-18,-9.09,325,327,2,0.62,RIBEIRAOZINHO MT,-16.489765,-52.6942009,12,5286
MT,RIO BRANCO,1147,1072,-75,-6.54,5113,4678,-435,-8.51,4355,4977,622,14.28,17503,17883,380,2.17,64864,71436,6572,10.13,92982,100046,7064,7.6,RIO BRANCO MT,-15.2398109,-58.1160774,12,5287
MT,SANTA CARMEM,478,517,39,8.16,155,150,-5,-3.23,29,29,0,0.0,112,142,30,26.79,353,252,-101,-28.61,1127,1090,-37,-3.28,SANTA CARMEM MT,-11.9745614,-55.2788045,12,5288
MT,SANTO AFONSO,180,189,9,5.0,11,7,-4,-36.36,0,0,0,0.0,21,21,0,0.0,188,169,-19,-10.11,400,386,-14,-3.5,SANTO AFONSO MT,-14.4960696,-57.0045096,12,5289
MT,SAO JOSE DO POVO,78,79,1,1.28,0,4,4,0.0,0,3,3,0.0,19,18,-1,-5.26,217,181,-36,-16.59,314,285,-29,-9.24,SAO JOSE DO POVO MT,-16.4647805,-54.2539044,12,5290
MT,SAO JOSE DO RIO CLARO,1013,1067,54,5.33,778,665,-113,-14.52,36,247,211,586.11,754,819,65,8.62,956,909,-47,-4.92,3537,3707,170,4.81,SAO JOSE DO RIO CLARO MT,-13.4467103,-56.7214365,12,5291
MT,SAO JOSE DO XINGU,855,999,144,16.84,3,4,1,33.33,5,3,-2,-40.0,95,109,14,14.74,378,369,-9,-2.38,1336,1484,148,11.08,SAO JOSE DO XINGU MT,-10.803888,-52.7357819,12,5292
MT,RONDOLANDIA,330,336,6,1.82,173,212,39,22.54,0,0,0,0.0,15,10,-5,-33.33,358,293,-65,-18.16,876,851,-25,-2.85,RONDOLANDIA MT,-10.8428772,-61.4596962,12,5294
MT,RONDONOPOLIS,2653,2582,-71,-2.68,9075,8961,-114,-1.26,4302,3940,-362,-8.41,17418,17270,-148,-0.85,26852,28423,1571,5.85,60300,61176,876,1.45,RONDONOPOLIS MT,-16.4603533,-54.6397099,12,5295
MT,ROSARIO OESTE,589,621,32,5.43,172,226,54,31.4,0,22,22,0.0,328,276,-52,-15.85,832,728,-104,-12.5,1921,1873,-48,-2.5,ROSARIO OESTE MT,-14.825938,-56.42357,12,5296
MT,SANTA CRUZ DO XINGU,278,310,32,11.51,0,0,0,0.0,3,0,-3,-100.0,47,44,-3,-6.38,221,223,2,0.9,549,577,28,5.1,SANTA CRUZ DO XINGU MT,-10.1533447,-52.392016,12,5297
MT,SALTO DO CEU,182,180,-2,-1.1,9,1,-8,-88.89,19,21,2,10.53,53,52,-1,-1.89,275,225,-50,-18.18,538,479,-59,-10.97,SALTO DO CEU MT,-15.1295662,-58.1298908,12,5298
MT,SANTA RITA DO TRIVELATO,1029,985,-44,-4.28,0,0,0,0.0,1,1,0,0.0,115,138,23,20.0,285,229,-56,-19.65,1430,1353,-77,-5.38,SANTA RITA DO TRIVELATO MT,-13.8139517,-55.2721092,12,5299
MT,SANTA TEREZINHA,1,1,0,0.0,4,3,-1,-25.0,24,16,-8,-33.33,56,75,19,33.93,735,455,-280,-38.1,820,550,-270,-32.93,SANTA TEREZINHA MT,-10.470375,-50.513986,12,5300
MT,SANTO ANTONIO DO LESTE,936,973,37,3.95,19,11,-8,-42.11,0,0,0,0.0,48,47,-1,-2.08,272,211,-61,-22.43,1275,1242,-33,-2.59,SANTO ANTONIO DO LESTE MT,-14.8037659,-53.6095671,12,5301
MT,SANTO ANTONIO DO LEVERGER,1402,1330,-72,-5.14,244,372,128,52.46,6,12,6,100.0,206,179,-27,-13.11,364,724,360,98.9,2222,2617,395,17.78,SANTO ANTONIO DO LEVERGER MT,-15.84980135,-56.08614356248529,12,5302
MT,SAO FELIX DO ARAGUAIA,1265,1207,-58,-4.58,29,26,-3,-10.34,3,9,6,200.0,243,264,21,8.64,774,667,-107,-13.82,2314,2173,-141,-6.09,SAO FELIX DO ARAGUAIA MT,-11.6170646,-50.6667246,12,5303
MT,SAPEZAL,6434,6319,-115,-1.79,455,470,15,3.3,262,259,-3,-1.15,1984,2083,99,4.99,2350,2562,212,9.02,11485,11693,208,1.81,SAPEZAL MT,-13.547958,-58.8146235,12,5304
MT,SERRA NOVA DOURADA,95,91,-4,-4.21,0,0,0,0.0,0,0,0,0.0,0,0,0,0.0,163,169,6,3.68,258,260,2,0.78,SERRA NOVA DOURADA MT,-12.0890348,-51.4005672,12,5305
MT,SINOP,1480,1464,-16,-1.08,6414,6649,235,3.66,2028,2183,155,7.64,15674,15995,321,2.05,16055,16095,40,0.25,41651,42386,735,1.76,SINOP MT,-11.8508224,-55.5175957,12,5306
MT,SORRISO,3946,4282,336,8.51,4521,4929,408,9.02,1839,1858,19,1.03,9239,9283,44,0.48,8637,9378,741,8.58,28182,29730,1548,5.49,SORRISO MT,-12.5444887,-55.7233972,12,5307
MT,TABAPORA,1039,957,-82,-7.89,123,178,55,44.72,5,6,1,20.0,256,270,14,5.47,513,486,-27,-5.26,1936,1897,-39,-2.01,TABAPORA MT,-11.3085286,-56.8212723,12,5308
MT,TANGARA DA SERRA,2252,2505,253,11.23,4476,4772,296,6.61,1248,1068,-180,-14.42,7671,7765,94,1.23,7984,7998,14,0.18,23631,24108,477,2.02,TANGARA DA SERRA MT,-14.6213903,-57.4907268,12,5309
MT,TAPURAH,1804,1884,80,4.43,197,184,-13,-6.6,77,107,30,38.96,877,892,15,1.71,1081,1065,-16,-1.48,4036,4132,96,2.38,TAPURAH MT,-12.742385,-56.512037,12,5310
MT,TERRA NOVA DO NORTE,214,222,8,3.74,291,334,43,14.78,20,11,-9,-45.0,521,540,19,3.65,498,515,17,3.41,1544,1622,78,5.05,TERRA NOVA DO NORTE MT,-10.5995196,-55.1167029,12,5311
MT,TESOURO,352,345,-7,-1.99,0,0,0,0.0,0,0,0,0.0,24,24,0,0.0,148,99,-49,-33.11,524,468,-56,-10.69,TESOURO MT,-16.0802073,-53.553114,12,5312
MT,UNIAO DO SUL,389,390,1,0.26,102,91,-11,-10.78,13,12,-1,-7.69,118,93,-25,-21.19,210,271,61,29.05,832,857,25,3.0,UNIAO DO SUL MT,-11.5308712,-54.3695643,12,5314
MT,VALE DE SAO DOMINGOS,85,89,4,4.71,1,2,1,100.0,0,16,16,0.0,26,32,6,23.08,205,232,27,13.17,317,371,54,17.03,VALE DE SAO DOMINGOS MT,-15.2966987,-59.065637,12,5315
MT,VERA,1047,1055,8,0.76,499,535,36,7.21,2,3,1,50.0,420,418,-2,-0.48,618,734,116,18.77,2586,2745,159,6.15,VERA MT,-12.2949604,-55.2947571,12,5317
MT,VILA RICA,826,811,-15,-1.82,146,122,-24,-16.44,42,27,-15,-35.71,763,787,24,3.15,1080,1016,-64,-5.93,2857,2763,-94,-3.29,VILA RICA MT,-10.013666,-51.118599,12,5318
MT,NOVA GUARITA,125,134,9,7.2,46,42,-4,-8.7,3,2,-1,-33.33,99,114,15,15.15,301,305,4,1.33,574,597,23,4.01,NOVA GUARITA MT,-10.3102031,-55.4042689,12,5319
MT,NOVA MARILANDIA,210,217,7,3.33,1253,1458,205,16.36,5,0,-5,-100.0,23,22,-1,-4.35,279,292,13,4.66,1770,1989,219,12.37,NOVA MARILANDIA MT,-14.3653436,-56.9709009,12,5320
MT,NOVA MARINGA,751,800,49,6.52,207,167,-40,-19.32,6,10,4,66.67,216,274,58,26.85,384,373,-11,-2.86,1564,1624,60,3.84,NOVA MARINGA MT,-13.0314433,-57.0922657,12,5321
MT,NOVA MONTE VERDE,549,507,-42,-7.65,205,449,244,119.02,15,11,-4,-26.67,331,369,38,11.48,433,455,22,5.08,1533,1791,258,16.83,NOVA MONTE VERDE MT,-9.9796694,-57.467331,12,5322
GO,ABADIANIA,320,279,-41,-12.81,366,403,37,10.11,1,16,15,1500.0,329,335,6,1.82,1316,1199,-117,-8.89,2332,2232,-100,-4.29,ABADIANIA GO,-16.1940946,-48.7067767,8,5324
GO,ACREUNA,848,913,65,7.67,308,293,-15,-4.87,35,33,-2,-5.71,684,698,14,2.05,1281,1293,12,0.94,3156,3230,74,2.34,ACREUNA GO,-17.3959899,-50.3749031,8,5325
GO,ADELANDIA,183,183,0,0.0,76,66,-10,-13.16,0,0,0,0.0,14,16,2,14.29,172,195,23,13.37,445,460,15,3.37,ADELANDIA GO,-16.4155077,-50.1665834,8,5326
GO,AGUA FRIA DE GOIAS,505,623,118,23.37,1,1,0,0.0,0,0,0,0.0,77,100,23,29.87,417,271,-146,-35.01,1000,995,-5,-0.5,AGUA FRIA DE GOIAS GO,-14.9803368,-47.7824312,8,5327
GO,AGUA LIMPA,96,82,-14,-14.58,36,19,-17,-47.22,0,0,0,0.0,25,23,-2,-8.0,282,226,-56,-19.86,439,350,-89,-20.27,AGUA LIMPA GO,-18.0755648,-48.7620637,8,5328
GO,ALEXANIA,480,461,-19,-3.96,619,515,-104,-16.8,19,29,10,52.63,1499,1411,-88,-5.87,2450,1824,-626,-25.55,5067,4240,-827,-16.32,ALEXANIA GO,-16.0834049,-48.5077803,8,5330
GO,ALOANDIA,37,32,-5,-13.51,7,5,-2,-28.57,0,0,0,0.0,27,31,4,14.81,174,149,-25,-14.37,245,217,-28,-11.43,ALOANDIA GO,-17.7277983,-49.4809338,8,5331
GO,ALTO HORIZONTE,36,34,-2,-5.56,800,839,39,4.88,368,319,-49,-13.32,218,203,-15,-6.88,1177,747,-430,-36.53,2599,2142,-457,-17.58,ALTO HORIZONTE GO,-14.1954948,-49.3366993,8,5332
GO,ALTO PARAISO DE GOIAS,279,278,-1,-0.36,39,41,2,5.13,0,1,1,0.0,246,243,-3,-1.22,997,861,-136,-13.64,1561,1424,-137,-8.78,ALTO PARAISO DE GOIAS GO,-14.1304779,-47.5100161,8,5333
GO,AMARALINA,59,82,23,38.98,5,1,-4,-80.0,0,0,0,0.0,7,6,-1,-14.29,222,221,-1,-0.45,293,310,17,5.8,AMARALINA GO,-13.9236199,-49.2962411,8,5335
GO,AMERICANO DO BRASIL,62,132,70,112.9,150,81,-69,-46.0,9,8,-1,-11.11,82,60,-22,-26.83,251,202,-49,-19.52,554,483,-71,-12.82,AMERICANO DO BRASIL GO,-16.2515808,-49.9806104,8,5336
GO,AMORINOPOLIS,58,71,13,22.41,4,1,-3,-75.0,6,0,-6,-100.0,32,41,9,28.12,186,162,-24,-12.9,286,275,-11,-3.85,AMORINOPOLIS GO,-16.6211308,-51.0949921,8,5337
GO,ANAPOLIS,600,652,52,8.67,27227,30187,2960,10.87,3201,3649,448,14.0,21127,20664,-463,-2.19,43572,42545,-1027,-2.36,95727,97697,1970,2.06,ANAPOLIS GO,-16.3332828,-48.9525756,8,5338
GO,ANHANGUERA,3,4,1,33.33,6,6,0,0.0,7,0,-7,-100.0,3,2,-1,-33.33,120,84,-36,-30.0,139,96,-43,-30.94,ANHANGUERA GO,-18.3338749,-48.220363,8,5339
GO,ANICUNS,291,250,-41,-14.09,1093,1168,75,6.86,42,31,-11,-26.19,462,479,17,3.68,1065,919,-146,-13.71,2953,2847,-106,-3.59,ANICUNS GO,-16.4606451,-49.9572265,8,5340
GO,APARECIDA DO RIO DOCE,265,270,5,1.89,2,2,0,0.0,0,0,0,0.0,49,39,-10,-20.41,272,263,-9,-3.31,588,574,-14,-2.38,APARECIDA DO RIO DOCE GO,-18.2980167,-51.1491312,8,5342
GO,APORE,462,429,-33,-7.14,362,395,33,9.12,0,0,0,0.0,66,63,-3,-4.55,326,340,14,4.29,1216,1227,11,0.9,APORE GO,-18.9642193,-51.92804,8,5343
GO,ARACU,53,34,-19,-35.85,108,118,10,9.26,16,24,8,50.0,49,44,-5,-10.2,197,191,-6,-3.05,423,411,-12,-2.84,ARACU GO,-16.3561579,-49.6815269,8,5344
GO,ARAGUAPAZ,275,279,4,1.45,26,16,-10,-38.46,0,1,1,0.0,119,104,-15,-12.61,347,349,2,0.58,767,749,-18,-2.35,ARAGUAPAZ GO,-15.0937927,-50.626417,8,5347
GO,ARENOPOLIS,159,132,-27,-16.98,59,43,-16,-27.12,52,54,2,3.85,21,25,4,19.05,305,219,-86,-28.2,596,473,-123,-20.64,ARENOPOLIS GO,-16.3859286,-51.55937,8,5348
GO,ARUANA,532,627,95,17.86,28,33,5,17.86,0,10,10,0.0,149,157,8,5.37,511,323,-188,-36.79,1220,1150,-70,-5.74,ARUANA GO,-14.9162439,-51.0715692,8,5349
GO,AURILANDIA,100,110,10,10.0,16,0,-16,-100.0,0,0,0,0.0,52,48,-4,-7.69,203,188,-15,-7.39,371,346,-25,-6.74,AURILANDIA GO,-16.6772599,-50.4641231,8,5350
GO,AVELINOPOLIS,72,68,-4,-5.56,94,127,33,35.11,1,10,9,900.0,28,25,-3,-10.71,192,195,3,1.56,387,425,38,9.82,AVELINOPOLIS GO,-16.4672409,-49.7578661,8,5351
GO,BELA VISTA DE GOIAS,974,835,-139,-14.27,1802,1849,47,2.61,70,73,3,4.29,1097,1089,-8,-0.73,1734,1710,-24,-1.38,5677,5556,-121,-2.13,BELA VISTA DE GOIAS GO,-16.9692949,-48.9513071,8,5354
GO,BOM JARDIM DE GOIAS,157,159,2,1.27,2,4,2,100.0,2,2,0,0.0,181,140,-41,-22.65,439,362,-77,-17.54,781,667,-114,-14.6,BOM JARDIM DE GOIAS GO,-16.2062659,-52.172793,8,5355
GO,BOM JESUS DE GOIAS,468,553,85,18.16,208,234,26,12.5,123,19,-104,-84.55,649,650,1,0.15,1814,1635,-179,-9.87,3262,3091,-171,-5.24,BOM JESUS DE GOIAS GO,-18.2174587,-49.739721,8,5356
GO,BONOPOLIS,324,307,-17,-5.25,14,13,-1,-7.14,0,0,0,0.0,34,26,-8,-23.53,216,170,-46,-21.3,588,516,-72,-12.24,BONOPOLIS GO,-13.649331,-49.8329113,8,5358
GO,BRITANIA,292,362,70,23.97,26,68,42,161.54,1,1,0,0.0,129,120,-9,-6.98,400,329,-71,-17.75,848,880,32,3.77,BRITANIA GO,-15.2427599,-51.1602061,8,5360
GO,BURITI ALEGRE,372,304,-68,-18.28,950,1064,114,12.0,0,1,1,0.0,229,227,-2,-0.87,821,841,20,2.44,2372,2437,65,2.74,BURITI ALEGRE GO,-18.1377879,-49.0404411,8,5361
GO,BURITI DE GOIAS,27,44,17,62.96,211,169,-42,-19.91,2,1,-1,-50.0,35,31,-4,-11.43,166,224,58,34.94,441,469,28,6.35,BURITI DE GOIAS GO,-16.180644,-50.4287479,8,5362
GO,BURITINOPOLIS,2,4,2,100.0,0,0,0,0.0,24,16,-8,-33.33,21,19,-2,-9.52,282,257,-25,-8.87,329,296,-33,-10.03,BURITINOPOLIS GO,-14.4573758,-46.4304568,8,5363
GO,CABECEIRAS,381,478,97,25.46,79,112,33,41.77,5,4,-1,-20.0,69,62,-7,-10.14,481,465,-16,-3.33,1015,1121,106,10.44,CABECEIRAS GO,-15.7995459,-46.9264991,8,5364
GO,CACHOEIRA ALTA,753,710,-43,-5.71,486,463,-23,-4.73,4,22,18,450.0,282,258,-24,-8.51,654,542,-112,-17.13,2179,1995,-184,-8.44,CACHOEIRA ALTA GO,-18.7618269,-50.9432431,8,5365
GO,CACHOEIRA DE GOIAS,43,32,-11,-25.58,30,23,-7,-23.33,0,0,0,0.0,8,12,4,50.0,140,21,-119,-85.0,221,88,-133,-60.18,CACHOEIRA DE GOIAS GO,-16.6688414,-50.6435997,8,5366
GO,CACHOEIRA DOURADA,269,280,11,4.09,1,0,-1,-100.0,3,2,-1,-33.33,15,13,-2,-13.33,437,351,-86,-19.68,725,646,-79,-10.9,CACHOEIRA DOURADA GO,-18.4915549,-49.5172789,8,5367
GO,CACU,383,336,-47,-12.27,1425,1356,-69,-4.84,17,37,20,117.65,453,426,-27,-5.96,1285,1347,62,4.82,3563,3502,-61,-1.71,CACU GO,-18.5637222,-51.1369685,8,5368
GO,CAIAPONIA,937,996,59,6.3,59,53,-6,-10.17,9,7,-2,-22.22,501,477,-24,-4.79,856,753,-103,-12.03,2362,2286,-76,-3.22,CAIAPONIA GO,-16.9538779,-51.8090761,8,5369
GO,CALDAS NOVAS,414,399,-15,-3.62,908,827,-81,-8.92,1530,1231,-299,-19.54,4661,4409,-252,-5.41,16965,14702,-2263,-13.34,24478,21568,-2910,-11.89,CALDAS NOVAS GO,-17.745,-48.625,8,5370
GO,CAMPESTRE DE GOIAS,91,98,7,7.69,86,88,2,2.33,0,0,0,0.0,20,25,5,25.0,202,191,-11,-5.45,399,402,3,0.75,CAMPESTRE DE GOIAS GO,-16.7624179,-49.69497,8,5372
GO,CAMPINACU,58,44,-14,-24.14,4,3,-1,-25.0,0,0,0,0.0,38,32,-6,-15.79,306,311,5,1.63,406,390,-16,-3.94,CAMPINACU GO,-13.7869969,-48.5703841,8,5373
GO,CAMPINORTE,90,95,5,5.56,78,79,1,1.28,12,6,-6,-50.0,417,435,18,4.32,526,538,12,2.28,1123,1153,30,2.67,CAMPINORTE GO,-14.3104574,-49.1552173,8,5374
GO,CAMPO ALEGRE DE GOIAS,788,867,79,10.03,8,8,0,0.0,55,24,-31,-56.36,186,189,3,1.61,536,412,-124,-23.13,1573,1500,-73,-4.64,CAMPO ALEGRE DE GOIAS GO,-17.6337896,-47.779291,8,5375
GO,CAMPO LIMPO DE GOIAS,105,120,15,14.29,428,521,93,21.73,2,4,2,100.0,145,141,-4,-2.76,462,489,27,5.84,1142,1275,133,11.65,CAMPO LIMPO DE GOIAS GO,-16.297101,-49.0894994,8,5376
GO,CAMPOS BELOS,85,95,10,11.76,132,147,15,11.36,28,51,23,82.14,781,754,-27,-3.46,1323,1138,-185,-13.98,2349,2185,-164,-6.98,CAMPOS BELOS GO,-13.0349839,-46.768112,8,5377
GO,CAMPOS VERDES,48,59,11,22.92,20,194,174,870.0,0,0,0,0.0,30,30,0,0.0,294,206,-88,-29.93,392,489,97,24.74,CAMPOS VERDES GO,-14.2709062,-49.65746,8,5378
GO,CARMO DO RIO VERDE,80,71,-9,-11.25,534,591,57,10.67,8,4,-4,-50.0,124,131,7,5.65,457,393,-64,-14.0,1203,1190,-13,-1.08,CARMO DO RIO VERDE GO,-15.3549139,-49.707975,8,5379
GO,CASTELANDIA,32,30,-2,-6.25,0,0,0,0.0,0,0,0,0.0,39,42,3,7.69,351,247,-104,-29.63,422,319,-103,-24.41,CASTELANDIA GO,-18.089062,-50.220798,8,5380
GO,CATALAO,1171,1166,-5,-0.43,6985,6557,-428,-6.13,1682,1985,303,18.01,5974,6089,115,1.93,9981,9960,-21,-0.21,25793,25757,-36,-0.14,CATALAO GO,-18.1702546,-47.9447082,8,5381
GO,CATURAI,114,102,-12,-10.53,29,33,4,13.79,5,3,-2,-40.0,75,69,-6,-8.0,320,324,4,1.25,543,531,-12,-2.21,CATURAI GO,-16.4473559,-49.4919149,8,5382
GO,CAVALCANTE,59,51,-8,-13.56,45,52,7,15.56,0,0,0,0.0,109,104,-5,-4.59,624,571,-53,-8.49,837,778,-59,-7.05,CAVALCANTE GO,-13.7928414,-47.4568521,8,5383
GO,CEZARINA,190,170,-20,-10.53,470,600,130,27.66,87,64,-23,-26.44,66,54,-12,-18.18,704,571,-133,-18.89,1517,1459,-58,-3.82,CEZARINA GO,-16.9718289,-49.775814,8,5385
GO,CHAPADAO DO CEU,908,906,-2,-0.22,1860,1907,47,2.53,133,86,-47,-35.34,466,455,-11,-2.36,1181,843,-338,-28.62,4548,4197,-351,-7.72,CHAPADAO DO CEU GO,-18.3951972,-52.6670783,8,5386
GO,COCALZINHO DE GOIAS,252,252,0,0.0,181,199,18,9.94,11,48,37,336.36,260,221,-39,-15.0,906,743,-163,-17.99,1610,1463,-147,-9.13,COCALZINHO DE GOIAS GO,-15.7762854,-48.7730427,8,5388
GO,COLINAS DO SUL,34,35,1,2.94,9,3,-6,-66.67,0,0,0,0.0,55,43,-12,-21.82,221,164,-57,-25.79,319,245,-74,-23.2,COLINAS DO SUL GO,-14.1555935,-48.0729958,8,5389
GO,CORREGO DO OURO,50,46,-4,-8.0,112,114,2,1.79,0,0,0,0.0,28,34,6,21.43,185,225,40,21.62,375,419,44,11.73,CORREGO DO OURO GO,-16.2960629,-50.5512216,8,5390
GO,CORUMBA DE GOIAS,413,395,-18,-4.36,103,84,-19,-18.45,9,11,2,22.22,145,124,-21,-14.48,528,357,-171,-32.39,1198,971,-227,-18.95,CORUMBA DE GOIAS GO,-15.9268355,-48.8074659,8,5391
GO,CORUMBAIBA,257,196,-61,-23.74,1288,1299,11,0.85,9,18,9,100.0,232,227,-5,-2.16,862,740,-122,-14.15,2648,2480,-168,-6.34,CORUMBAIBA GO,-18.1348982,-48.564223,8,5392
GO,CRISTALINA,5285,5510,225,4.26,921,1092,171,18.57,200,333,133,66.5,2332,2411,79,3.39,4031,3984,-47,-1.17,12769,13330,561,4.39,CRISTALINA GO,-16.7680599,-47.6133427,8,5393
GO,CRISTIANOPOLIS,79,56,-23,-29.11,17,13,-4,-23.53,14,14,0,0.0,88,91,3,3.41,284,196,-88,-30.99,482,370,-112,-23.24,CRISTIANOPOLIS GO,-17.2010889,-48.7060055,8,5394
GO,CRIXAS,241,250,9,3.73,1363,1457,94,6.9,704,762,58,8.24,468,363,-105,-22.44,1217,1268,51,4.19,3993,4100,107,2.68,CRIXAS GO,-14.5424536,-49.9694813,8,5395
GO,CROMINIA,102,65,-37,-36.27,2,25,23,1150.0,4,1,-3,-75.0,131,132,1,0.76,312,299,-13,-4.17,551,522,-29,-5.26,CROMINIA GO,-17.2891983,-49.3749654,8,5396
GO,CUMARI,99,97,-2,-2.02,7,15,8,114.29,0,0,0,0.0,39,36,-3,-7.69,173,173,0,0.0,318,321,3,0.94,CUMARI GO,-18.2644369,-48.1511341,8,5397
GO,DAMIANOPOLIS,6,5,-1,-16.67,0,0,0,0.0,0,0,0,0.0,49,45,-4,-8.16,237,206,-31,-13.08,292,256,-36,-12.33,DAMIANOPOLIS GO,-14.5603809,-46.1780241,8,5398
GO,DAMOLANDIA,23,20,-3,-13.04,42,53,11,26.19,6,4,-2,-33.33,23,20,-3,-13.04,194,176,-18,-9.28,288,273,-15,-5.21,DAMOLANDIA GO,-16.2548322,-49.3675277,8,5399
GO,DAVINOPOLIS,42,51,9,21.43,108,149,41,37.96,4,5,1,25.0,1220,1348,128,10.49,611,688,77,12.6,1985,2241,256,12.9,DAVINOPOLIS GO,-18.1536888,-47.5624052,8,5400
GO,DIORAMA,62,61,-1,-1.61,1,1,0,0.0,0,0,0,0.0,18,21,3,16.67,182,159,-23,-12.64,263,242,-21,-7.98,DIORAMA GO,-16.2359735,-51.2578729,8,5401
GO,DOVERLANDIA,413,472,59,14.29,67,68,1,1.49,0,1,1,0.0,135,139,4,2.96,382,325,-57,-14.92,997,1005,8,0.8,DOVERLANDIA GO,-16.7210996,-52.3138104,8,5402
GO,EDEALINA,143,137,-6,-4.2,148,150,2,1.35,2,4,2,100.0,95,105,10,10.53,452,383,-69,-15.27,840,779,-61,-7.26,EDEALINA GO,-17.4239419,-49.6644011,8,5403
GO,EDEIA,501,623,122,24.35,1211,988,-223,-18.41,7,4,-3,-42.86,267,355,88,32.96,816,959,143,17.52,2802,2929,127,4.53,EDEIA GO,-17.3407253,-49.9292351,8,5404
GO,ESTRELA DO NORTE,47,47,0,0.0,2,5,3,150.0,2,2,0,0.0,31,28,-3,-9.68,269,253,-16,-5.95,351,335,-16,-4.56,ESTRELA DO NORTE GO,-13.8687665,-49.0690546,8,5405
GO,FAINA,177,168,-9,-5.08,124,61,-63,-50.81,1,1,0,0.0,104,77,-27,-25.96,429,502,73,17.02,835,809,-26,-3.11,FAINA GO,-15.4458005,-50.3633826,8,5406
GO,FAZENDA NOVA,145,140,-5,-3.45,100,50,-50,-50.0,13,12,-1,-7.69,60,64,4,6.67,295,165,-130,-44.07,613,431,-182,-29.69,FAZENDA NOVA GO,-16.185602,-50.7795674,8,5407
GO,FIRMINOPOLIS,94,81,-13,-13.83,256,194,-62,-24.22,7,3,-4,-57.14,173,175,2,1.16,502,465,-37,-7.37,1032,918,-114,-11.05,FIRMINOPOLIS GO,-16.5753264,-50.3011286,8,5408
GO,FLORES DE GOIAS,261,292,31,11.88,2,2,0,0.0,0,0,0,0.0,66,59,-7,-10.61,573,589,16,2.79,902,942,40,4.43,FLORES DE GOIAS GO,-14.4580291,-47.0395396,8,5409
GO,FORMOSA,1910,1579,-331,-17.33,1477,1460,-17,-1.15,665,600,-65,-9.77,4759,4539,-220,-4.62,8023,7684,-339,-4.23,16834,15862,-972,-5.77,FORMOSA GO,-15.5492443,-47.3301212,8,5410
GO,FORMOSO,279,297,18,6.45,6,10,4,66.67,0,0,0,0.0,129,116,-13,-10.08,402,331,-71,-17.66,816,754,-62,-7.6,FORMOSO GO,-13.6499059,-48.8775481,8,5411
GO,GAMELEIRA DE GOIAS,210,219,9,4.29,67,50,-17,-25.37,0,0,0,0.0,34,37,3,8.82,259,184,-75,-28.96,570,490,-80,-14.04,GAMELEIRA DE GOIAS GO,-16.4853739,-48.64541,8,5412
GO,DIVINOPOLIS DE GOIAS,43,39,-4,-9.3,29,49,20,68.97,0,0,0,0.0,52,40,-12,-23.08,243,200,-43,-17.7,367,328,-39,-10.63,DIVINOPOLIS DE GOIAS GO,-13.2905914,-46.3950744,8,5413
GO,GOIANAPOLIS,141,129,-12,-8.51,241,281,40,16.6,2,1,-1,-50.0,143,173,30,20.98,1209,936,-273,-22.58,1736,1520,-216,-12.44,GOIANAPOLIS GO,-16.5071038,-49.0213217,8,5414
GO,GOIANESIA,924,1011,87,9.42,4923,5049,126,2.56,476,584,108,22.69,3164,3032,-132,-4.17,5026,4738,-288,-5.73,14513,14414,-99,-0.68,GOIANESIA GO,-15.3118269,-49.1162001,8,5416
GO,GOIANIA,2220,1849,-371,-16.71,46646,49914,3268,7.01,31797,31004,-793,-2.49,108290,104277,-4013,-3.71,386919,375522,-11397,-2.95,575872,562566,-13306,-2.31,GOIANIA GO,-16.6584892,-49.1786901,8,5417
GO,GOIAS,670,716,46,6.87,533,514,-19,-3.56,43,18,-25,-58.14,690,683,-7,-1.01,2103,2064,-39,-1.85,4039,3995,-44,-1.09,GOIAS GO,-15.9408902,-50.1465398,8,5419
GO,GOIATUBA,1024,1134,110,10.74,4161,4208,47,1.13,14,24,10,71.43,1689,1737,48,2.84,2631,2483,-148,-5.63,9519,9586,67,0.7,GOIATUBA GO,-18.0154577,-49.3640591,8,5420
GO,GOUVELANDIA,137,148,11,8.03,29,40,11,37.93,0,1,1,0.0,58,52,-6,-10.34,378,322,-56,-14.81,602,563,-39,-6.48,GOUVELANDIA GO,-18.4425949,-50.1365172,8,5421
GO,GUARAITA,40,38,-2,-5.0,10,4,-6,-60.0,0,0,0,0.0,5,8,3,60.0,198,180,-18,-9.09,253,230,-23,-9.09,GUARAITA GO,-15.6318094,-50.0288807,8,5423
GO,GUARANI DE GOIAS,66,71,5,7.58,27,47,20,74.07,0,0,0,0.0,30,24,-6,-20.0,276,177,-99,-35.87,399,319,-80,-20.05,GUARANI DE GOIAS GO,-13.9393794,-46.4781536,8,5424
GO,GUARINOS,22,22,0,0.0,17,31,14,82.35,0,0,0,0.0,8,6,-2,-25.0,212,129,-83,-39.15,259,188,-71,-27.41,GUARINOS GO,-14.7323527,-49.7013939,8,5425
GO,HEITORAI,27,26,-1,-3.7,50,16,-34,-68.0,0,0,0,0.0,45,51,6,13.33,264,319,55,20.83,386,412,26,6.74,HEITORAI GO,-15.7189859,-49.826826,8,5426
GO,HIDROLINA,56,81,25,44.64,15,7,-8,-53.33,2,2,0,0.0,52,66,14,26.92,117,226,109,93.16,242,382,140,57.85,HIDROLINA GO,-14.722224,-49.4694448,8,5428
GO,IACIARA,418,431,13,3.11,25,10,-15,-60.0,2,0,-2,-100.0,191,167,-24,-12.57,648,522,-126,-19.44,1284,1130,-154,-11.99,IACIARA GO,-14.1014906,-46.6343388,8,5429
GO,INACIOLANDIA,236,246,10,4.24,6,6,0,0.0,0,3,3,0.0,95,78,-17,-17.89,424,342,-82,-19.34,761,675,-86,-11.3,INACIOLANDIA GO,-18.4864065,-49.9887805,8,5430
GO,INDIARA,224,269,45,20.09,697,750,53,7.6,33,37,4,12.12,490,491,1,0.2,1011,896,-115,-11.37,2455,2443,-12,-0.49,INDIARA GO,-17.1387389,-49.9861621,8,5431
GO,INHUMAS,1362,1311,-51,-3.74,2650,3029,379,14.3,121,111,-10,-8.26,2041,1926,-115,-5.63,3994,4079,85,2.13,10168,10456,288,2.83,INHUMAS GO,-16.3610569,-49.500111,8,5432
GO,IPAMERI,1375,1332,-43,-3.13,679,691,12,1.77,47,14,-33,-70.21,1094,991,-103,-9.41,1899,1814,-85,-4.48,5094,4842,-252,-4.95,IPAMERI GO,-17.7215439,-48.158118,8,5433
GO,IPIRANGA DE GOIAS,13,11,-2,-15.38,40,41,1,2.5,0,0,0,0.0,24,22,-2,-8.33,241,155,-86,-35.68,318,229,-89,-27.99,IPIRANGA DE GOIAS GO,-15.1744391,-49.6733825,8,5434
GO,IPORA,142,133,-9,-6.34,437,417,-20,-4.58,15,144,129,860.0,632,582,-50,-7.91,882,857,-25,-2.83,2108,2133,25,1.19,IPORA GO,-16.4407981,-51.1181188,8,5435
GO,ISRAELANDIA,74,63,-11,-14.86,56,64,8,14.29,0,0,0,0.0,31,32,1,3.23,151,80,-71,-47.02,312,239,-73,-23.4,ISRAELANDIA GO,-16.3165217,-50.9046315,8,5436
GO,ITABERAI,1449,1365,-84,-5.8,4894,4833,-61,-1.25,175,226,51,29.14,1709,1693,-16,-0.94,2648,2740,92,3.47,10875,10857,-18,-0.17,ITABERAI GO,-16.0205509,-49.8060341,8,5437
GO,ITAGUARI,51,73,22,43.14,169,229,60,35.5,0,0,0,0.0,96,94,-2,-2.08,308,297,-11,-3.57,624,693,69,11.06,ITAGUARI GO,-15.9180439,-49.6070841,8,5438
GO,ITAGUARU,38,32,-6,-15.79,22,20,-2,-9.09,4,1,-3,-75.0,98,96,-2,-2.04,351,351,0,0.0,513,500,-13,-2.53,ITAGUARU GO,-15.7613695,-49.6337242,8,5439
GO,ITAJA,1,2,1,100.0,345,340,-5,-1.45,3,1,-2,-66.67,84,73,-11,-13.1,383,267,-116,-30.29,816,683,-133,-16.3,ITAJA GO,-19.0673379,-51.5495141,8,5440
GO,ITAPACI,268,369,101,37.69,843,878,35,4.15,89,27,-62,-69.66,456,418,-38,-8.33,1327,1308,-19,-1.43,2983,3000,17,0.57,ITAPACI GO,-14.9522349,-49.5511221,8,5441
GO,ITAPIRAPUA,432,417,-15,-3.47,177,147,-30,-16.95,6,4,-2,-33.33,150,137,-13,-8.67,395,334,-61,-15.44,1160,1039,-121,-10.43,ITAPIRAPUA GO,-15.8204999,-50.6094341,8,5442
GO,ITAPURANGA,262,256,-6,-2.29,748,634,-114,-15.24,1,4,3,300.0,727,719,-8,-1.1,1491,1372,-119,-7.98,3229,2985,-244,-7.56,ITAPURANGA GO,-15.5605889,-49.9489571,8,5443
GO,ITARUMA,508,467,-41,-8.07,31,30,-1,-3.23,32,22,-10,-31.25,122,130,8,6.56,448,335,-113,-25.22,1141,984,-157,-13.76,ITARUMA GO,-18.7645529,-51.348516,8,5444
GO,ITAUCU,80,76,-4,-5.0,397,334,-63,-15.87,4,5,1,25.0,165,170,5,3.03,566,497,-69,-12.19,1212,1082,-130,-10.73,ITAUCU GO,-16.2035995,-49.6059971,8,5445
GO,ITUMBIARA,2304,1754,-550,-23.87,6898,7047,149,2.16,494,586,92,18.62,6862,6671,-191,-2.78,12281,11855,-426,-3.47,28839,27913,-926,-3.21,ITUMBIARA GO,-18.4135862,-49.2172596,8,5446
GO,IVOLANDIA,134,131,-3,-2.24,6,4,-2,-33.33,0,0,0,0.0,15,19,4,26.67,193,185,-8,-4.15,348,339,-9,-2.59,IVOLANDIA GO,-16.6050122,-50.792374,8,5447
GO,JARAGUA,316,284,-32,-10.13,1831,1540,-291,-15.89,33,17,-16,-48.48,1018,985,-33,-3.24,2631,1773,-858,-32.61,5829,4599,-1230,-21.1,JARAGUA GO,-15.7528866,-49.3344033,8,5449
GO,JATAI,3085,3183,98,3.18,3261,3017,-244,-7.48,406,473,67,16.5,6251,6086,-165,-2.64,10086,10139,53,0.53,23089,22898,-191,-0.83,JATAI GO,-17.8783829,-51.7204241,8,5450
GO,JAUPACI,70,63,-7,-10.0,88,85,-3,-3.41,0,0,0,0.0,16,14,-2,-12.5,187,153,-34,-18.18,361,315,-46,-12.74,JAUPACI GO,-16.1841736,-50.9522616,8,5451
GO,JESUPOLIS,17,14,-3,-17.65,14,12,-2,-14.29,0,0,0,0.0,14,12,-2,-14.29,153,126,-27,-17.65,198,164,-34,-17.17,JESUPOLIS GO,-15.9545513,-49.3748004,8,5452
GO,JOVIANIA,199,222,23,11.56,2,2,0,0.0,4,12,8,200.0,162,166,4,2.47,494,538,44,8.91,861,940,79,9.18,JOVIANIA GO,-17.8063651,-49.623645,8,5453
GO,JUSSARA,6,7,1,16.67,10,6,-4,-40.0,0,0,0,0.0,73,74,1,1.37,513,463,-50,-9.75,602,550,-52,-8.64,JUSSARA GO,-15.874813,-50.867431,8,5454
GO,LAGOA SANTA,100,107,7,7.0,3295,3535,240,7.28,801,791,-10,-1.25,3375,3354,-21,-0.62,9467,9021,-446,-4.71,17038,16808,-230,-1.35,LAGOA SANTA GO,-19.1832417,-51.3998026,8,5455
GO,LEOPOLDO DE BULHOES,923,1058,135,14.63,121,178,57,47.11,0,0,0,0.0,151,149,-2,-1.32,684,376,-308,-45.03,1879,1761,-118,-6.28,LEOPOLDO DE BULHOES GO,-16.6190479,-48.742755,8,5456
GO,MAIRIPOTABA,90,86,-4,-4.44,14,12,-2,-14.29,0,5,5,0.0,33,38,5,15.15,193,166,-27,-13.99,330,307,-23,-6.97,MAIRIPOTABA GO,-17.2949694,-49.4960906,8,5458
GO,MAMBAI,59,56,-3,-5.08,7,6,-1,-14.29,2,0,-2,-100.0,149,180,31,20.81,440,171,-269,-61.14,657,413,-244,-37.14,MAMBAI GO,-14.4970828,-46.1115108,8,5459
GO,MARA ROSA,176,177,1,0.57,102,113,11,10.78,37,31,-6,-16.22,178,199,21,11.8,604,544,-60,-9.93,1097,1064,-33,-3.01,MARA ROSA GO,-14.0148159,-49.1776521,8,5460
GO,MARZAGAO,28,27,-1,-3.57,0,0,0,0.0,1,3,2,200.0,71,102,31,43.66,206,176,-30,-14.56,306,308,2,0.65,MARZAGAO GO,-17.980597,-48.6430322,8,5461
GO,MATRINCHA,233,229,-4,-1.72,39,37,-2,-5.13,0,0,0,0.0,81,88,7,8.64,307,302,-5,-1.63,660,656,-4,-0.61,MATRINCHA GO,-15.4357441,-50.749268,8,5462
GO,MAURILANDIA,466,478,12,2.58,3,2,-1,-33.33,12,3,-9,-75.0,129,145,16,12.4,711,453,-258,-36.29,1321,1081,-240,-18.17,MAURILANDIA GO,-17.9718589,-50.3388361,8,5463
GO,MIMOSO DE GOIAS,181,184,3,1.66,4,4,0,0.0,0,0,0,0.0,8,10,2,25.0,279,299,20,7.17,472,497,25,5.3,MIMOSO DE GOIAS GO,-15.0575453,-48.1602281,8,5464
GO,MINACU,74,58,-16,-21.62,155,430,275,177.42,206,211,5,2.43,644,615,-29,-4.5,2003,1488,-515,-25.71,3082,2802,-280,-9.09,MINACU GO,-13.5336413,-48.2184889,8,5465
GO,MINEIROS,2240,2128,-112,-5.0,4264,4771,507,11.89,459,565,106,23.09,3173,3230,57,1.8,6005,6119,114,1.9,16141,16813,672,4.16,MINEIROS GO,-17.5653879,-52.5536721,8,5466
GO,MOIPORA,73,56,-17,-23.29,16,9,-7,-43.75,0,0,0,0.0,6,6,0,0.0,231,144,-87,-37.66,326,215,-111,-34.05,MOIPORA GO,-16.5448305,-50.7352929,8,5467
GO,MONTE ALEGRE DE GOIAS,152,154,2,1.32,9,10,1,11.11,0,4,4,0.0,68,70,2,2.94,369,307,-62,-16.8,598,545,-53,-8.86,MONTE ALEGRE DE GOIAS GO,-13.2552059,-46.892813,8,5468
GO,MONTES CLAROS DE GOIAS,517,486,-31,-6.0,483,557,74,15.32,6,20,14,233.33,213,231,18,8.45,548,429,-119,-21.72,1767,1723,-44,-2.49,MONTES CLAROS DE GOIAS GO,-16.0059459,-51.3978781,8,5469
GO,MONTIVIDIU,1013,1262,249,24.58,125,122,-3,-2.4,20,20,0,0.0,433,472,39,9.01,951,731,-220,-23.13,2542,2607,65,2.56,MONTIVIDIU GO,-17.450464,-51.1737162,8,5470
GO,MONTIVIDIU DO NORTE,109,81,-28,-25.69,27,23,-4,-14.81,1,1,0,0.0,33,32,-1,-3.03,223,199,-24,-10.76,393,336,-57,-14.5,MONTIVIDIU DO NORTE GO,-13.3489998,-48.6872789,8,5471
GO,MORRINHOS,0,0,0,0.0,45,41,-4,-8.89,1,12,11,1100.0,115,150,35,30.43,569,525,-44,-7.73,730,728,-2,-0.27,MORRINHOS GO,-17.7333689,-49.105908,8,5472
GO,MORRO AGUDO DE GOIAS,16,17,1,6.25,59,30,-29,-49.15,0,0,0,0.0,15,12,-3,-20.0,1026,1145,119,11.6,1116,1204,88,7.89,MORRO AGUDO DE GOIAS GO,-15.3184299,-50.0552811,8,5473
GO,MOSSAMEDES,150,151,1,0.67,207,194,-13,-6.28,0,0,0,0.0,51,45,-6,-11.76,377,344,-33,-8.75,785,734,-51,-6.5,MOSSAMEDES GO,-16.1263751,-50.2104393,8,5474
GO,MOZARLANDIA,297,320,23,7.74,2369,2449,80,3.38,11,10,-1,-9.09,376,368,-8,-2.13,807,785,-22,-2.73,3860,3932,72,1.87,MOZARLANDIA GO,-14.7457049,-50.5713211,8,5475
GO,MUNDO NOVO,87,57,-30,-34.48,22,20,-2,-9.09,10,14,4,40.0,144,169,25,17.36,676,630,-46,-6.8,939,890,-49,-5.22,MUNDO NOVO GO,-13.7729429,-50.281378,8,5476
GO,MUTUNOPOLIS,74,63,-11,-14.86,3,2,-1,-33.33,0,0,0,0.0,24,27,3,12.5,204,178,-26,-12.75,305,270,-35,-11.48,MUTUNOPOLIS GO,-13.7303379,-49.2745491,8,5477
GO,NAZARIO,178,176,-2,-1.12,627,643,16,2.55,4,8,4,100.0,94,66,-28,-29.79,473,310,-163,-34.46,1376,1203,-173,-12.57,NAZARIO GO,-16.5807689,-49.881671,8,5478
GO,NIQUELANDIA,787,804,17,2.16,719,739,20,2.78,1404,1773,369,26.28,837,825,-12,-1.43,2201,2001,-200,-9.09,5948,6142,194,3.26,NIQUELANDIA GO,-14.4648655,-48.4572244,8,5480
GO,NOVA AMERICA,26,21,-5,-19.23,0,0,0,0.0,0,0,0,0.0,34,29,-5,-14.71,144,191,47,32.64,204,241,37,18.14,NOVA AMERICA GO,-15.0205889,-49.8952971,8,5481
GO,NOVA AURORA,453,443,-10,-2.21,1296,1456,160,12.35,35,55,20,57.14,681,632,-49,-7.2,995,959,-36,-3.62,3460,3545,85,2.46,NOVA AURORA GO,-18.0596519,-48.255172,8,5482
GO,NOVA CRIXAS,1296,1544,248,19.14,37,30,-7,-18.92,5,7,2,40.0,238,277,39,16.39,819,516,-303,-37.0,2395,2374,-21,-0.88,NOVA CRIXAS GO,-14.0968848,-50.3396014,8,5483
GO,NOVA GLORIA,91,84,-7,-7.69,83,57,-26,-31.33,2,1,-1,-50.0,129,135,6,4.65,369,248,-121,-32.79,674,525,-149,-22.11,NOVA GLORIA GO,-15.1481798,-49.577239,8,5484
GO,NOVA IGUACU DE GOIAS,34,35,1,2.94,16,14,-2,-12.5,0,0,0,0.0,28,25,-3,-10.71,176,125,-51,-28.98,254,199,-55,-21.65,NOVA IGUACU DE GOIAS GO,-14.2868289,-49.3871911,8,5485
GO,NOVA ROMA,124,121,-3,-2.42,42,40,-2,-4.76,0,0,0,0.0,22,19,-3,-13.64,229,212,-17,-7.42,417,392,-25,-6.0,NOVA ROMA GO,-13.7393323,-46.8831607,8,5486
GO,NOVO BRASIL,111,114,3,2.7,80,47,-33,-41.25,0,0,0,0.0,45,36,-9,-20.0,249,195,-54,-21.69,485,392,-93,-19.18,NOVO BRASIL GO,-16.0337152,-50.7112124,8,5488
GO,NOVO PLANALTO,186,185,-1,-0.54,4,3,-1,-25.0,0,0,0,0.0,51,45,-6,-11.76,323,265,-58,-17.96,564,498,-66,-11.7,NOVO PLANALTO GO,-13.2419575,-49.5081599,8,5490
GO,ORIZONA,576,597,21,3.65,781,825,44,5.63,0,8,8,0.0,596,606,10,1.68,793,635,-158,-19.92,2746,2671,-75,-2.73,ORIZONA GO,-17.0333559,-48.29641,8,5491
GO,OURO VERDE DE GOIAS,72,73,1,1.39,31,32,1,3.23,0,0,0,0.0,35,33,-2,-5.71,290,259,-31,-10.69,428,397,-31,-7.24,OURO VERDE DE GOIAS GO,-16.2181069,-49.194154,8,5492
GO,PALESTINA DE GOIAS,169,143,-26,-15.38,14,13,-1,-7.14,0,0,0,0.0,19,20,1,5.26,188,145,-43,-22.87,390,321,-69,-17.69,PALESTINA DE GOIAS GO,-16.7456647,-51.530084,8,5495
GO,PALMEIRAS DE GOIAS,602,615,13,2.16,4224,4305,81,1.92,133,135,2,1.5,562,576,14,2.49,1675,1722,47,2.81,7196,7353,157,2.18,PALMEIRAS DE GOIAS GO,-16.8102393,-49.9234165,8,5496
GO,PALMINOPOLIS,80,74,-6,-7.5,41,47,6,14.63,0,0,0,0.0,234,246,12,5.13,257,224,-33,-12.84,612,591,-21,-3.43,PALMINOPOLIS GO,-16.7884665,-50.1654607,8,5498
GO,PANAMA,77,72,-5,-6.49,22,22,0,0.0,0,0,0,0.0,34,37,3,8.82,232,240,8,3.45,365,371,6,1.64,PANAMA GO,-18.1755033,-49.3523852,8,5499
GO,PARANAIGUARA,228,240,12,5.26,62,53,-9,-14.52,9,9,0,0.0,209,189,-20,-9.57,633,589,-44,-6.95,1141,1080,-61,-5.35,PARANAIGUARA GO,-18.9137048,-50.6536307,8,5500
GO,PARAUNA,1189,1247,58,4.88,419,479,60,14.32,27,42,15,55.56,359,358,-1,-0.28,958,579,-379,-39.56,2952,2705,-247,-8.37,PARAUNA GO,-16.9495937,-50.4473008,8,5501
GO,PEROLANDIA,240,239,-1,-0.42,815,802,-13,-1.6,0,0,0,0.0,28,40,12,42.86,405,267,-138,-34.07,1488,1348,-140,-9.41,PEROLANDIA GO,-17.5269378,-52.0624546,8,5502
GO,PETROLINA DE GOIAS,129,110,-19,-14.73,118,105,-13,-11.02,1,1,0,0.0,167,148,-19,-11.38,536,574,38,7.09,951,938,-13,-1.37,PETROLINA DE GOIAS GO,-16.1005783,-49.3359066,8,5503
GO,PILAR DE GOIAS,59,73,14,23.73,507,485,-22,-4.34,0,0,0,0.0,6,7,1,16.67,263,323,60,22.81,835,888,53,6.35,PILAR DE GOIAS GO,-14.7628082,-49.5797292,8,5504
GO,PIRACANJUBA,803,794,-9,-1.12,427,397,-30,-7.03,4,9,5,125.0,846,830,-16,-1.89,1528,1312,-216,-14.14,3608,3342,-266,-7.37,PIRACANJUBA GO,-17.3020379,-49.0170101,8,5505
GO,PIRANHAS,85,89,4,4.71,36,77,41,113.89,6,1,-5,-83.33,214,220,6,2.8,2189,2366,177,8.09,2530,2753,223,8.81,PIRANHAS GO,-16.4252491,-51.8231427,8,5506
GO,PIRENOPOLIS,424,405,-19,-4.48,292,513,221,75.68,107,155,48,44.86,650,664,14,2.15,2824,2201,-623,-22.06,4297,3938,-359,-8.35,PIRENOPOLIS GO,-15.8501619,-48.957317,8,5507
GO,PIRES DO RIO,543,593,50,9.21,3239,3477,238,7.35,101,114,13,12.87,1466,1424,-42,-2.86,1899,2093,194,10.22,7248,7701,453,6.25,PIRES DO RIO GO,-17.3006277,-48.2793037,8,5508
GO,PONTALINA,475,462,-13,-2.74,695,656,-39,-5.61,76,158,82,107.89,444,472,28,6.31,1191,986,-205,-17.21,2881,2734,-147,-5.1,PONTALINA GO,-17.5144331,-49.4449688,8,5510
GO,PORANGATU,582,563,-19,-3.26,933,1001,68,7.29,12,30,18,150.0,1830,1806,-24,-1.31,3210,3263,53,1.65,6567,6663,96,1.46,PORANGATU GO,-13.444663,-49.1423569,8,5511
GO,PORTELANDIA,235,215,-20,-8.51,111,120,9,8.11,0,0,0,0.0,146,141,-5,-3.42,329,331,2,0.61,821,807,-14,-1.71,PORTELANDIA GO,-17.3573086,-52.6777879,8,5513
GO,POSSE,377,327,-50,-13.26,321,386,65,20.25,80,81,1,1.25,1160,1181,21,1.81,2606,1965,-641,-24.6,4544,3940,-604,-13.29,POSSE GO,-14.0835852,-46.3563185,8,5514
GO,PROFESSOR JAMIL,89,81,-8,-8.99,16,21,5,31.25,0,0,0,0.0,38,31,-7,-18.42,248,176,-72,-29.03,391,309,-82,-20.97,PROFESSOR JAMIL GO,-17.25316,-49.2442452,8,5515
GO,QUIRINOPOLIS,1060,1036,-24,-2.26,5173,5344,171,3.31,118,45,-73,-61.86,2316,2166,-150,-6.48,4076,2920,-1156,-28.36,12743,11511,-1232,-9.67,QUIRINOPOLIS GO,-18.4471859,-50.4546981,8,5516
GO,RIANAPOLIS,55,18,-37,-67.27,113,26,-87,-76.99,3,9,6,200.0,88,81,-7,-7.95,266,188,-78,-29.32,525,322,-203,-38.67,RIANAPOLIS GO,-15.4479209,-49.5102051,8,5518
GO,RIO VERDE,6766,7577,811,11.99,13655,14475,820,6.01,1848,2376,528,28.57,12451,12339,-112,-0.9,23718,24147,429,1.81,58438,60914,2476,4.24,RIO VERDE GO,-17.7921255,-50.9191219,8,5520
GO,RUBIATABA,1397,1005,-392,-28.06,885,1037,152,17.18,26,23,-3,-11.54,432,437,5,1.16,1228,1244,16,1.3,3968,3746,-222,-5.59,RUBIATABA GO,-15.1629793,-49.8005102,8,5521
GO,SANCLERLANDIA,71,62,-9,-12.68,704,736,32,4.55,8,13,5,62.5,223,228,5,2.24,473,489,16,3.38,1479,1528,49,3.31,SANCLERLANDIA GO,-16.1993165,-50.309374,8,5522
GO,SANTA BARBARA DE GOIAS,61,62,1,1.64,358,423,65,18.16,37,53,16,43.24,54,58,4,7.41,461,321,-140,-30.37,971,917,-54,-5.56,SANTA BARBARA DE GOIAS GO,-16.5779125,-49.6982268,8,5523
GO,SANTA CRUZ DE GOIAS,259,249,-10,-3.86,8,9,1,12.5,0,0,0,0.0,16,20,4,25.0,221,136,-85,-38.46,504,414,-90,-17.86,SANTA CRUZ DE GOIAS GO,-17.3155119,-48.4809501,8,5524
GO,SANTA FE DE GOIAS,240,227,-13,-5.42,682,602,-80,-11.73,0,0,0,0.0,57,59,2,3.51,364,242,-122,-33.52,1343,1130,-213,-15.86,SANTA FE DE GOIAS GO,-15.7705927,-51.1018204,8,5525
GO,SANTA HELENA DE GOIAS,1272,1414,142,11.16,723,740,17,2.35,110,129,19,17.27,1412,1427,15,1.06,2953,2498,-455,-15.41,6470,6208,-262,-4.05,SANTA HELENA DE GOIAS GO,-17.8115199,-50.5976641,8,5526
GO,SANTA ISABEL,352,315,-37,-10.51,2657,2633,-24,-0.9,186,227,41,22.04,2148,2129,-19,-0.88,4661,4416,-245,-5.26,10004,9720,-284,-2.84,SANTA ISABEL GO,-15.3000401,-49.4271365,8,5527
GO,SANTA ROSA DE GOIAS,36,35,-1,-2.78,41,31,-10,-24.39,1,1,0,0.0,36,35,-1,-2.78,195,159,-36,-18.46,309,261,-48,-15.53,SANTA ROSA DE GOIAS GO,-16.0839829,-49.495326,8,5530
GO,SANTA TEREZA DE GOIAS,78,69,-9,-11.54,2,2,0,0.0,0,0,0,0.0,36,37,1,2.78,269,295,26,9.67,385,403,18,4.68,SANTA TEREZA DE GOIAS GO,-13.713116,-49.0164361,8,5531
GO,SANTA TEREZINHA DE GOIAS,90,80,-10,-11.11,48,53,5,10.42,2,4,2,100.0,233,249,16,6.87,604,509,-95,-15.73,977,895,-82,-8.39,SANTA TEREZINHA DE GOIAS GO,-14.4361002,-49.7092915,8,5532
GO,SANTO ANTONIO DA BARRA,639,683,44,6.89,149,174,25,16.78,8,31,23,287.5,30,21,-9,-30.0,353,214,-139,-39.38,1179,1123,-56,-4.75,SANTO ANTONIO DA BARRA GO,-17.5584989,-50.6345431,8,5533
GO,SAO DOMINGOS,2,3,1,50.0,27,38,11,40.74,0,0,0,0.0,3,4,1,33.33,248,225,-23,-9.27,280,270,-10,-3.57,SAO DOMINGOS GO,-13.3998769,-46.3217961,8,5536
GO,SAO FRANCISCO DE GOIAS,267,307,40,14.98,161,116,-45,-27.95,0,0,0,0.0,94,111,17,18.09,313,246,-67,-21.41,835,780,-55,-6.59,SAO FRANCISCO DE GOIAS GO,-15.9334279,-49.2608329,8,5537
GO,SAO JOAO DA PARAUNA,68,66,-2,-2.94,17,12,-5,-29.41,0,0,0,0.0,13,12,-1,-7.69,158,127,-31,-19.62,256,217,-39,-15.23,SAO JOAO DA PARAUNA GO,-16.8161447,-50.408197,8,5539
GO,SAO LUIS DE MONTES BELOS,190,181,-9,-4.74,1629,1805,176,10.8,37,44,7,18.92,1541,1492,-49,-3.18,2743,2677,-66,-2.41,6140,6199,59,0.96,SAO LUIS DE MONTES BELOS GO,-16.5210639,-50.3726281,8,5540
GO,SAO MIGUEL DO ARAGUAIA,1100,1126,26,2.36,96,103,7,7.29,54,38,-16,-29.63,740,711,-29,-3.92,1334,1250,-84,-6.3,3324,3228,-96,-2.89,SAO MIGUEL DO ARAGUAIA GO,-13.2726442,-50.1627219,8,5542
GO,SAO MIGUEL DO PASSA QUATRO,209,208,-1,-0.48,50,49,-1,-2.0,0,0,0,0.0,66,64,-2,-3.03,476,328,-148,-31.09,801,649,-152,-18.98,SAO MIGUEL DO PASSA QUATRO GO,-17.0582009,-48.6619811,8,5543
GO,SAO PATRICIO,772,860,88,11.4,241,115,-126,-52.28,0,0,0,0.0,17,18,1,5.88,191,241,50,26.18,1221,1234,13,1.06,SAO PATRICIO GO,-15.3492626,-49.819299,8,5544
GO,SAO SIMAO,498,454,-44,-8.84,908,1097,189,20.81,2,3,1,50.0,498,505,7,1.41,1407,1245,-162,-11.51,3313,3304,-9,-0.27,SAO SIMAO GO,-18.9941302,-50.5468215,8,5545
GO,SERRANOPOLIS,609,573,-36,-5.91,754,779,25,3.32,3,2,-1,-33.33,190,181,-9,-4.74,595,336,-259,-43.53,2151,1871,-280,-13.02,SERRANOPOLIS GO,-18.30602885,-51.9563672773001,8,5547
GO,SILVANIA,949,952,3,0.32,409,407,-2,-0.49,10,13,3,30.0,742,745,3,0.4,1599,1281,-318,-19.89,3709,3398,-311,-8.39,SILVANIA GO,-16.6599718,-48.608326,8,5548
GO,TAQUARAL DE GOIAS,47,56,9,19.15,300,297,-3,-1.0,8,3,-5,-62.5,73,77,4,5.48,233,245,12,5.15,661,678,17,2.57,TAQUARAL DE GOIAS GO,-16.0520569,-49.6038591,8,5551
GO,TERESINA DE GOIAS,10,10,0,0.0,0,0,0,0.0,0,0,0,0.0,17,18,1,5.88,263,139,-124,-47.15,290,167,-123,-42.41,TERESINA DE GOIAS GO,-13.7789573,-47.266894,8,5552
GO,TEREZOPOLIS DE GOIAS,65,51,-14,-21.54,364,348,-16,-4.4,15,53,38,253.33,168,186,18,10.71,454,355,-99,-21.81,1066,993,-73,-6.85,TEREZOPOLIS DE GOIAS GO,-16.4837865,-49.0949299,8,5553
GO,TROMBAS,55,56,1,1.82,3,5,2,66.67,0,0,0,0.0,31,40,9,29.03,290,173,-117,-40.34,379,274,-105,-27.7,TROMBAS GO,-13.5078899,-48.74171,8,5556
GO,TURVANIA,139,151,12,8.63,47,28,-19,-40.43,0,0,0,0.0,66,74,8,12.12,309,257,-52,-16.83,561,510,-51,-9.09,TURVANIA GO,-16.6120126,-50.1352075,8,5557
GO,UIRAPURU,53,59,6,11.32,2,2,0,0.0,0,0,0,0.0,14,16,2,14.29,233,172,-61,-26.18,302,249,-53,-17.55,UIRAPURU GO,-14.2842502,-49.9195999,8,5559
GO,URUACU,279,736,457,163.8,619,669,50,8.08,389,512,123,31.62,1984,1925,-59,-2.97,3209,3704,495,15.43,6480,7546,1066,16.45,URUACU GO,-14.5244164,-49.1510022,8,5560
GO,URUANA,60,47,-13,-21.67,73,89,16,21.92,4,3,-1,-25.0,199,214,15,7.54,594,570,-24,-4.04,930,923,-7,-0.75,URUANA GO,-15.4998907,-49.6870172,8,5561
GO,VARJAO,82,116,34,41.46,12,15,3,25.0,0,0,0,0.0,56,73,17,30.36,33,112,79,239.39,183,316,133,72.68,VARJAO GO,-17.045397,-49.632599,8,5564
GO,VIANOPOLIS,427,405,-22,-5.15,330,315,-15,-4.55,42,15,-27,-64.29,590,643,53,8.98,956,979,23,2.41,2345,2357,12,0.51,VIANOPOLIS GO,-16.7475869,-48.5131735,8,5565
GO,VICENTINOPOLIS,400,398,-2,-0.5,970,898,-72,-7.42,0,0,0,0.0,160,170,10,6.25,667,710,43,6.45,2197,2176,-21,-0.96,VICENTINOPOLIS GO,-17.7353689,-49.8040525,8,5566
GO,VILA BOA,268,387,119,44.4,67,67,0,0.0,0,0,0,0.0,25,34,9,36.0,438,390,-48,-10.96,798,878,80,10.03,VILA BOA GO,-15.0357754,-47.0561444,8,5567
GO,VILA PROPICIO,400,433,33,8.25,153,178,25,16.34,0,0,0,0.0,45,41,-4,-8.89,382,226,-156,-40.84,980,878,-102,-10.41,VILA PROPICIO GO,-15.4558431,-48.8855024,8,5568
DF,BRASILIA,5365,5374,9,0.17,36044,37413,1369,3.8,47291,49237,1946,4.11,161867,158572,-3295,-2.04,817048,987812,170764,20.9,1067615,1238408,170793,16.0,BRASILIA DF,-15.7934036,-47.8823172,6,5569
